"Province","District","PC_number","PS_number","Abdullah","Ghani","Total"
"BAMYAN","BAMYAN",1001014,1,341,111,452
"BAMYAN","BAMYAN",1001018,4,296,161,457
"BAMYAN","BAMYAN",1001014,2,156,67,223
"BAMYAN","BAMYAN",1001018,2,266,228,494
"BAMYAN","BAMYAN",1001018,3,286,160,446
"BAMYAN","BAMYAN",1001009,1,226,85,311
"BAMYAN","BAMYAN",1001009,2,201,69,270
"BAMYAN","BAMYAN",1001009,3,158,55,213
"BAMYAN","BAMYAN",1001009,4,174,42,216
"BAMYAN","BAMYAN",1001012,2,106,20,126
"BAMYAN","BAMYAN",1001012,3,92,33,125
"BAMYAN","BAMYAN",1001169,1,59,30,89
"BAMYAN","BAMYAN",1001014,3,152,68,220
"BAMYAN","BAMYAN",1001004,1,286,93,379
"BAMYAN","BAMYAN",1001167,1,327,154,481
"BAMYAN","BAMYAN",1001167,2,351,151,502
"BAMYAN","BAMYAN",1001167,3,386,194,580
"BAMYAN","BAMYAN",1001167,4,107,36,143
"BAMYAN","BAMYAN",1001013,2,146,120,266
"BAMYAN","BAMYAN",1001013,3,142,101,243
"BAMYAN","BAMYAN",1001013,4,122,83,205
"BAMYAN","BAMYAN",1001015,1,364,160,524
"BAMYAN","BAMYAN",1001015,2,210,89,299
"BAMYAN","BAMYAN",1001015,3,132,59,191
"BAMYAN","BAMYAN",1001016,1,280,110,390
"BAMYAN","BAMYAN",1001016,2,137,74,211
"BAMYAN","BAMYAN",1001016,3,90,78,168
"BAMYAN","BAMYAN",1001001,1,435,157,592
"BAMYAN","BAMYAN",1001004,2,122,44,166
"BAMYAN","BAMYAN",1001004,3,79,13,92
"BAMYAN","BAMYAN",1001017,1,45,31,76
"BAMYAN","BAMYAN",1001017,2,67,37,104
"BAMYAN","BAMYAN",1001017,3,55,32,87
"BAMYAN","BAMYAN",1001017,4,64,32,96
"BAMYAN","BAMYAN",1001018,1,275,225,500
"BAMYAN","BAMYAN",1001001,9,199,126,325
"BAMYAN","BAMYAN",1001001,10,81,26,107
"BAMYAN","BAMYAN",1001001,11,408,163,571
"BAMYAN","BAMYAN",1001006,1,238,50,288
"BAMYAN","BAMYAN",1001006,2,190,39,229
"BAMYAN","BAMYAN",1001006,3,178,49,227
"BAMYAN","BAMYAN",1001006,4,198,43,241
"BAMYAN","BAMYAN",1001002,1,274,36,310
"BAMYAN","BAMYAN",1001002,2,245,49,294
"BAMYAN","BAMYAN",1001002,3,181,25,206
"BAMYAN","BAMYAN",1001002,4,262,49,311
"BAMYAN","BAMYAN",1001002,5,185,28,213
"BAMYAN","BAMYAN",1001002,6,120,26,146
"BAMYAN","BAMYAN",1001012,1,305,66,371
"BAMYAN","BAMYAN",1001019,1,233,138,371
"BAMYAN","BAMYAN",1001019,2,93,53,146
"BAMYAN","BAMYAN",1001008,1,256,70,326
"BAMYAN","BAMYAN",1001008,2,196,50,246
"BAMYAN","BAMYAN",1001008,3,134,54,188
"BAMYAN","BAMYAN",1001003,1,44,111,155
"BAMYAN","BAMYAN",1001003,2,53,110,163
"BAMYAN","BAMYAN",1001003,3,24,123,147
"BAMYAN","BAMYAN",1001003,4,32,112,144
"BAMYAN","BAMYAN",1001013,1,144,120,264
"BAMYAN","BAMYAN",1001001,6,414,172,586
"BAMYAN","BAMYAN",1001001,7,285,134,419
"BAMYAN","BAMYAN",1001001,8,235,132,367
"BAMYAN","BAMYAN",1001020,1,285,123,408
"BAMYAN","BAMYAN",1001020,2,134,38,172
"BAMYAN","BAMYAN",1001019,3,144,52,196
"BAMYAN","BAMYAN",1001011,1,154,94,248
"BAMYAN","BAMYAN",1001011,2,29,87,116
"BAMYAN","BAMYAN",1001011,3,54,65,119
"BAMYAN","BAMYAN",1001001,2,421,165,586
"BAMYAN","BAMYAN",1001001,3,403,178,581
"BAMYAN","BAMYAN",1001001,4,435,154,589
"BAMYAN","BAMYAN",1001001,5,417,169,586
"BAMYAN","BAMYAN",1001007,4,320,103,423
"BAMYAN","BAMYAN",1001010,1,205,34,239
"BAMYAN","BAMYAN",1001010,2,94,10,104
"BAMYAN","BAMYAN",1001010,3,87,4,91
"BAMYAN","BAMYAN",1001169,2,97,30,127
"BAMYAN","BAMYAN",1001020,3,119,49,168
"BAMYAN","BAMYAN",1001168,1,365,165,530
"BAMYAN","BAMYAN",1001168,2,364,219,583
"BAMYAN","BAMYAN",1001007,3,280,98,378
"BAMYAN","BAMYAN",1001169,3,172,77,249
"BAMYAN","BAMYAN",1001007,1,274,101,375
"BAMYAN","BAMYAN",1001007,2,369,142,511
"BAMYAN","BAMYAN",1001005,2,115,24,139
"BAMYAN","BAMYAN",1001005,4,88,17,105
"BAMYAN","BAMYAN",1001005,1,130,30,160
"BAMYAN","BAMYAN",1001168,3,390,185,575
"BAMYAN","BAMYAN",1001005,3,89,15,104
"BAMYAN","BAMYAN",1001168,4,175,112,287
"BAMYAN","SHEBAR",1002022,2,130,131,261
"BAMYAN","SHEBAR",1002024,2,189,368,557
"BAMYAN","SHEBAR",1002021,1,372,115,487
"BAMYAN","SHEBAR",1002022,1,156,138,294
"BAMYAN","SHEBAR",1002024,1,280,245,525
"BAMYAN","SHEBAR",1002024,3,148,367,515
"BAMYAN","SHEBAR",1002028,2,293,300,593
"BAMYAN","SHEBAR",1002025,1,176,234,410
"BAMYAN","SHEBAR",1002032,3,398,199,597
"BAMYAN","SHEBAR",1002028,1,436,162,598
"BAMYAN","SHEBAR",1002171,2,436,150,586
"BAMYAN","SHEBAR",1002023,1,206,260,466
"BAMYAN","SHEBAR",1002025,2,141,284,425
"BAMYAN","SHEBAR",1002171,1,402,197,599
"BAMYAN","SHEBAR",1002031,2,345,249,594
"BAMYAN","SHEBAR",1002032,1,474,86,560
"BAMYAN","SHEBAR",1002032,2,302,287,589
"BAMYAN","SHEBAR",1002026,2,109,128,237
"BAMYAN","SHEBAR",1002030,2,486,102,588
"BAMYAN","SHEBAR",1002021,2,268,185,453
"BAMYAN","SHEBAR",1002171,3,439,117,556
"BAMYAN","SHEBAR",1002030,1,445,151,596
"BAMYAN","SHEBAR",1002031,1,409,187,596
"BAMYAN","SHEBAR",1002170,1,147,101,248
"BAMYAN","SHEBAR",1002021,3,473,54,527
"BAMYAN","SHEBAR",1002023,2,180,323,503
"BAMYAN","SHEBAR",1002026,1,160,121,281
"BAMYAN","SHEBAR",1002027,2,141,222,363
"BAMYAN","SHEBAR",1002170,2,169,111,280
"BAMYAN","SHEBAR",1002170,3,238,168,406
"BAMYAN","SHEBAR",1002027,1,169,206,375
"BAMYAN","SHEBAR",1002030,3,395,201,596
"BAMYAN","SHEBAR",1002029,1,551,40,591
"BAMYAN","SHEBAR",1002027,3,287,190,477
"BAMYAN","SHEBAR",1002029,2,576,20,596
"BAMYAN","SAIGHAN",1003047,2,163,10,173
"BAMYAN","SAIGHAN",1003044,3,49,147,196
"BAMYAN","SAIGHAN",1003044,1,137,58,195
"BAMYAN","SAIGHAN",1003172,1,337,51,388
"BAMYAN","SAIGHAN",1003041,1,78,32,110
"BAMYAN","SAIGHAN",1003163,1,492,99,591
"BAMYAN","SAIGHAN",1003045,2,93,127,220
"BAMYAN","SAIGHAN",1003045,1,114,125,239
"BAMYAN","SAIGHAN",1003047,1,216,51,267
"BAMYAN","SAIGHAN",1003173,1,487,107,594
"BAMYAN","SAIGHAN",1003172,2,266,127,393
"BAMYAN","SAIGHAN",1003172,3,305,96,401
"BAMYAN","SAIGHAN",1003044,2,34,139,173
"BAMYAN","SAIGHAN",1003046,2,496,90,586
"BAMYAN","SAIGHAN",1003173,2,481,105,586
"BAMYAN","SAIGHAN",1003173,3,274,268,542
"BAMYAN","SAIGHAN",1003034,1,493,57,550
"BAMYAN","SAIGHAN",1003034,2,393,47,440
"BAMYAN","SAIGHAN",1003040,1,203,81,284
"BAMYAN","SAIGHAN",1003163,2,362,54,416
"BAMYAN","SAIGHAN",1003049,1,202,1,203
"BAMYAN","SAIGHAN",1003049,2,99,9,108
"BAMYAN","SAIGHAN",1003038,1,415,36,451
"BAMYAN","SAIGHAN",1003038,2,398,18,416
"BAMYAN","SAIGHAN",1003046,1,524,75,599
"BAMYAN","SAIGHAN",1003039,2,485,111,596
"BAMYAN","SAIGHAN",1003043,2,574,24,598
"BAMYAN","SAIGHAN",1003041,2,103,49,152
"BAMYAN","SAIGHAN",1003040,2,102,39,141
"BAMYAN","SAIGHAN",1003043,1,357,166,523
"BAMYAN","SAIGHAN",1003036,1,351,27,378
"BAMYAN","SAIGHAN",1003036,2,361,14,375
"BAMYAN","SAIGHAN",1003041,3,159,57,216
"BAMYAN","SAIGHAN",1003035,3,328,7,335
"BAMYAN","SAIGHAN",1003042,2,536,64,600
"BAMYAN","SAIGHAN",1003033,2,237,20,257
"BAMYAN","SAIGHAN",1003033,4,155,14,169
"BAMYAN","SAIGHAN",1003039,1,536,51,587
"BAMYAN","SAIGHAN",1003033,1,363,23,386
"BAMYAN","SAIGHAN",1003035,1,268,12,280
"BAMYAN","SAIGHAN",1003035,2,144,153,297
"BAMYAN","SAIGHAN",1003042,1,378,220,598
"BAMYAN","SAIGHAN",1003033,3,365,14,379
"BAMYAN","SAIGHAN",1003037,3,398,123,521
"BAMYAN","SAIGHAN",1003048,2,16,47,63
"BAMYAN","SAIGHAN",1003037,1,357,166,523
"BAMYAN","SAIGHAN",1003048,1,21,43,64
"BAMYAN","SAIGHAN",1003037,2,400,68,468
"BAMYAN","KAHMARD",1004060,2,301,35,336
"BAMYAN","KAHMARD",1004066,2,377,33,410
"BAMYAN","KAHMARD",1004063,2,407,190,597
"BAMYAN","KAHMARD",1004066,1,345,27,372
"BAMYAN","KAHMARD",1004060,1,309,16,325
"BAMYAN","KAHMARD",1004063,1,345,252,597
"BAMYAN","KAHMARD",1004059,1,150,382,532
"BAMYAN","KAHMARD",1004063,3,479,117,596
"BAMYAN","KAHMARD",1004065,1,76,20,96
"BAMYAN","KAHMARD",1004065,2,30,15,45
"BAMYAN","KAHMARD",1004062,1,390,117,507
"BAMYAN","KAHMARD",1004062,2,139,111,250
"BAMYAN","KAHMARD",1004054,1,412,79,491
"BAMYAN","KAHMARD",1004050,3,260,23,283
"BAMYAN","KAHMARD",1004050,2,268,15,283
"BAMYAN","KAHMARD",1004057,1,544,56,600
"BAMYAN","KAHMARD",1004060,3,481,114,595
"BAMYAN","KAHMARD",1004051,1,566,29,595
"BAMYAN","KAHMARD",1004051,2,575,25,600
"BAMYAN","KAHMARD",1004061,3,125,32,157
"BAMYAN","KAHMARD",1004057,2,325,72,397
"BAMYAN","KAHMARD",1004055,1,292,32,324
"BAMYAN","KAHMARD",1004055,2,291,29,320
"BAMYAN","KAHMARD",1004050,1,563,32,595
"BAMYAN","KAHMARD",1004067,1,299,301,600
"BAMYAN","KAHMARD",1004067,2,300,300,600
"BAMYAN","KAHMARD",1004054,2,410,65,475
"BAMYAN","KAHMARD",1004064,1,134,77,211
"BAMYAN","KAHMARD",1004064,2,58,272,330
"BAMYAN","KAHMARD",1004058,1,481,118,599
"BAMYAN","KAHMARD",1004058,2,362,233,595
"BAMYAN","KAHMARD",1004053,3,513,33,546
"BAMYAN","KAHMARD",1004056,2,304,72,376
"BAMYAN","KAHMARD",1004061,1,468,92,560
"BAMYAN","KAHMARD",1004061,2,300,154,454
"BAMYAN","KAHMARD",1004059,2,120,400,520
"BAMYAN","KAHMARD",1004052,1,316,146,462
"BAMYAN","KAHMARD",1004052,2,302,37,339
"BAMYAN","KAHMARD",1004053,1,511,87,598
"BAMYAN","KAHMARD",1004053,2,470,15,485
"BAMYAN","KAHMARD",1004056,1,197,81,278
"BAMYAN","KAHMARD",1004068,1,210,69,279
"BAMYAN","KAHMARD",1004068,2,217,98,315
"BAMYAN","YAKAWLANG",1005177,1,93,20,113
"BAMYAN","YAKAWLANG",1005177,2,50,28,78
"BAMYAN","YAKAWLANG",1005084,1,76,42,118
"BAMYAN","YAKAWLANG",1005084,2,58,21,79
"BAMYAN","YAKAWLANG",1005177,3,167,61,228
"BAMYAN","YAKAWLANG",1005077,1,104,87,191
"BAMYAN","YAKAWLANG",1005089,2,337,167,504
"BAMYAN","YAKAWLANG",1005073,1,170,56,226
"BAMYAN","YAKAWLANG",1005166,2,162,86,248
"BAMYAN","YAKAWLANG",1005166,1,153,117,270
"BAMYAN","YAKAWLANG",1005093,1,441,158,599
"BAMYAN","YAKAWLANG",1005089,3,518,81,599
"BAMYAN","YAKAWLANG",1005073,2,63,10,73
"BAMYAN","YAKAWLANG",1005090,2,445,137,582
"BAMYAN","YAKAWLANG",1005086,1,486,100,586
"BAMYAN","YAKAWLANG",1005077,2,92,43,135
"BAMYAN","YAKAWLANG",1005090,1,483,108,591
"BAMYAN","YAKAWLANG",1005085,2,137,43,180
"BAMYAN","YAKAWLANG",1005089,1,413,43,456
"BAMYAN","YAKAWLANG",1005094,1,402,61,463
"BAMYAN","YAKAWLANG",1005094,2,330,48,378
"BAMYAN","YAKAWLANG",1005094,3,543,45,588
"BAMYAN","YAKAWLANG",1005175,1,310,60,370
"BAMYAN","YAKAWLANG",1005175,2,257,50,307
"BAMYAN","YAKAWLANG",1005175,3,354,54,408
"BAMYAN","YAKAWLANG",1005178,1,140,21,161
"BAMYAN","YAKAWLANG",1005178,2,141,13,154
"BAMYAN","YAKAWLANG",1005178,3,203,21,224
"BAMYAN","YAKAWLANG",1005086,2,524,54,578
"BAMYAN","YAKAWLANG",1005085,1,240,124,364
"BAMYAN","YAKAWLANG",1005176,2,297,45,342
"BAMYAN","YAKAWLANG",1005176,3,382,37,419
"BAMYAN","YAKAWLANG",1005092,2,245,103,348
"BAMYAN","YAKAWLANG",1005095,2,422,108,530
"BAMYAN","YAKAWLANG",1005075,1,451,132,583
"BAMYAN","YAKAWLANG",1005075,2,202,42,244
"BAMYAN","YAKAWLANG",1005075,3,247,48,295
"BAMYAN","YAKAWLANG",1005069,1,191,134,325
"BAMYAN","YAKAWLANG",1005069,2,344,180,524
"BAMYAN","YAKAWLANG",1005088,1,208,99,307
"BAMYAN","YAKAWLANG",1005088,2,138,284,422
"BAMYAN","YAKAWLANG",1005069,5,298,82,380
"BAMYAN","YAKAWLANG",1005069,6,272,107,379
"BAMYAN","YAKAWLANG",1005070,1,341,112,453
"BAMYAN","YAKAWLANG",1005070,2,160,55,215
"BAMYAN","YAKAWLANG",1005070,3,167,39,206
"BAMYAN","YAKAWLANG",1005078,1,273,148,421
"BAMYAN","YAKAWLANG",1005078,2,232,85,317
"BAMYAN","YAKAWLANG",1005079,1,400,188,588
"BAMYAN","YAKAWLANG",1005079,2,186,123,309
"BAMYAN","YAKAWLANG",1005081,1,296,23,319
"BAMYAN","YAKAWLANG",1005093,2,435,163,598
"BAMYAN","YAKAWLANG",1005179,1,84,22,106
"BAMYAN","YAKAWLANG",1005179,2,51,48,99
"BAMYAN","YAKAWLANG",1005179,3,111,46,157
"BAMYAN","YAKAWLANG",1005091,1,235,119,354
"BAMYAN","YAKAWLANG",1005091,2,389,52,441
"BAMYAN","YAKAWLANG",1005176,1,352,85,437
"BAMYAN","YAKAWLANG",1005083,2,239,27,266
"BAMYAN","YAKAWLANG",1005080,1,413,90,503
"BAMYAN","YAKAWLANG",1005080,2,384,37,421
"BAMYAN","YAKAWLANG",1005082,1,324,156,480
"BAMYAN","YAKAWLANG",1005082,2,377,98,475
"BAMYAN","YAKAWLANG",1005087,1,466,75,541
"BAMYAN","YAKAWLANG",1005087,2,203,123,326
"BAMYAN","YAKAWLANG",1005071,1,257,56,313
"BAMYAN","YAKAWLANG",1005071,2,301,103,404
"BAMYAN","YAKAWLANG",1005071,3,523,71,594
"BAMYAN","YAKAWLANG",1005174,1,342,253,595
"BAMYAN","YAKAWLANG",1005174,2,427,163,590
"BAMYAN","YAKAWLANG",1005174,3,379,72,451
"BAMYAN","YAKAWLANG",1005092,1,423,120,543
"BAMYAN","YAKAWLANG",1005164,1,151,73,224
"BAMYAN","YAKAWLANG",1005164,2,104,22,126
"BAMYAN","YAKAWLANG",1005095,1,391,199,590
"BAMYAN","YAKAWLANG",1005069,3,283,194,477
"BAMYAN","YAKAWLANG",1005069,4,336,100,436
"BAMYAN","YAKAWLANG",1005074,2,265,99,364
"BAMYAN","YAKAWLANG",1005081,2,264,35,299
"BAMYAN","YAKAWLANG",1005074,4,251,64,315
"BAMYAN","YAKAWLANG",1005083,1,242,54,296
"BAMYAN","YAKAWLANG",1005072,2,235,31,266
"BAMYAN","YAKAWLANG",1005074,3,282,61,343
"BAMYAN","YAKAWLANG",1005165,2,119,28,147
"BAMYAN","YAKAWLANG",1005081,3,342,31,373
"BAMYAN","YAKAWLANG",1005074,1,352,98,450
"BAMYAN","YAKAWLANG",1005165,1,119,21,140
"BAMYAN","YAKAWLANG",1005076,1,142,117,259
"BAMYAN","YAKAWLANG",1005076,2,153,65,218
"BAMYAN","YAKAWLANG",1005072,1,178,26,204
"BAMYAN","PANJAB",1006114,2,301,42,343
"BAMYAN","PANJAB",1006111,1,174,46,220
"BAMYAN","PANJAB",1006183,1,86,23,109
"BAMYAN","PANJAB",1006183,2,83,21,104
"BAMYAN","PANJAB",1006112,2,133,179,312
"BAMYAN","PANJAB",1006114,1,245,63,308
"BAMYAN","PANJAB",1006182,2,108,22,130
"BAMYAN","PANJAB",1006182,3,179,30,209
"BAMYAN","PANJAB",1006111,2,136,31,167
"BAMYAN","PANJAB",1006111,3,309,54,363
"BAMYAN","PANJAB",1006112,1,148,67,215
"BAMYAN","PANJAB",1006107,1,550,50,600
"BAMYAN","PANJAB",1006183,3,202,21,223
"BAMYAN","PANJAB",1006182,1,177,30,207
"BAMYAN","PANJAB",1006115,1,335,70,405
"BAMYAN","PANJAB",1006115,2,246,92,338
"BAMYAN","PANJAB",1006107,2,508,63,571
"BAMYAN","PANJAB",1006107,3,555,21,576
"BAMYAN","PANJAB",1006105,1,438,137,575
"BAMYAN","PANJAB",1006105,2,170,68,238
"BAMYAN","PANJAB",1006180,1,86,44,130
"BAMYAN","PANJAB",1006180,2,108,17,125
"BAMYAN","PANJAB",1006184,2,150,29,179
"BAMYAN","PANJAB",1006184,3,286,26,312
"BAMYAN","PANJAB",1006110,2,107,51,158
"BAMYAN","PANJAB",1006097,3,295,105,400
"BAMYAN","PANJAB",1006098,1,358,165,523
"BAMYAN","PANJAB",1006098,2,271,73,344
"BAMYAN","PANJAB",1006181,1,222,287,509
"BAMYAN","PANJAB",1006181,2,260,250,510
"BAMYAN","PANJAB",1006096,1,352,71,423
"BAMYAN","PANJAB",1006096,2,329,69,398
"BAMYAN","PANJAB",1006096,3,380,67,447
"BAMYAN","PANJAB",1006105,3,184,54,238
"BAMYAN","PANJAB",1006184,1,170,47,217
"BAMYAN","PANJAB",1006103,1,405,129,534
"BAMYAN","PANJAB",1006103,2,364,106,470
"BAMYAN","PANJAB",1006097,2,154,45,199
"BAMYAN","PANJAB",1006117,3,324,171,495
"BAMYAN","PANJAB",1006099,1,133,42,175
"BAMYAN","PANJAB",1006099,2,156,69,225
"BAMYAN","PANJAB",1006099,3,245,298,543
"BAMYAN","PANJAB",1006101,1,256,21,277
"BAMYAN","PANJAB",1006181,3,316,86,402
"BAMYAN","PANJAB",1006106,1,385,108,493
"BAMYAN","PANJAB",1006106,2,292,55,347
"BAMYAN","PANJAB",1006096,4,295,50,345
"BAMYAN","PANJAB",1006113,1,160,79,239
"BAMYAN","PANJAB",1006113,2,183,63,246
"BAMYAN","PANJAB",1006097,1,186,27,213
"BAMYAN","PANJAB",1006117,2,281,175,456
"BAMYAN","PANJAB",1006110,1,118,34,152
"BAMYAN","PANJAB",1006101,2,338,26,364
"BAMYAN","PANJAB",1006100,1,319,90,409
"BAMYAN","PANJAB",1006100,2,307,46,353
"BAMYAN","PANJAB",1006104,1,221,24,245
"BAMYAN","PANJAB",1006104,2,236,47,283
"BAMYAN","PANJAB",1006104,3,293,28,321
"BAMYAN","PANJAB",1006117,1,340,154,494
"BAMYAN","PANJAB",1006109,2,183,15,198
"BAMYAN","PANJAB",1006109,1,215,22,237
"BAMYAN","PANJAB",1006102,3,159,70,229
"BAMYAN","PANJAB",1006112,3,222,46,268
"BAMYAN","PANJAB",1006118,1,257,124,381
"BAMYAN","PANJAB",1006118,2,223,118,341
"BAMYAN","PANJAB",1006102,2,167,135,302
"BAMYAN","PANJAB",1006116,1,274,101,375
"BAMYAN","PANJAB",1006116,2,379,22,401
"BAMYAN","PANJAB",1006108,2,176,25,201
"BAMYAN","PANJAB",1006180,3,157,14,171
"BAMYAN","PANJAB",1006102,1,122,49,171
"BAMYAN","PANJAB",1006108,1,138,30,168
"BAMYAN","WARAS",1007142,2,217,46,263
"BAMYAN","WARAS",1007142,1,271,56,327
"BAMYAN","WARAS",1007125,3,350,103,453
"BAMYAN","WARAS",1007119,2,107,21,128
"BAMYAN","WARAS",1007119,3,98,12,110
"BAMYAN","WARAS",1007124,1,146,54,200
"BAMYAN","WARAS",1007128,2,58,41,99
"BAMYAN","WARAS",1007128,3,163,39,202
"BAMYAN","WARAS",1007121,1,296,54,350
"BAMYAN","WARAS",1007119,1,214,56,270
"BAMYAN","WARAS",1007122,1,265,55,320
"BAMYAN","WARAS",1007122,2,261,76,337
"BAMYAN","WARAS",1007122,3,277,106,383
"BAMYAN","WARAS",1007121,2,364,29,393
"BAMYAN","WARAS",1007131,2,517,67,584
"BAMYAN","WARAS",1007143,1,389,78,467
"BAMYAN","WARAS",1007130,1,324,45,369
"BAMYAN","WARAS",1007131,1,504,88,592
"BAMYAN","WARAS",1007128,1,61,18,79
"BAMYAN","WARAS",1007160,2,180,70,250
"BAMYAN","WARAS",1007135,1,155,30,185
"BAMYAN","WARAS",1007135,2,186,21,207
"BAMYAN","WARAS",1007125,2,134,50,184
"BAMYAN","WARAS",1007186,2,191,67,258
"BAMYAN","WARAS",1007186,3,164,11,175
"BAMYAN","WARAS",1007120,1,243,77,320
"BAMYAN","WARAS",1007120,2,280,52,332
"BAMYAN","WARAS",1007188,1,151,30,181
"BAMYAN","WARAS",1007124,2,110,40,150
"BAMYAN","WARAS",1007124,3,257,44,301
"BAMYAN","WARAS",1007130,2,461,34,495
"BAMYAN","WARAS",1007187,2,83,65,148
"BAMYAN","WARAS",1007187,3,134,26,160
"BAMYAN","WARAS",1007156,1,120,24,144
"BAMYAN","WARAS",1007156,2,122,31,153
"BAMYAN","WARAS",1007156,3,291,22,313
"BAMYAN","WARAS",1007139,1,310,63,373
"BAMYAN","WARAS",1007139,2,148,23,171
"BAMYAN","WARAS",1007154,2,113,27,140
"BAMYAN","WARAS",1007154,3,202,57,259
"BAMYAN","WARAS",1007140,1,412,175,587
"BAMYAN","WARAS",1007140,2,247,79,326
"BAMYAN","WARAS",1007134,1,181,38,219
"BAMYAN","WARAS",1007187,1,85,134,219
"BAMYAN","WARAS",1007146,1,531,65,596
"BAMYAN","WARAS",1007146,2,479,27,506
"BAMYAN","WARAS",1007160,1,387,40,427
"BAMYAN","WARAS",1007149,1,193,12,205
"BAMYAN","WARAS",1007149,2,134,20,154
"BAMYAN","WARAS",1007149,3,309,44,353
"BAMYAN","WARAS",1007132,1,252,23,275
"BAMYAN","WARAS",1007132,2,172,69,241
"BAMYAN","WARAS",1007132,3,298,25,323
"BAMYAN","WARAS",1007123,1,202,43,245
"BAMYAN","WARAS",1007123,2,209,35,244
"BAMYAN","WARAS",1007133,1,569,20,589
"BAMYAN","WARAS",1007143,2,320,27,347
"BAMYAN","WARAS",1007133,3,307,17,324
"BAMYAN","WARAS",1007138,1,460,138,598
"BAMYAN","WARAS",1007138,2,333,262,595
"BAMYAN","WARAS",1007145,1,167,42,209
"BAMYAN","WARAS",1007145,2,190,47,237
"BAMYAN","WARAS",1007186,1,102,33,135
"BAMYAN","WARAS",1007158,2,566,29,595
"BAMYAN","WARAS",1007151,1,138,5,143
"BAMYAN","WARAS",1007151,2,199,3,202
"BAMYAN","WARAS",1007148,1,288,65,353
"BAMYAN","WARAS",1007148,2,340,57,397
"BAMYAN","WARAS",1007141,1,203,26,229
"BAMYAN","WARAS",1007141,2,176,8,184
"BAMYAN","WARAS",1007144,1,143,40,183
"BAMYAN","WARAS",1007144,2,124,83,207
"BAMYAN","WARAS",1007152,1,134,94,228
"BAMYAN","WARAS",1007152,2,94,19,113
"BAMYAN","WARAS",1007155,1,256,80,336
"BAMYAN","WARAS",1007155,2,181,47,228
"BAMYAN","WARAS",1007155,3,166,50,216
"BAMYAN","WARAS",1007154,1,102,26,128
"BAMYAN","WARAS",1007147,2,549,47,596
"BAMYAN","WARAS",1007161,1,219,80,299
"BAMYAN","WARAS",1007153,1,428,17,445
"BAMYAN","WARAS",1007153,2,316,9,325
"BAMYAN","WARAS",1007162,1,264,29,293
"BAMYAN","WARAS",1007134,2,137,21,158
"BAMYAN","WARAS",1007134,3,248,22,270
"BAMYAN","WARAS",1007137,1,222,79,301
"BAMYAN","WARAS",1007137,2,109,35,144
"BAMYAN","WARAS",1007159,3,321,8,329
"BAMYAN","WARAS",1007157,1,94,27,121
"BAMYAN","WARAS",1007157,2,118,18,136
"BAMYAN","WARAS",1007147,1,494,98,592
"BAMYAN","WARAS",1007157,3,249,31,280
"BAMYAN","WARAS",1007127,1,200,94,294
"BAMYAN","WARAS",1007161,2,78,23,101
"BAMYAN","WARAS",1007129,1,37,447,484
"BAMYAN","WARAS",1007129,2,533,15,548
"BAMYAN","WARAS",1007133,2,519,61,580
"BAMYAN","WARAS",1007136,1,167,32,199
"BAMYAN","WARAS",1007136,2,142,18,160
"BAMYAN","WARAS",1007136,3,142,18,160
"BAMYAN","WARAS",1007126,1,100,24,124
"BAMYAN","WARAS",1007126,2,108,39,147
"BAMYAN","WARAS",1007126,3,239,53,292
"BAMYAN","WARAS",1007125,1,194,70,264
"BAMYAN","WARAS",1007158,1,464,41,505
"BAMYAN","WARAS",1007159,2,131,25,156
"BAMYAN","WARAS",1007127,2,76,28,104
"BAMYAN","WARAS",1007127,3,300,118,418
"BAMYAN","WARAS",1007159,1,225,14,239
"BAMYAN","WARAS",1007185,1,137,9,146
"BAMYAN","WARAS",1007188,2,227,34,261
"BAMYAN","WARAS",1007188,3,226,38,264
"BAMYAN","WARAS",1007150,2,140,13,153
"BAMYAN","WARAS",1007185,3,212,12,224
"BAMYAN","WARAS",1007150,1,136,17,153
"BAMYAN","WARAS",1007162,2,390,49,439
"BAMYAN","WARAS",1007185,2,121,11,132
"KABUL","KABUL",101299,2,159,35,194
"KABUL","KABUL",101303,6,268,101,369
"KABUL","KABUL",101303,5,261,73,334
"KABUL","KABUL",101307,2,239,48,287
"KABUL","KABUL",101307,4,99,20,119
"KABUL","KABUL",101305,1,245,47,292
"KABUL","KABUL",101307,3,80,8,88
"KABUL","KABUL",101305,2,200,39,239
"KABUL","KABUL",101305,3,102,20,122
"KABUL","KABUL",101301,2,174,97,271
"KABUL","KABUL",101303,4,175,89,264
"KABUL","KABUL",101307,1,243,56,299
"KABUL","KABUL",101303,2,202,108,310
"KABUL","KABUL",101303,3,266,134,400
"KABUL","KABUL",101301,1,217,163,380
"KABUL","KABUL",101308,1,175,19,194
"KABUL","KABUL",101278,4,493,93,586
"KABUL","KABUL",101267,1,223,51,274
"KABUL","KABUL",101299,1,200,39,239
"KABUL","KABUL",101303,8,107,69,176
"KABUL","KABUL",101268,1,534,60,594
"KABUL","KABUL",101303,7,184,72,256
"KABUL","KABUL",101305,4,108,17,125
"KABUL","KABUL",101300,4,82,18,100
"KABUL","KABUL",101303,1,293,133,426
"KABUL","KABUL",101255,4,11,125,136
"KABUL","KABUL",101255,5,10,182,192
"KABUL","KABUL",101136,1,98,479,577
"KABUL","KABUL",101267,2,190,36,226
"KABUL","KABUL",101267,3,136,24,160
"KABUL","KABUL",101267,4,200,40,240
"KABUL","KABUL",101267,5,243,24,267
"KABUL","KABUL",101267,6,328,37,365
"KABUL","KABUL",101306,1,192,174,366
"KABUL","KABUL",101301,3,134,95,229
"KABUL","KABUL",101301,4,142,116,258
"KABUL","KABUL",101301,5,137,118,255
"KABUL","KABUL",101293,7,210,93,303
"KABUL","KABUL",101268,5,481,34,515
"KABUL","KABUL",101268,6,488,29,517
"KABUL","KABUL",101278,1,498,96,594
"KABUL","KABUL",101514,4,1,595,596
"KABUL","KABUL",101514,5,15,584,599
"KABUL","KABUL",101514,6,2,429,431
"KABUL","KABUL",101278,5,553,38,591
"KABUL","KABUL",101278,6,548,43,591
"KABUL","KABUL",101267,7,215,22,237
"KABUL","KABUL",101152,3,163,426,589
"KABUL","KABUL",101293,5,145,75,220
"KABUL","KABUL",101293,6,178,86,264
"KABUL","KABUL",101300,3,77,25,102
"KABUL","KABUL",101306,4,104,88,192
"KABUL","KABUL",101293,8,84,58,142
"KABUL","KABUL",101293,9,71,56,127
"KABUL","KABUL",101306,7,87,80,167
"KABUL","KABUL",101448,5,2,595,597
"KABUL","KABUL",101448,6,2,597,599
"KABUL","KABUL",101448,7,3,597,600
"KABUL","KABUL",101448,8,2,598,600
"KABUL","KABUL",101323,3,40,113,153
"KABUL","KABUL",101278,7,543,43,586
"KABUL","KABUL",101268,2,473,50,523
"KABUL","KABUL",101268,3,526,66,592
"KABUL","KABUL",101268,4,488,35,523
"KABUL","KABUL",101511,7,6,586,592
"KABUL","KABUL",101511,8,0,596,596
"KABUL","KABUL",101285,4,219,44,263
"KABUL","KABUL",101449,6,1,592,593
"KABUL","KABUL",101136,2,100,483,583
"KABUL","KABUL",101136,3,69,520,589
"KABUL","KABUL",101136,4,7,19,26
"KABUL","KABUL",101136,5,3,13,16
"KABUL","KABUL",101152,1,135,459,594
"KABUL","KABUL",101152,2,92,326,418
"KABUL","KABUL",101278,8,528,55,583
"KABUL","KABUL",101306,2,268,310,578
"KABUL","KABUL",101306,3,197,285,482
"KABUL","KABUL",101152,6,36,89,125
"KABUL","KABUL",101514,1,10,582,592
"KABUL","KABUL",101514,2,9,582,591
"KABUL","KABUL",101514,3,2,597,599
"KABUL","KABUL",101295,2,300,150,450
"KABUL","KABUL",101295,3,146,95,241
"KABUL","KABUL",101295,4,86,40,126
"KABUL","KABUL",101323,1,160,262,422
"KABUL","KABUL",101323,2,132,312,444
"KABUL","KABUL",101293,1,340,176,516
"KABUL","KABUL",101298,2,193,166,359
"KABUL","KABUL",101152,4,103,365,468
"KABUL","KABUL",101152,5,109,472,581
"KABUL","KABUL",101532,3,5,590,595
"KABUL","KABUL",101448,1,15,579,594
"KABUL","KABUL",101448,2,3,596,599
"KABUL","KABUL",101448,3,2,596,598
"KABUL","KABUL",101448,4,1,597,598
"KABUL","KABUL",101512,3,10,203,213
"KABUL","KABUL",101512,4,115,81,196
"KABUL","KABUL",101308,2,177,28,205
"KABUL","KABUL",101308,3,111,11,122
"KABUL","KABUL",101304,2,235,55,290
"KABUL","KABUL",101293,2,173,121,294
"KABUL","KABUL",101293,3,119,41,160
"KABUL","KABUL",101293,4,150,65,215
"KABUL","KABUL",101300,2,149,45,194
"KABUL","KABUL",101511,6,0,600,600
"KABUL","KABUL",101156,4,86,110,196
"KABUL","KABUL",101317,1,190,381,571
"KABUL","KABUL",101317,2,226,352,578
"KABUL","KABUL",101317,3,200,381,581
"KABUL","KABUL",101317,4,205,329,534
"KABUL","KABUL",101317,5,146,251,397
"KABUL","KABUL",101317,6,142,287,429
"KABUL","KABUL",101317,7,174,412,586
"KABUL","KABUL",101313,1,6,343,349
"KABUL","KABUL",101313,2,10,424,434
"KABUL","KABUL",101298,3,160,137,297
"KABUL","KABUL",101298,4,265,268,533
"KABUL","KABUL",101298,5,95,40,135
"KABUL","KABUL",101298,6,52,16,68
"KABUL","KABUL",101298,7,53,17,70
"KABUL","KABUL",101295,1,267,131,398
"KABUL","KABUL",101314,2,197,245,442
"KABUL","KABUL",101314,3,260,276,536
"KABUL","KABUL",101314,4,275,310,585
"KABUL","KABUL",101314,5,257,330,587
"KABUL","KABUL",101314,6,296,292,588
"KABUL","KABUL",101314,7,158,247,405
"KABUL","KABUL",101314,8,185,241,426
"KABUL","KABUL",101314,9,86,146,232
"KABUL","KABUL",101311,1,252,32,284
"KABUL","KABUL",101269,1,435,99,534
"KABUL","KABUL",101269,2,462,129,591
"KABUL","KABUL",101269,3,340,66,406
"KABUL","KABUL",101306,5,87,101,188
"KABUL","KABUL",101306,6,127,111,238
"KABUL","KABUL",101554,3,528,59,587
"KABUL","KABUL",101554,4,393,73,466
"KABUL","KABUL",101554,5,528,47,575
"KABUL","KABUL",101510,1,81,501,582
"KABUL","KABUL",101511,1,0,600,600
"KABUL","KABUL",101304,3,182,62,244
"KABUL","KABUL",101304,4,128,23,151
"KABUL","KABUL",101304,5,129,22,151
"KABUL","KABUL",101300,1,145,26,171
"KABUL","KABUL",101449,2,9,587,596
"KABUL","KABUL",101449,3,1,588,589
"KABUL","KABUL",101449,4,1,595,596
"KABUL","KABUL",101449,5,3,594,597
"KABUL","KABUL",101146,4,30,82,112
"KABUL","KABUL",101146,5,56,125,181
"KABUL","KABUL",101146,6,57,72,129
"KABUL","KABUL",101144,1,266,252,518
"KABUL","KABUL",101144,2,266,237,503
"KABUL","KABUL",101144,3,241,250,491
"KABUL","KABUL",101144,4,377,201,578
"KABUL","KABUL",101313,3,19,505,524
"KABUL","KABUL",101313,4,12,373,385
"KABUL","KABUL",101313,5,7,423,430
"KABUL","KABUL",101313,6,5,276,281
"KABUL","KABUL",101313,7,5,241,246
"KABUL","KABUL",101314,1,290,293,583
"KABUL","KABUL",101147,7,37,107,144
"KABUL","KABUL",101147,8,30,117,147
"KABUL","KABUL",101147,9,27,94,121
"KABUL","KABUL",101145,1,287,224,511
"KABUL","KABUL",101295,5,86,42,128
"KABUL","KABUL",101295,6,83,40,123
"KABUL","KABUL",101145,4,316,204,520
"KABUL","KABUL",101148,1,88,134,222
"KABUL","KABUL",101148,2,108,122,230
"KABUL","KABUL",101148,3,93,115,208
"KABUL","KABUL",101148,4,78,111,189
"KABUL","KABUL",101148,5,72,41,113
"KABUL","KABUL",101148,6,49,75,124
"KABUL","KABUL",101148,7,35,63,98
"KABUL","KABUL",101148,8,43,117,160
"KABUL","KABUL",101150,1,127,206,333
"KABUL","KABUL",101150,2,109,173,282
"KABUL","KABUL",101150,3,105,172,277
"KABUL","KABUL",101150,4,54,65,119
"KABUL","KABUL",101511,2,4,571,575
"KABUL","KABUL",101511,3,2,597,599
"KABUL","KABUL",101511,4,2,596,598
"KABUL","KABUL",101511,5,1,597,598
"KABUL","KABUL",101156,2,179,268,447
"KABUL","KABUL",101156,3,93,147,240
"KABUL","KABUL",101524,6,4,51,55
"KABUL","KABUL",101496,1,367,30,397
"KABUL","KABUL",101496,2,478,48,526
"KABUL","KABUL",101496,3,460,21,481
"KABUL","KABUL",101498,1,71,493,564
"KABUL","KABUL",101498,2,5,30,35
"KABUL","KABUL",101498,3,57,478,535
"KABUL","KABUL",101498,4,99,494,593
"KABUL","KABUL",101498,5,34,217,251
"KABUL","KABUL",101147,1,134,446,580
"KABUL","KABUL",101147,2,141,448,589
"KABUL","KABUL",101147,3,113,447,560
"KABUL","KABUL",101147,4,54,148,202
"KABUL","KABUL",101147,5,44,245,289
"KABUL","KABUL",101147,6,58,106,164
"KABUL","KABUL",101534,4,397,188,585
"KABUL","KABUL",101534,5,363,113,476
"KABUL","KABUL",101534,6,136,54,190
"KABUL","KABUL",101534,7,206,102,308
"KABUL","KABUL",101430,1,68,169,237
"KABUL","KABUL",101430,2,38,98,136
"KABUL","KABUL",101430,3,26,50,76
"KABUL","KABUL",101430,4,27,46,73
"KABUL","KABUL",101430,5,14,53,67
"KABUL","KABUL",101430,6,9,73,82
"KABUL","KABUL",101311,2,297,36,333
"KABUL","KABUL",101311,3,207,12,219
"KABUL","KABUL",101311,4,204,10,214
"KABUL","KABUL",101512,1,31,180,211
"KABUL","KABUL",101512,2,36,282,318
"KABUL","KABUL",101269,5,250,33,283
"KABUL","KABUL",101279,1,269,94,363
"KABUL","KABUL",101512,5,14,59,73
"KABUL","KABUL",101512,6,16,184,200
"KABUL","KABUL",101150,5,37,50,87
"KABUL","KABUL",101150,6,60,143,203
"KABUL","KABUL",101150,7,66,158,224
"KABUL","KABUL",101156,1,122,165,287
"KABUL","KABUL",101302,4,100,49,149
"KABUL","KABUL",101302,5,91,60,151
"KABUL","KABUL",101310,1,322,114,436
"KABUL","KABUL",101310,2,318,110,428
"KABUL","KABUL",101310,3,141,34,175
"KABUL","KABUL",101310,4,128,67,195
"KABUL","KABUL",101309,1,359,121,480
"KABUL","KABUL",101309,2,350,134,484
"KABUL","KABUL",101309,3,128,26,154
"KABUL","KABUL",101309,4,138,19,157
"KABUL","KABUL",101473,1,5,591,596
"KABUL","KABUL",101498,6,23,323,346
"KABUL","KABUL",101498,7,66,523,589
"KABUL","KABUL",101498,8,14,579,593
"KABUL","KABUL",101534,1,395,187,582
"KABUL","KABUL",101534,2,386,201,587
"KABUL","KABUL",101534,3,376,200,576
"KABUL","KABUL",101473,8,2,589,591
"KABUL","KABUL",101473,9,5,592,597
"KABUL","KABUL",101473,10,0,591,591
"KABUL","KABUL",101473,11,13,584,597
"KABUL","KABUL",101332,1,15,585,600
"KABUL","KABUL",101332,2,6,586,592
"KABUL","KABUL",101332,3,3,596,599
"KABUL","KABUL",101332,4,2,596,598
"KABUL","KABUL",101332,5,1,298,299
"KABUL","KABUL",101332,6,11,585,596
"KABUL","KABUL",101332,7,8,589,597
"KABUL","KABUL",101332,8,18,580,598
"KABUL","KABUL",101332,9,1,597,598
"KABUL","KABUL",101554,1,495,99,594
"KABUL","KABUL",101554,2,504,86,590
"KABUL","KABUL",101297,3,78,29,107
"KABUL","KABUL",101297,4,90,30,120
"KABUL","KABUL",101297,5,81,13,94
"KABUL","KABUL",101297,6,66,11,77
"KABUL","KABUL",101510,2,86,489,575
"KABUL","KABUL",101510,3,3,589,592
"KABUL","KABUL",101510,4,5,594,599
"KABUL","KABUL",101510,5,0,597,597
"KABUL","KABUL",101449,1,5,585,590
"KABUL","KABUL",101176,13,1,317,318
"KABUL","KABUL",101176,14,1,207,208
"KABUL","KABUL",101497,1,34,551,585
"KABUL","KABUL",101497,2,33,553,586
"KABUL","KABUL",101497,3,63,522,585
"KABUL","KABUL",101497,4,58,475,533
"KABUL","KABUL",101449,7,1,596,597
"KABUL","KABUL",101530,1,392,34,426
"KABUL","KABUL",101530,2,441,47,488
"KABUL","KABUL",101530,3,451,40,491
"KABUL","KABUL",101529,1,224,29,253
"KABUL","KABUL",101529,2,222,30,252
"KABUL","KABUL",101529,3,230,31,261
"KABUL","KABUL",101509,1,0,428,428
"KABUL","KABUL",101509,2,5,488,493
"KABUL","KABUL",101509,3,0,584,584
"KABUL","KABUL",101509,4,0,599,599
"KABUL","KABUL",101509,5,0,600,600
"KABUL","KABUL",101509,6,3,593,596
"KABUL","KABUL",101509,7,7,593,600
"KABUL","KABUL",101528,1,313,80,393
"KABUL","KABUL",101145,2,150,145,295
"KABUL","KABUL",101145,3,165,167,332
"KABUL","KABUL",101535,1,7,593,600
"KABUL","KABUL",101535,2,61,539,600
"KABUL","KABUL",101535,3,10,571,581
"KABUL","KABUL",101532,1,11,579,590
"KABUL","KABUL",101532,2,62,517,579
"KABUL","KABUL",101525,4,50,541,591
"KABUL","KABUL",101525,5,50,528,578
"KABUL","KABUL",101495,1,380,17,397
"KABUL","KABUL",101495,2,549,28,577
"KABUL","KABUL",101495,3,474,22,496
"KABUL","KABUL",101495,4,540,41,581
"KABUL","KABUL",101522,1,412,50,462
"KABUL","KABUL",101522,2,386,55,441
"KABUL","KABUL",101522,3,418,40,458
"KABUL","KABUL",101524,1,78,514,592
"KABUL","KABUL",101524,2,72,520,592
"KABUL","KABUL",101524,3,79,503,582
"KABUL","KABUL",101524,4,44,320,364
"KABUL","KABUL",101524,5,45,410,455
"KABUL","KABUL",101285,1,262,120,382
"KABUL","KABUL",101285,2,291,149,440
"KABUL","KABUL",101285,3,265,60,325
"KABUL","KABUL",101021,5,2,2,4
"KABUL","KABUL",101021,6,12,5,17
"KABUL","KABUL",101021,7,23,3,26
"KABUL","KABUL",101021,8,27,11,38
"KABUL","KABUL",101020,1,85,53,138
"KABUL","KABUL",101020,2,125,69,194
"KABUL","KABUL",101020,3,44,25,69
"KABUL","KABUL",101026,1,401,58,459
"KABUL","KABUL",101026,2,292,39,331
"KABUL","KABUL",101023,1,167,83,250
"KABUL","KABUL",101023,2,125,63,188
"KABUL","KABUL",101023,3,127,42,169
"KABUL","KABUL",101023,4,93,40,133
"KABUL","KABUL",101023,5,75,34,109
"KABUL","KABUL",101023,6,49,17,66
"KABUL","KABUL",101034,1,182,201,383
"KABUL","KABUL",101034,2,107,117,224
"KABUL","KABUL",101034,3,92,93,185
"KABUL","KABUL",101034,4,54,53,107
"KABUL","KABUL",101034,5,26,34,60
"KABUL","KABUL",101034,6,43,39,82
"KABUL","KABUL",101034,7,24,29,53
"KABUL","KABUL",101430,7,3,55,58
"KABUL","KABUL",101430,8,6,42,48
"KABUL","KABUL",101430,9,9,82,91
"KABUL","KABUL",101001,1,38,45,83
"KABUL","KABUL",101269,4,228,34,262
"KABUL","KABUL",101025,5,224,69,293
"KABUL","KABUL",101025,6,329,76,405
"KABUL","KABUL",101279,2,265,100,365
"KABUL","KABUL",101279,3,305,71,376
"KABUL","KABUL",101308,4,101,7,108
"KABUL","KABUL",101302,1,94,57,151
"KABUL","KABUL",101302,2,85,50,135
"KABUL","KABUL",101302,3,82,48,130
"KABUL","KABUL",101512,11,100,476,576
"KABUL","KABUL",101507,1,364,162,526
"KABUL","KABUL",101507,2,393,145,538
"KABUL","KABUL",101507,3,87,17,104
"KABUL","KABUL",101507,4,89,17,106
"KABUL","KABUL",101507,5,94,36,130
"KABUL","KABUL",101506,1,206,315,521
"KABUL","KABUL",101506,2,60,200,260
"KABUL","KABUL",101531,1,392,164,556
"KABUL","KABUL",101531,2,416,165,581
"KABUL","KABUL",101531,3,410,175,585
"KABUL","KABUL",101473,2,12,578,590
"KABUL","KABUL",101473,3,0,598,598
"KABUL","KABUL",101473,4,0,591,591
"KABUL","KABUL",101473,5,0,598,598
"KABUL","KABUL",101473,6,0,595,595
"KABUL","KABUL",101473,7,0,593,593
"KABUL","KABUL",101505,4,177,200,377
"KABUL","KABUL",101523,1,385,35,420
"KABUL","KABUL",101523,2,382,39,421
"KABUL","KABUL",101523,3,345,18,363
"KABUL","KABUL",101502,1,141,80,221
"KABUL","KABUL",101502,2,96,22,118
"KABUL","KABUL",101502,3,71,31,102
"KABUL","KABUL",101291,2,110,73,183
"KABUL","KABUL",101291,3,239,164,403
"KABUL","KABUL",101291,4,26,20,46
"KABUL","KABUL",101291,5,48,16,64
"KABUL","KABUL",101291,6,55,32,87
"KABUL","KABUL",101291,7,32,14,46
"KABUL","KABUL",101297,1,186,59,245
"KABUL","KABUL",101297,2,149,30,179
"KABUL","KABUL",101176,4,9,580,589
"KABUL","KABUL",101176,5,18,567,585
"KABUL","KABUL",101176,6,3,115,118
"KABUL","KABUL",101176,7,1,88,89
"KABUL","KABUL",101176,8,4,139,143
"KABUL","KABUL",101176,9,7,403,410
"KABUL","KABUL",101176,10,3,332,335
"KABUL","KABUL",101176,11,10,471,481
"KABUL","KABUL",101176,12,10,294,304
"KABUL","KABUL",101499,3,542,42,584
"KABUL","KABUL",101499,4,553,37,590
"KABUL","KABUL",101499,5,545,42,587
"KABUL","KABUL",101499,6,347,28,375
"KABUL","KABUL",101499,7,311,46,357
"KABUL","KABUL",101556,1,459,54,513
"KABUL","KABUL",101556,2,479,64,543
"KABUL","KABUL",101556,3,440,62,502
"KABUL","KABUL",101556,4,434,99,533
"KABUL","KABUL",101526,1,354,234,588
"KABUL","KABUL",101526,2,347,233,580
"KABUL","KABUL",101526,3,315,150,465
"KABUL","KABUL",101526,4,81,43,124
"KABUL","KABUL",101527,1,227,85,312
"KABUL","KABUL",101527,2,131,98,229
"KABUL","KABUL",101527,3,244,67,311
"KABUL","KABUL",101553,1,503,84,587
"KABUL","KABUL",101553,2,519,66,585
"KABUL","KABUL",101553,3,535,59,594
"KABUL","KABUL",101553,4,498,93,591
"KABUL","KABUL",101553,5,555,35,590
"KABUL","KABUL",101331,1,25,568,593
"KABUL","KABUL",101331,2,43,547,590
"KABUL","KABUL",101331,3,28,567,595
"KABUL","KABUL",101331,4,0,596,596
"KABUL","KABUL",101331,5,0,596,596
"KABUL","KABUL",101331,6,0,598,598
"KABUL","KABUL",101331,7,0,591,591
"KABUL","KABUL",101331,8,0,589,589
"KABUL","KABUL",101331,9,0,598,598
"KABUL","KABUL",101331,10,0,592,592
"KABUL","KABUL",101331,11,0,596,596
"KABUL","KABUL",101329,1,251,219,470
"KABUL","KABUL",101329,2,336,259,595
"KABUL","KABUL",101329,3,231,192,423
"KABUL","KABUL",101329,4,185,141,326
"KABUL","KABUL",101329,5,52,30,82
"KABUL","KABUL",101329,6,67,37,104
"KABUL","KABUL",101329,7,64,39,103
"KABUL","KABUL",101328,1,372,213,585
"KABUL","KABUL",101328,2,354,231,585
"KABUL","KABUL",101328,3,363,217,580
"KABUL","KABUL",101328,4,363,220,583
"KABUL","KABUL",101328,5,248,190,438
"KABUL","KABUL",101328,6,131,108,239
"KABUL","KABUL",101328,7,153,130,283
"KABUL","KABUL",101328,8,78,82,160
"KABUL","KABUL",101328,9,78,40,118
"KABUL","KABUL",101325,1,80,462,542
"KABUL","KABUL",101325,2,105,487,592
"KABUL","KABUL",101325,3,32,111,143
"KABUL","KABUL",101325,4,55,124,179
"KABUL","KABUL",101325,5,47,149,196
"KABUL","KABUL",101327,1,483,95,578
"KABUL","KABUL",101327,2,463,107,570
"KABUL","KABUL",101327,3,473,109,582
"KABUL","KABUL",101327,4,441,134,575
"KABUL","KABUL",101327,5,485,107,592
"KABUL","KABUL",101327,6,468,110,578
"KABUL","KABUL",101327,7,473,113,586
"KABUL","KABUL",101327,8,363,102,465
"KABUL","KABUL",101327,9,375,69,444
"KABUL","KABUL",101327,10,264,43,307
"KABUL","KABUL",101327,11,203,41,244
"KABUL","KABUL",101327,12,201,41,242
"KABUL","KABUL",101327,13,273,62,335
"KABUL","KABUL",101327,14,493,93,586
"KABUL","KABUL",101327,15,492,92,584
"KABUL","KABUL",101294,1,388,199,587
"KABUL","KABUL",101294,2,332,150,482
"KABUL","KABUL",101294,3,221,83,304
"KABUL","KABUL",101294,4,201,66,267
"KABUL","KABUL",101294,5,110,27,137
"KABUL","KABUL",101294,6,221,110,331
"KABUL","KABUL",101294,7,134,72,206
"KABUL","KABUL",101294,8,174,58,232
"KABUL","KABUL",101512,7,115,134,249
"KABUL","KABUL",101512,8,87,506,593
"KABUL","KABUL",101512,9,83,82,165
"KABUL","KABUL",101512,10,29,569,598
"KABUL","KABUL",101324,2,28,35,63
"KABUL","KABUL",101324,3,17,30,47
"KABUL","KABUL",101326,1,526,65,591
"KABUL","KABUL",101326,2,511,66,577
"KABUL","KABUL",101326,3,509,85,594
"KABUL","KABUL",101326,4,523,61,584
"KABUL","KABUL",101326,5,511,76,587
"KABUL","KABUL",101326,6,347,47,394
"KABUL","KABUL",101326,7,216,15,231
"KABUL","KABUL",101326,8,273,24,297
"KABUL","KABUL",101326,9,256,14,270
"KABUL","KABUL",101531,4,195,71,266
"KABUL","KABUL",101531,5,176,78,254
"KABUL","KABUL",101531,6,123,42,165
"KABUL","KABUL",101505,1,182,176,358
"KABUL","KABUL",101505,2,304,263,567
"KABUL","KABUL",101505,3,111,155,266
"KABUL","KABUL",101555,6,344,28,372
"KABUL","KABUL",101504,1,247,15,262
"KABUL","KABUL",101504,2,256,15,271
"KABUL","KABUL",101504,3,242,17,259
"KABUL","KABUL",101504,4,356,17,373
"KABUL","KABUL",101504,5,286,11,297
"KABUL","KABUL",101557,1,509,81,590
"KABUL","KABUL",101493,1,277,310,587
"KABUL","KABUL",101493,2,284,299,583
"KABUL","KABUL",101493,3,208,326,534
"KABUL","KABUL",101493,4,231,357,588
"KABUL","KABUL",101493,5,128,138,266
"KABUL","KABUL",101176,1,5,586,591
"KABUL","KABUL",101176,2,16,578,594
"KABUL","KABUL",101176,3,13,579,592
"KABUL","KABUL",101500,1,446,140,586
"KABUL","KABUL",101500,2,394,149,543
"KABUL","KABUL",101500,3,347,95,442
"KABUL","KABUL",101500,4,309,103,412
"KABUL","KABUL",101500,5,337,57,394
"KABUL","KABUL",101500,6,284,38,322
"KABUL","KABUL",101500,7,315,52,367
"KABUL","KABUL",101499,1,524,66,590
"KABUL","KABUL",101499,2,525,71,596
"KABUL","KABUL",101216,4,145,64,209
"KABUL","KABUL",101216,5,115,65,180
"KABUL","KABUL",101216,6,122,62,184
"KABUL","KABUL",101216,7,121,56,177
"KABUL","KABUL",101220,1,50,49,99
"KABUL","KABUL",101220,2,21,23,44
"KABUL","KABUL",101220,3,40,38,78
"KABUL","KABUL",101194,1,206,280,486
"KABUL","KABUL",101194,2,129,205,334
"KABUL","KABUL",101194,3,97,153,250
"KABUL","KABUL",101194,4,42,58,100
"KABUL","KABUL",101194,5,133,230,363
"KABUL","KABUL",101194,6,32,42,74
"KABUL","KABUL",101192,1,168,414,582
"KABUL","KABUL",101192,2,152,427,579
"KABUL","KABUL",101192,3,150,405,555
"KABUL","KABUL",101192,4,54,128,182
"KABUL","KABUL",101207,1,179,377,556
"KABUL","KABUL",101207,2,116,360,476
"KABUL","KABUL",101209,1,192,349,541
"KABUL","KABUL",101209,2,96,279,375
"KABUL","KABUL",101186,1,205,381,586
"KABUL","KABUL",101528,2,311,93,404
"KABUL","KABUL",101528,3,304,61,365
"KABUL","KABUL",101513,5,27,39,66
"KABUL","KABUL",101513,6,9,412,421
"KABUL","KABUL",101525,1,50,446,496
"KABUL","KABUL",101525,2,49,533,582
"KABUL","KABUL",101525,3,50,295,345
"KABUL","KABUL",101185,3,218,341,559
"KABUL","KABUL",101185,4,229,353,582
"KABUL","KABUL",101185,5,65,394,459
"KABUL","KABUL",101185,6,48,243,291
"KABUL","KABUL",101185,7,26,77,103
"KABUL","KABUL",101185,8,16,70,86
"KABUL","KABUL",101185,9,33,281,314
"KABUL","KABUL",101210,1,404,183,587
"KABUL","KABUL",101210,2,85,49,134
"KABUL","KABUL",101210,3,161,109,270
"KABUL","KABUL",101187,1,279,161,440
"KABUL","KABUL",101187,2,270,144,414
"KABUL","KABUL",101187,3,216,128,344
"KABUL","KABUL",101190,1,357,236,593
"KABUL","KABUL",101190,2,233,203,436
"KABUL","KABUL",101205,1,361,204,565
"KABUL","KABUL",101205,2,364,163,527
"KABUL","KABUL",101205,3,189,121,310
"KABUL","KABUL",101205,4,140,102,242
"KABUL","KABUL",101219,1,191,392,583
"KABUL","KABUL",101219,2,1,5,6
"KABUL","KABUL",101219,3,67,159,226
"KABUL","KABUL",101219,4,85,161,246
"KABUL","KABUL",101219,5,70,158,228
"KABUL","KABUL",101219,6,30,89,119
"KABUL","KABUL",101219,7,190,380,570
"KABUL","KABUL",101226,1,225,234,459
"KABUL","KABUL",101226,2,240,253,493
"KABUL","KABUL",101226,3,309,228,537
"KABUL","KABUL",101226,4,7,12,19
"KABUL","KABUL",101226,5,12,11,23
"KABUL","KABUL",101199,1,350,239,589
"KABUL","KABUL",101199,2,330,240,570
"KABUL","KABUL",101199,3,249,194,443
"KABUL","KABUL",101199,4,228,163,391
"KABUL","KABUL",101195,1,180,114,294
"KABUL","KABUL",101195,2,151,110,261
"KABUL","KABUL",101195,3,129,87,216
"KABUL","KABUL",101198,1,352,231,583
"KABUL","KABUL",101198,2,364,206,570
"KABUL","KABUL",101198,3,319,147,466
"KABUL","KABUL",101198,4,299,158,457
"KABUL","KABUL",101198,5,43,42,85
"KABUL","KABUL",101001,2,25,34,59
"KABUL","KABUL",101001,3,14,43,57
"KABUL","KABUL",101001,4,17,20,37
"KABUL","KABUL",101001,5,16,7,23
"KABUL","KABUL",101294,9,270,120,390
"KABUL","KABUL",101322,1,322,266,588
"KABUL","KABUL",101322,2,141,189,330
"KABUL","KABUL",101324,1,81,99,180
"KABUL","KABUL",101279,7,222,43,265
"KABUL","KABUL",101279,8,253,40,293
"KABUL","KABUL",101275,1,495,76,571
"KABUL","KABUL",101275,2,489,67,556
"KABUL","KABUL",101275,3,292,42,334
"KABUL","KABUL",101275,4,236,34,270
"KABUL","KABUL",101275,5,242,27,269
"KABUL","KABUL",101265,1,481,98,579
"KABUL","KABUL",101265,2,511,84,595
"KABUL","KABUL",101265,3,541,43,584
"KABUL","KABUL",101265,4,537,56,593
"KABUL","KABUL",101326,10,343,55,398
"KABUL","KABUL",101211,1,246,260,506
"KABUL","KABUL",101211,2,290,251,541
"KABUL","KABUL",101211,3,167,186,353
"KABUL","KABUL",101211,4,172,157,329
"KABUL","KABUL",101211,5,69,64,133
"KABUL","KABUL",101211,6,79,49,128
"KABUL","KABUL",101211,7,28,41,69
"KABUL","KABUL",101206,1,409,177,586
"KABUL","KABUL",101206,2,127,42,169
"KABUL","KABUL",101206,3,160,45,205
"KABUL","KABUL",101206,4,36,14,50
"KABUL","KABUL",101191,1,305,285,590
"KABUL","KABUL",101557,2,506,79,585
"KABUL","KABUL",101557,3,532,46,578
"KABUL","KABUL",101557,4,343,39,382
"KABUL","KABUL",101503,1,207,48,255
"KABUL","KABUL",101503,2,234,51,285
"KABUL","KABUL",101503,3,169,50,219
"KABUL","KABUL",101503,4,77,28,105
"KABUL","KABUL",101503,5,133,29,162
"KABUL","KABUL",101188,5,70,64,134
"KABUL","KABUL",101188,6,74,62,136
"KABUL","KABUL",101208,1,326,244,570
"KABUL","KABUL",101208,2,304,200,504
"KABUL","KABUL",101208,3,223,106,329
"KABUL","KABUL",101208,4,107,58,165
"KABUL","KABUL",101216,1,163,81,244
"KABUL","KABUL",101216,2,160,90,250
"KABUL","KABUL",101216,3,163,98,261
"KABUL","KABUL",101271,1,282,124,406
"KABUL","KABUL",101271,2,192,69,261
"KABUL","KABUL",101271,3,166,42,208
"KABUL","KABUL",101271,4,245,76,321
"KABUL","KABUL",101271,5,331,68,399
"KABUL","KABUL",101271,6,320,71,391
"KABUL","KABUL",101286,1,347,59,406
"KABUL","KABUL",101286,2,290,74,364
"KABUL","KABUL",101286,3,186,17,203
"KABUL","KABUL",101286,4,102,23,125
"KABUL","KABUL",101286,5,92,8,100
"KABUL","KABUL",101272,1,525,61,586
"KABUL","KABUL",101272,2,515,73,588
"KABUL","KABUL",101272,3,535,56,591
"KABUL","KABUL",101272,4,539,49,588
"KABUL","KABUL",101272,5,395,21,416
"KABUL","KABUL",101282,1,291,75,366
"KABUL","KABUL",101282,2,198,49,247
"KABUL","KABUL",101282,3,131,32,163
"KABUL","KABUL",101282,4,83,21,104
"KABUL","KABUL",101282,5,336,53,389
"KABUL","KABUL",101282,6,352,37,389
"KABUL","KABUL",101283,1,510,77,587
"KABUL","KABUL",101283,2,500,88,588
"KABUL","KABUL",101283,3,512,67,579
"KABUL","KABUL",101283,4,539,51,590
"KABUL","KABUL",101283,5,550,37,587
"KABUL","KABUL",101283,6,510,63,573
"KABUL","KABUL",101283,7,555,33,588
"KABUL","KABUL",101283,8,274,33,307
"KABUL","KABUL",101277,1,473,110,583
"KABUL","KABUL",101277,2,508,80,588
"KABUL","KABUL",101277,3,502,76,578
"KABUL","KABUL",101277,4,530,59,589
"KABUL","KABUL",101277,5,421,48,469
"KABUL","KABUL",101277,6,465,42,507
"KABUL","KABUL",101284,1,423,78,501
"KABUL","KABUL",101284,2,352,57,409
"KABUL","KABUL",101284,3,260,38,298
"KABUL","KABUL",101284,4,260,44,304
"KABUL","KABUL",101274,1,515,73,588
"KABUL","KABUL",101274,2,550,43,593
"KABUL","KABUL",101274,3,431,57,488
"KABUL","KABUL",101231,1,279,137,416
"KABUL","KABUL",101231,2,237,115,352
"KABUL","KABUL",101231,3,137,41,178
"KABUL","KABUL",101231,4,102,61,163
"KABUL","KABUL",101227,1,309,264,573
"KABUL","KABUL",101227,2,305,278,583
"KABUL","KABUL",101227,3,41,114,155
"KABUL","KABUL",101227,4,97,98,195
"KABUL","KABUL",101227,5,58,78,136
"KABUL","KABUL",101203,1,221,179,400
"KABUL","KABUL",101203,2,260,194,454
"KABUL","KABUL",101203,3,198,207,405
"KABUL","KABUL",101201,1,449,132,581
"KABUL","KABUL",101201,2,352,96,448
"KABUL","KABUL",101201,3,277,90,367
"KABUL","KABUL",101201,4,204,78,282
"KABUL","KABUL",101232,1,354,165,519
"KABUL","KABUL",101232,2,237,115,352
"KABUL","KABUL",101232,3,209,80,289
"KABUL","KABUL",101232,4,119,66,185
"KABUL","KABUL",101232,5,141,66,207
"KABUL","KABUL",101232,6,69,26,95
"KABUL","KABUL",101232,7,77,18,95
"KABUL","KABUL",101213,1,131,86,217
"KABUL","KABUL",101213,2,116,73,189
"KABUL","KABUL",101034,8,73,74,147
"KABUL","KABUL",101025,1,367,89,456
"KABUL","KABUL",101025,2,239,77,316
"KABUL","KABUL",101025,3,351,133,484
"KABUL","KABUL",101025,4,449,143,592
"KABUL","KABUL",101179,1,131,198,329
"KABUL","KABUL",101179,2,150,205,355
"KABUL","KABUL",101025,7,279,83,362
"KABUL","KABUL",101001,6,10,66,76
"KABUL","KABUL",101279,4,295,57,352
"KABUL","KABUL",101279,5,300,66,366
"KABUL","KABUL",101279,6,289,63,352
"KABUL","KABUL",101033,5,47,82,129
"KABUL","KABUL",101033,6,272,308,580
"KABUL","KABUL",101033,7,61,72,133
"KABUL","KABUL",101033,8,268,303,571
"KABUL","KABUL",101033,9,248,342,590
"KABUL","KABUL",101022,1,99,29,128
"KABUL","KABUL",101501,1,452,115,567
"KABUL","KABUL",101501,2,309,49,358
"KABUL","KABUL",101501,3,495,95,590
"KABUL","KABUL",101501,4,284,50,334
"KABUL","KABUL",101501,5,546,45,591
"KABUL","KABUL",101501,6,545,50,595
"KABUL","KABUL",101501,7,465,60,525
"KABUL","KABUL",101555,1,514,70,584
"KABUL","KABUL",101555,2,509,80,589
"KABUL","KABUL",101555,3,544,36,580
"KABUL","KABUL",101555,4,543,49,592
"KABUL","KABUL",101555,5,388,69,457
"KABUL","KABUL",101287,4,31,4,35
"KABUL","KABUL",101287,5,28,9,37
"KABUL","KABUL",101288,1,39,24,63
"KABUL","KABUL",101288,2,72,34,106
"KABUL","KABUL",101288,3,76,50,126
"KABUL","KABUL",101288,4,33,8,41
"KABUL","KABUL",101191,2,350,238,588
"KABUL","KABUL",101191,3,30,29,59
"KABUL","KABUL",101191,4,13,25,38
"KABUL","KABUL",101191,5,38,49,87
"KABUL","KABUL",101188,1,302,278,580
"KABUL","KABUL",101188,2,334,183,517
"KABUL","KABUL",101188,3,311,232,543
"KABUL","KABUL",101188,4,89,111,200
"KABUL","KABUL",101249,5,12,486,498
"KABUL","KABUL",101249,6,30,513,543
"KABUL","KABUL",101249,7,13,144,157
"KABUL","KABUL",101249,8,15,258,273
"KABUL","KABUL",101249,9,2,154,156
"KABUL","KABUL",101249,10,1,323,324
"KABUL","KABUL",101249,11,12,260,272
"KABUL","KABUL",101245,1,420,139,559
"KABUL","KABUL",101245,2,210,51,261
"KABUL","KABUL",101245,3,150,50,200
"KABUL","KABUL",101245,4,161,56,217
"KABUL","KABUL",101245,5,71,19,90
"KABUL","KABUL",101245,6,88,27,115
"KABUL","KABUL",101243,1,418,142,560
"KABUL","KABUL",101243,2,361,143,504
"KABUL","KABUL",101243,3,331,111,442
"KABUL","KABUL",101243,4,300,97,397
"KABUL","KABUL",101243,5,280,90,370
"KABUL","KABUL",101240,1,398,45,443
"KABUL","KABUL",101240,2,366,35,401
"KABUL","KABUL",101240,3,337,33,370
"KABUL","KABUL",101240,4,354,35,389
"KABUL","KABUL",101240,5,272,19,291
"KABUL","KABUL",101240,6,152,6,158
"KABUL","KABUL",101240,7,132,10,142
"KABUL","KABUL",101240,8,133,6,139
"KABUL","KABUL",101240,9,156,9,165
"KABUL","KABUL",101248,1,293,297,590
"KABUL","KABUL",101248,2,294,297,591
"KABUL","KABUL",101248,3,257,332,589
"KABUL","KABUL",101239,1,408,179,587
"KABUL","KABUL",101239,2,304,83,387
"KABUL","KABUL",101239,3,341,135,476
"KABUL","KABUL",101239,4,331,93,424
"KABUL","KABUL",101239,5,257,93,350
"KABUL","KABUL",101239,6,177,67,244
"KABUL","KABUL",101239,7,164,53,217
"KABUL","KABUL",101238,1,114,68,182
"KABUL","KABUL",101238,2,179,93,272
"KABUL","KABUL",101238,3,35,21,56
"KABUL","KABUL",101238,4,26,15,41
"KABUL","KABUL",101238,5,42,21,63
"KABUL","KABUL",101238,6,34,16,50
"KABUL","KABUL",101241,1,447,139,586
"KABUL","KABUL",101241,2,469,118,587
"KABUL","KABUL",101241,3,467,121,588
"KABUL","KABUL",101241,4,474,112,586
"KABUL","KABUL",101299,3,89,13,102
"KABUL","KABUL",101299,4,77,13,90
"KABUL","KABUL",101304,1,229,60,289
"KABUL","KABUL",101241,8,254,63,317
"KABUL","KABUL",101241,9,222,60,282
"KABUL","KABUL",101241,10,249,104,353
"KABUL","KABUL",101241,11,220,80,300
"KABUL","KABUL",101246,1,244,113,357
"KABUL","KABUL",101246,2,204,104,308
"KABUL","KABUL",101246,3,331,155,486
"KABUL","KABUL",101246,4,76,27,103
"KABUL","KABUL",101246,5,88,47,135
"KABUL","KABUL",101246,6,221,103,324
"KABUL","KABUL",101244,1,159,81,240
"KABUL","KABUL",101244,2,115,48,163
"KABUL","KABUL",101244,3,247,127,374
"KABUL","KABUL",101244,4,163,72,235
"KABUL","KABUL",101244,5,181,60,241
"KABUL","KABUL",101244,6,133,58,191
"KABUL","KABUL",101244,7,90,36,126
"KABUL","KABUL",101260,1,329,118,447
"KABUL","KABUL",101260,2,342,106,448
"KABUL","KABUL",101260,3,394,34,428
"KABUL","KABUL",101260,4,232,28,260
"KABUL","KABUL",101261,1,289,64,353
"KABUL","KABUL",101261,2,272,69,341
"KABUL","KABUL",101261,3,249,66,315
"KABUL","KABUL",101261,4,378,77,455
"KABUL","KABUL",101261,5,359,71,430
"KABUL","KABUL",101250,1,63,357,420
"KABUL","KABUL",101250,2,90,392,482
"KABUL","KABUL",101250,3,107,379,486
"KABUL","KABUL",101250,4,48,265,313
"KABUL","KABUL",101250,5,82,419,501
"KABUL","KABUL",101250,6,73,303,376
"KABUL","KABUL",101250,7,31,138,169
"KABUL","KABUL",101250,8,27,136,163
"KABUL","KABUL",101250,9,41,217,258
"KABUL","KABUL",101250,10,26,102,128
"KABUL","KABUL",101242,1,462,83,545
"KABUL","KABUL",101242,2,510,79,589
"KABUL","KABUL",101242,3,451,53,504
"KABUL","KABUL",101242,4,373,61,434
"KABUL","KABUL",101242,5,337,43,380
"KABUL","KABUL",101242,6,164,39,203
"KABUL","KABUL",101242,7,486,74,560
"KABUL","KABUL",101256,1,340,77,417
"KABUL","KABUL",101256,2,209,45,254
"KABUL","KABUL",101256,3,151,23,174
"KABUL","KABUL",101256,4,162,42,204
"KABUL","KABUL",101256,5,368,46,414
"KABUL","KABUL",101256,6,345,58,403
"KABUL","KABUL",101251,1,96,501,597
"KABUL","KABUL",101251,2,81,496,577
"KABUL","KABUL",101251,3,89,445,534
"KABUL","KABUL",101251,4,56,191,247
"KABUL","KABUL",101251,5,94,395,489
"KABUL","KABUL",101251,6,48,287,335
"KABUL","KABUL",101251,7,35,129,164
"KABUL","KABUL",101251,8,2,22,24
"KABUL","KABUL",101252,1,78,504,582
"KABUL","KABUL",101252,2,68,522,590
"KABUL","KABUL",101252,3,70,524,594
"KABUL","KABUL",101252,4,17,185,202
"KABUL","KABUL",101252,5,46,294,340
"KABUL","KABUL",101252,6,24,235,259
"KABUL","KABUL",101288,5,2,7,9
"KABUL","KABUL",101288,6,1,8,9
"KABUL","KABUL",101291,1,92,67,159
"KABUL","KABUL",101247,6,212,80,292
"KABUL","KABUL",101249,1,25,461,486
"KABUL","KABUL",101249,2,14,578,592
"KABUL","KABUL",101249,3,34,552,586
"KABUL","KABUL",101249,4,34,547,581
"KABUL","KABUL",101258,6,186,46,232
"KABUL","KABUL",101258,7,296,54,350
"KABUL","KABUL",101258,8,304,31,335
"KABUL","KABUL",101258,9,201,24,225
"KABUL","KABUL",101258,10,211,28,239
"KABUL","KABUL",101258,11,290,38,328
"KABUL","KABUL",101258,12,271,39,310
"KABUL","KABUL",101259,1,217,50,267
"KABUL","KABUL",101259,2,187,45,232
"KABUL","KABUL",101259,3,243,39,282
"KABUL","KABUL",101259,4,263,66,329
"KABUL","KABUL",101259,5,382,38,420
"KABUL","KABUL",101259,6,520,68,588
"KABUL","KABUL",101257,1,521,68,589
"KABUL","KABUL",101257,2,327,30,357
"KABUL","KABUL",101257,3,392,42,434
"KABUL","KABUL",101262,1,517,71,588
"KABUL","KABUL",101262,2,534,26,560
"KABUL","KABUL",101262,3,412,25,437
"KABUL","KABUL",101262,4,108,22,130
"KABUL","KABUL",101263,1,399,103,502
"KABUL","KABUL",101263,2,477,108,585
"KABUL","KABUL",101263,3,406,132,538
"KABUL","KABUL",101263,4,413,95,508
"KABUL","KABUL",101263,5,467,121,588
"KABUL","KABUL",101263,6,515,73,588
"KABUL","KABUL",101263,7,518,81,599
"KABUL","KABUL",101263,8,469,69,538
"KABUL","KABUL",101263,9,404,56,460
"KABUL","KABUL",101266,1,250,45,295
"KABUL","KABUL",101266,2,240,26,266
"KABUL","KABUL",101266,3,197,33,230
"KABUL","KABUL",101266,4,312,35,347
"KABUL","KABUL",101266,5,275,36,311
"KABUL","KABUL",101253,1,78,505,583
"KABUL","KABUL",101253,2,44,547,591
"KABUL","KABUL",101253,3,35,553,588
"KABUL","KABUL",101253,4,29,276,305
"KABUL","KABUL",101253,5,26,193,219
"KABUL","KABUL",101253,6,15,251,266
"KABUL","KABUL",101253,7,36,433,469
"KABUL","KABUL",101253,8,27,282,309
"KABUL","KABUL",101253,9,21,202,223
"KABUL","KABUL",101254,1,68,513,581
"KABUL","KABUL",101254,2,59,518,577
"KABUL","KABUL",101254,3,59,469,528
"KABUL","KABUL",101254,4,23,202,225
"KABUL","KABUL",101254,5,18,234,252
"KABUL","KABUL",101254,6,38,265,303
"KABUL","KABUL",101264,1,398,95,493
"KABUL","KABUL",101264,2,427,71,498
"KABUL","KABUL",101264,3,501,98,599
"KABUL","KABUL",101264,4,315,38,353
"KABUL","KABUL",101264,5,342,40,382
"KABUL","KABUL",101255,1,46,232,278
"KABUL","KABUL",101255,2,35,172,207
"KABUL","KABUL",101255,3,40,139,179
"KABUL","KABUL",101122,5,58,69,127
"KABUL","KABUL",101119,1,173,232,405
"KABUL","KABUL",101119,2,113,142,255
"KABUL","KABUL",101119,3,51,89,140
"KABUL","KABUL",101119,4,40,46,86
"KABUL","KABUL",101119,5,37,50,87
"KABUL","KABUL",101125,1,199,219,418
"KABUL","KABUL",101125,2,72,109,181
"KABUL","KABUL",101125,3,52,43,95
"KABUL","KABUL",101125,4,86,212,298
"KABUL","KABUL",101125,5,20,9,29
"KABUL","KABUL",101125,6,19,7,26
"KABUL","KABUL",101125,7,13,18,31
"KABUL","KABUL",101125,8,76,44,120
"KABUL","KABUL",101125,9,21,10,31
"KABUL","KABUL",101126,1,212,377,589
"KABUL","KABUL",101126,2,206,368,574
"KABUL","KABUL",101126,3,208,367,575
"KABUL","KABUL",101126,4,215,367,582
"KABUL","KABUL",101126,5,98,149,247
"KABUL","KABUL",101126,6,128,231,359
"KABUL","KABUL",101126,7,79,118,197
"KABUL","KABUL",101126,8,37,98,135
"KABUL","KABUL",101126,9,40,61,101
"KABUL","KABUL",101126,10,93,111,204
"KABUL","KABUL",101126,11,22,48,70
"KABUL","KABUL",101128,1,192,213,405
"KABUL","KABUL",101128,2,97,115,212
"KABUL","KABUL",101128,3,104,134,238
"KABUL","KABUL",101128,4,90,100,190
"KABUL","KABUL",101128,5,35,37,72
"KABUL","KABUL",101128,6,62,56,118
"KABUL","KABUL",101128,7,60,48,108
"KABUL","KABUL",101128,8,53,53,106
"KABUL","KABUL",101128,9,22,25,47
"KABUL","KABUL",101128,10,24,11,35
"KABUL","KABUL",101005,2,96,96,192
"KABUL","KABUL",101005,3,9,4,13
"KABUL","KABUL",101005,4,5,1,6
"KABUL","KABUL",101005,5,5,3,8
"KABUL","KABUL",101006,1,111,139,250
"KABUL","KABUL",101006,2,51,67,118
"KABUL","KABUL",101006,3,54,63,117
"KABUL","KABUL",101006,4,8,16,24
"KABUL","KABUL",101276,1,318,56,374
"KABUL","KABUL",101276,2,340,69,409
"KABUL","KABUL",101276,3,395,59,454
"KABUL","KABUL",101270,1,159,18,177
"KABUL","KABUL",101270,2,237,48,285
"KABUL","KABUL",101270,3,284,58,342
"KABUL","KABUL",101270,4,331,30,361
"KABUL","KABUL",101270,5,340,25,365
"KABUL","KABUL",101273,1,341,79,420
"KABUL","KABUL",101273,2,483,95,578
"KABUL","KABUL",101273,3,276,50,326
"KABUL","KABUL",101273,4,275,54,329
"KABUL","KABUL",101252,7,37,423,460
"KABUL","KABUL",101252,8,5,64,69
"KABUL","KABUL",101252,9,5,31,36
"KABUL","KABUL",101258,1,439,103,542
"KABUL","KABUL",101258,2,329,61,390
"KABUL","KABUL",101258,3,176,43,219
"KABUL","KABUL",101258,4,282,62,344
"KABUL","KABUL",101258,5,277,62,339
"KABUL","KABUL",101280,1,286,56,342
"KABUL","KABUL",101280,2,285,73,358
"KABUL","KABUL",101280,3,261,36,297
"KABUL","KABUL",101280,4,240,31,271
"KABUL","KABUL",101281,1,433,58,491
"KABUL","KABUL",101281,2,325,55,380
"KABUL","KABUL",101281,3,286,59,345
"KABUL","KABUL",101281,4,347,61,408
"KABUL","KABUL",101281,5,535,45,580
"KABUL","KABUL",101281,6,546,36,582
"KABUL","KABUL",101202,5,45,50,95
"KABUL","KABUL",101202,6,42,25,67
"KABUL","KABUL",101196,1,149,359,508
"KABUL","KABUL",101196,2,141,277,418
"KABUL","KABUL",101196,3,135,443,578
"KABUL","KABUL",101196,4,108,382,490
"KABUL","KABUL",101225,1,268,96,364
"KABUL","KABUL",101225,2,325,113,438
"KABUL","KABUL",101225,3,468,119,587
"KABUL","KABUL",101223,1,213,185,398
"KABUL","KABUL",101223,2,99,92,191
"KABUL","KABUL",101223,3,99,134,233
"KABUL","KABUL",101223,4,93,110,203
"KABUL","KABUL",101223,5,21,11,32
"KABUL","KABUL",101223,6,9,14,23
"KABUL","KABUL",101223,7,17,6,23
"KABUL","KABUL",101218,1,189,151,340
"KABUL","KABUL",101218,2,135,106,241
"KABUL","KABUL",101218,3,117,76,193
"KABUL","KABUL",101224,1,144,124,268
"KABUL","KABUL",101224,2,151,107,258
"KABUL","KABUL",101224,3,190,169,359
"KABUL","KABUL",101224,4,10,22,32
"KABUL","KABUL",101224,5,9,25,34
"KABUL","KABUL",101234,1,264,86,350
"KABUL","KABUL",101234,2,464,123,587
"KABUL","KABUL",101234,3,405,111,516
"KABUL","KABUL",101234,4,336,84,420
"KABUL","KABUL",101234,5,224,38,262
"KABUL","KABUL",101234,6,157,32,189
"KABUL","KABUL",101230,1,297,100,397
"KABUL","KABUL",101230,2,304,101,405
"KABUL","KABUL",101230,3,233,70,303
"KABUL","KABUL",101230,4,57,30,87
"KABUL","KABUL",101230,5,54,20,74
"KABUL","KABUL",101230,6,52,16,68
"KABUL","KABUL",101230,7,74,26,100
"KABUL","KABUL",101229,1,273,39,312
"KABUL","KABUL",101229,2,362,53,415
"KABUL","KABUL",101229,3,301,43,344
"KABUL","KABUL",101229,4,60,20,80
"KABUL","KABUL",101229,5,38,5,43
"KABUL","KABUL",101229,6,198,24,222
"KABUL","KABUL",101129,7,37,120,157
"KABUL","KABUL",101129,8,23,65,88
"KABUL","KABUL",101129,9,26,49,75
"KABUL","KABUL",101132,1,166,195,361
"KABUL","KABUL",101132,2,163,209,372
"KABUL","KABUL",101132,3,250,261,511
"KABUL","KABUL",101132,4,259,233,492
"KABUL","KABUL",101132,5,70,87,157
"KABUL","KABUL",101132,6,52,72,124
"KABUL","KABUL",101132,7,48,48,96
"KABUL","KABUL",101131,1,227,165,392
"KABUL","KABUL",101131,2,302,152,454
"KABUL","KABUL",101131,3,257,155,412
"KABUL","KABUL",101131,4,247,147,394
"KABUL","KABUL",101131,5,187,117,304
"KABUL","KABUL",101131,6,220,111,331
"KABUL","KABUL",101134,1,166,124,290
"KABUL","KABUL",101134,2,159,107,266
"KABUL","KABUL",101134,3,117,77,194
"KABUL","KABUL",101134,4,85,75,160
"KABUL","KABUL",101134,5,32,24,56
"KABUL","KABUL",101134,6,28,23,51
"KABUL","KABUL",101134,7,32,16,48
"KABUL","KABUL",101133,1,221,345,566
"KABUL","KABUL",101133,2,191,391,582
"KABUL","KABUL",101323,4,28,58,86
"KABUL","KABUL",101321,1,64,271,335
"KABUL","KABUL",101321,2,55,170,225
"KABUL","KABUL",101321,3,64,195,259
"KABUL","KABUL",101321,4,76,164,240
"KABUL","KABUL",101321,5,58,120,178
"KABUL","KABUL",101320,1,153,74,227
"KABUL","KABUL",101179,3,121,269,390
"KABUL","KABUL",101179,4,15,47,62
"KABUL","KABUL",101179,5,30,72,102
"KABUL","KABUL",101178,1,154,232,386
"KABUL","KABUL",101178,2,133,206,339
"KABUL","KABUL",101178,3,108,128,236
"KABUL","KABUL",101178,4,56,135,191
"KABUL","KABUL",101178,5,55,138,193
"KABUL","KABUL",101292,1,196,103,299
"KABUL","KABUL",101292,2,202,118,320
"KABUL","KABUL",101292,3,210,103,313
"KABUL","KABUL",101292,4,67,41,108
"KABUL","KABUL",101292,5,62,53,115
"KABUL","KABUL",101292,6,71,35,106
"KABUL","KABUL",101290,1,284,186,470
"KABUL","KABUL",101290,2,270,161,431
"KABUL","KABUL",101290,3,298,210,508
"KABUL","KABUL",101290,4,123,28,151
"KABUL","KABUL",101290,5,88,42,130
"KABUL","KABUL",101290,6,88,40,128
"KABUL","KABUL",101287,1,149,42,191
"KABUL","KABUL",101287,2,116,34,150
"KABUL","KABUL",101287,3,49,3,52
"KABUL","KABUL",101312,4,66,202,268
"KABUL","KABUL",101312,5,61,172,233
"KABUL","KABUL",101312,6,82,272,354
"KABUL","KABUL",101312,7,24,136,160
"KABUL","KABUL",101312,8,43,193,236
"KABUL","KABUL",101312,9,47,168,215
"KABUL","KABUL",101316,1,191,298,489
"KABUL","KABUL",101316,2,236,271,507
"KABUL","KABUL",101316,3,167,205,372
"KABUL","KABUL",101316,4,33,139,172
"KABUL","KABUL",101316,5,27,174,201
"KABUL","KABUL",101316,6,27,89,116
"KABUL","KABUL",101138,1,177,134,311
"KABUL","KABUL",101138,2,132,126,258
"KABUL","KABUL",101138,3,122,101,223
"KABUL","KABUL",101138,4,53,28,81
"KABUL","KABUL",101138,5,53,35,88
"KABUL","KABUL",101138,6,50,25,75
"KABUL","KABUL",101138,7,47,23,70
"KABUL","KABUL",101149,1,52,224,276
"KABUL","KABUL",101149,2,25,173,198
"KABUL","KABUL",101149,3,55,337,392
"KABUL","KABUL",101149,4,44,158,202
"KABUL","KABUL",101149,5,40,108,148
"KABUL","KABUL",101149,6,20,74,94
"KABUL","KABUL",101142,1,147,251,398
"KABUL","KABUL",101142,2,156,263,419
"KABUL","KABUL",101142,3,93,123,216
"KABUL","KABUL",101146,1,60,252,312
"KABUL","KABUL",101146,2,102,316,418
"KABUL","KABUL",101146,3,138,392,530
"KABUL","KABUL",101030,2,386,47,433
"KABUL","KABUL",101030,3,526,59,585
"KABUL","KABUL",101036,1,251,167,418
"KABUL","KABUL",101036,2,232,137,369
"KABUL","KABUL",101036,3,201,102,303
"KABUL","KABUL",101036,4,173,129,302
"KABUL","KABUL",101036,5,149,58,207
"KABUL","KABUL",101036,6,94,69,163
"KABUL","KABUL",101036,7,167,118,285
"KABUL","KABUL",101036,8,163,89,252
"KABUL","KABUL",101038,1,49,67,116
"KABUL","KABUL",101038,2,77,108,185
"KABUL","KABUL",101038,3,228,178,406
"KABUL","KABUL",101038,4,53,51,104
"KABUL","KABUL",101038,5,33,44,77
"KABUL","KABUL",101037,1,138,135,273
"KABUL","KABUL",101037,2,91,115,206
"KABUL","KABUL",101037,3,99,149,248
"KABUL","KABUL",101037,4,45,46,91
"KABUL","KABUL",101037,5,22,34,56
"KABUL","KABUL",101037,6,38,47,85
"KABUL","KABUL",101044,1,152,198,350
"KABUL","KABUL",101044,2,135,181,316
"KABUL","KABUL",101044,3,107,124,231
"KABUL","KABUL",101044,4,134,126,260
"KABUL","KABUL",101044,5,112,189,301
"KABUL","KABUL",101043,1,139,132,271
"KABUL","KABUL",101043,2,108,115,223
"KABUL","KABUL",101043,3,120,129,249
"KABUL","KABUL",101042,1,241,321,562
"KABUL","KABUL",101042,2,109,161,270
"KABUL","KABUL",101042,3,48,84,132
"KABUL","KABUL",101040,1,150,146,296
"KABUL","KABUL",101040,2,133,137,270
"KABUL","KABUL",101040,3,97,146,243
"KABUL","KABUL",101040,4,58,63,121
"KABUL","KABUL",101040,5,87,112,199
"KABUL","KABUL",101039,1,312,277,589
"KABUL","KABUL",101156,5,47,81,128
"KABUL","KABUL",101156,6,47,63,110
"KABUL","KABUL",101153,1,77,349,426
"KABUL","KABUL",101153,2,69,244,313
"KABUL","KABUL",101153,3,58,238,296
"KABUL","KABUL",101153,4,42,155,197
"KABUL","KABUL",101153,5,35,84,119
"KABUL","KABUL",101155,1,94,377,471
"KABUL","KABUL",101155,2,98,322,420
"KABUL","KABUL",101155,3,101,311,412
"KABUL","KABUL",101155,4,64,189,253
"KABUL","KABUL",101155,5,91,247,338
"KABUL","KABUL",101155,6,80,217,297
"KABUL","KABUL",101159,1,155,429,584
"KABUL","KABUL",101159,2,157,406,563
"KABUL","KABUL",101159,3,183,401,584
"KABUL","KABUL",101159,4,214,259,473
"KABUL","KABUL",101159,5,217,216,433
"KABUL","KABUL",101151,1,43,543,586
"KABUL","KABUL",101151,2,50,523,573
"KABUL","KABUL",101151,3,46,535,581
"KABUL","KABUL",101151,4,4,132,136
"KABUL","KABUL",101151,5,49,408,457
"KABUL","KABUL",101151,6,31,566,597
"KABUL","KABUL",101151,7,26,249,275
"KABUL","KABUL",101151,8,14,187,201
"KABUL","KABUL",101151,9,22,129,151
"KABUL","KABUL",101151,10,11,128,139
"KABUL","KABUL",101151,11,10,62,72
"KABUL","KABUL",101151,12,50,410,460
"KABUL","KABUL",101154,1,81,232,313
"KABUL","KABUL",101154,2,130,330,460
"KABUL","KABUL",101154,3,110,371,481
"KABUL","KABUL",101154,4,77,336,413
"KABUL","KABUL",101154,5,75,297,372
"KABUL","KABUL",101174,1,52,529,581
"KABUL","KABUL",101174,2,34,150,184
"KABUL","KABUL",101174,3,52,418,470
"KABUL","KABUL",101173,1,172,342,514
"KABUL","KABUL",101173,2,150,276,426
"KABUL","KABUL",101173,3,61,163,224
"KABUL","KABUL",101158,1,64,343,407
"KABUL","KABUL",101158,2,81,360,441
"KABUL","KABUL",101158,3,69,415,484
"KABUL","KABUL",101158,4,19,283,302
"KABUL","KABUL",101158,5,66,359,425
"KABUL","KABUL",101170,1,90,431,521
"KABUL","KABUL",101170,2,64,292,356
"KABUL","KABUL",101170,3,46,142,188
"KABUL","KABUL",101170,4,22,212,234
"KABUL","KABUL",101170,5,26,89,115
"KABUL","KABUL",101170,6,18,102,120
"KABUL","KABUL",101160,1,11,267,278
"KABUL","KABUL",101160,2,3,187,190
"KABUL","KABUL",101160,3,21,259,280
"KABUL","KABUL",101160,4,8,187,195
"KABUL","KABUL",101160,5,7,136,143
"KABUL","KABUL",101161,1,15,169,184
"KABUL","KABUL",101161,2,9,156,165
"KABUL","KABUL",101161,3,10,83,93
"KABUL","KABUL",101161,4,6,108,114
"KABUL","KABUL",101161,5,14,182,196
"KABUL","KABUL",101157,1,104,367,471
"KABUL","KABUL",101157,2,107,355,462
"KABUL","KABUL",101157,3,96,330,426
"KABUL","KABUL",101157,4,85,338,423
"KABUL","KABUL",101519,1,158,256,414
"KABUL","KABUL",101519,2,156,275,431
"KABUL","KABUL",101519,3,141,304,445
"KABUL","KABUL",101172,1,129,279,408
"KABUL","KABUL",101172,2,182,244,426
"KABUL","KABUL",101172,3,163,242,405
"KABUL","KABUL",101172,4,227,359,586
"KABUL","KABUL",101167,1,124,311,435
"KABUL","KABUL",101167,2,131,300,431
"KABUL","KABUL",101167,3,15,93,108
"KABUL","KABUL",101167,4,36,108,144
"KABUL","KABUL",101520,1,202,236,438
"KABUL","KABUL",101520,2,160,230,390
"KABUL","KABUL",101520,3,190,179,369
"KABUL","KABUL",101175,1,63,380,443
"KABUL","KABUL",101175,2,53,258,311
"KABUL","KABUL",101175,3,32,321,353
"KABUL","KABUL",101175,4,69,280,349
"KABUL","KABUL",101162,1,29,176,205
"KABUL","KABUL",101162,2,31,211,242
"KABUL","KABUL",101162,3,32,219,251
"KABUL","KABUL",101162,4,17,102,119
"KABUL","KABUL",101162,5,26,142,168
"KABUL","KABUL",101164,1,175,264,439
"KABUL","KABUL",101164,2,170,275,445
"KABUL","KABUL",101164,3,142,209,351
"KABUL","KABUL",101164,4,194,82,276
"KABUL","KABUL",101164,5,151,151,302
"KABUL","KABUL",101163,1,73,188,261
"KABUL","KABUL",101163,2,62,178,240
"KABUL","KABUL",101163,3,111,314,425
"KABUL","KABUL",101163,4,77,125,202
"KABUL","KABUL",101163,5,57,111,168
"KABUL","KABUL",101166,1,85,317,402
"KABUL","KABUL",101166,2,93,319,412
"KABUL","KABUL",101166,3,100,263,363
"KABUL","KABUL",101166,4,84,230,314
"KABUL","KABUL",101165,1,32,97,129
"KABUL","KABUL",101165,2,32,121,153
"KABUL","KABUL",101165,3,27,134,161
"KABUL","KABUL",101165,4,23,94,117
"KABUL","KABUL",101165,5,14,68,82
"KABUL","KABUL",101169,1,117,263,380
"KABUL","KABUL",101169,2,169,305,474
"KABUL","KABUL",101169,3,124,273,397
"KABUL","KABUL",101169,4,29,336,365
"KABUL","KABUL",101169,5,104,200,304
"KABUL","KABUL",101169,6,72,111,183
"KABUL","KABUL",101490,1,291,290,581
"KABUL","KABUL",101490,2,255,328,583
"KABUL","KABUL",101490,3,172,168,340
"KABUL","KABUL",101490,4,147,176,323
"KABUL","KABUL",101490,5,94,87,181
"KABUL","KABUL",101490,6,90,95,185
"KABUL","KABUL",101490,7,77,73,150
"KABUL","KABUL",101490,8,120,93,213
"KABUL","KABUL",101492,1,46,191,237
"KABUL","KABUL",101492,2,55,245,300
"KABUL","KABUL",101492,3,53,219,272
"KABUL","KABUL",101492,4,50,81,131
"KABUL","KABUL",101492,5,41,95,136
"KABUL","KABUL",101489,1,224,79,303
"KABUL","KABUL",101489,2,202,86,288
"KABUL","KABUL",101489,3,124,49,173
"KABUL","KABUL",101489,4,117,20,137
"KABUL","KABUL",101489,5,153,18,171
"KABUL","KABUL",101489,6,153,26,179
"KABUL","KABUL",101168,1,114,295,409
"KABUL","KABUL",101168,2,152,319,471
"KABUL","KABUL",101168,3,131,212,343
"KABUL","KABUL",101168,4,101,207,308
"KABUL","KABUL",101168,5,160,418,578
"KABUL","KABUL",101168,6,28,95,123
"KABUL","KABUL",101171,1,40,226,266
"KABUL","KABUL",101171,2,31,179,210
"KABUL","KABUL",101171,3,34,190,224
"KABUL","KABUL",101171,4,4,47,51
"KABUL","KABUL",101171,5,8,64,72
"KABUL","KABUL",101491,1,22,427,449
"KABUL","KABUL",101491,2,17,424,441
"KABUL","KABUL",101491,3,18,416,434
"KABUL","KABUL",101488,1,274,181,455
"KABUL","KABUL",101488,2,21,10,31
"KABUL","KABUL",101183,1,155,188,343
"KABUL","KABUL",101183,2,156,214,370
"KABUL","KABUL",101183,3,166,261,427
"KABUL","KABUL",101183,4,190,327,517
"KABUL","KABUL",101183,5,108,240,348
"KABUL","KABUL",101003,1,175,271,446
"KABUL","KABUL",101003,2,130,202,332
"KABUL","KABUL",101003,3,20,29,49
"KABUL","KABUL",101003,4,25,25,50
"KABUL","KABUL",101005,1,125,106,231
"KABUL","KABUL",101197,4,114,38,152
"KABUL","KABUL",101197,5,120,65,185
"KABUL","KABUL",101189,1,44,539,583
"KABUL","KABUL",101189,2,66,517,583
"KABUL","KABUL",101189,3,50,539,589
"KABUL","KABUL",101189,4,29,565,594
"KABUL","KABUL",101189,5,35,401,436
"KABUL","KABUL",101189,6,12,342,354
"KABUL","KABUL",101189,7,43,364,407
"KABUL","KABUL",101189,8,48,309,357
"KABUL","KABUL",101193,1,289,295,584
"KABUL","KABUL",101193,2,154,243,397
"KABUL","KABUL",101193,3,123,227,350
"KABUL","KABUL",101193,4,65,65,130
"KABUL","KABUL",101215,1,265,309,574
"KABUL","KABUL",101215,2,282,264,546
"KABUL","KABUL",101215,3,171,191,362
"KABUL","KABUL",101215,4,216,254,470
"KABUL","KABUL",101215,5,183,223,406
"KABUL","KABUL",101214,1,275,228,503
"KABUL","KABUL",101273,5,500,92,592
"KABUL","KABUL",101273,6,311,84,395
"KABUL","KABUL",101273,7,402,37,439
"KABUL","KABUL",101273,8,355,24,379
"KABUL","KABUL",101273,9,221,24,245
"KABUL","KABUL",101273,10,322,42,364
"KABUL","KABUL",101273,11,221,66,287
"KABUL","KABUL",101273,12,525,72,597
"KABUL","KABUL",101222,3,136,88,224
"KABUL","KABUL",101222,4,28,21,49
"KABUL","KABUL",101222,5,17,12,29
"KABUL","KABUL",101204,1,89,508,597
"KABUL","KABUL",101204,2,97,419,516
"KABUL","KABUL",101204,3,37,553,590
"KABUL","KABUL",101204,4,35,170,205
"KABUL","KABUL",101202,1,190,116,306
"KABUL","KABUL",101202,2,117,78,195
"KABUL","KABUL",101202,3,37,31,68
"KABUL","KABUL",101202,4,87,67,154
"KABUL","KABUL",101075,5,130,171,301
"KABUL","KABUL",101074,1,155,209,364
"KABUL","KABUL",101074,2,167,249,416
"KABUL","KABUL",101074,3,189,400,589
"KABUL","KABUL",101074,4,228,263,491
"KABUL","KABUL",101074,5,87,183,270
"KABUL","KABUL",101074,6,76,265,341
"KABUL","KABUL",101074,7,73,145,218
"KABUL","KABUL",101074,8,166,292,458
"KABUL","KABUL",101078,1,127,456,583
"KABUL","KABUL",101078,2,136,434,570
"KABUL","KABUL",101078,3,161,418,579
"KABUL","KABUL",101123,1,407,179,586
"KABUL","KABUL",101123,2,290,139,429
"KABUL","KABUL",101123,3,263,119,382
"KABUL","KABUL",101123,4,311,93,404
"KABUL","KABUL",101123,5,310,101,411
"KABUL","KABUL",101123,6,316,86,402
"KABUL","KABUL",101127,1,156,434,590
"KABUL","KABUL",101127,2,67,218,285
"KABUL","KABUL",101127,3,48,177,225
"KABUL","KABUL",101127,4,110,369,479
"KABUL","KABUL",101127,5,73,221,294
"KABUL","KABUL",101127,6,35,158,193
"KABUL","KABUL",101127,7,35,158,193
"KABUL","KABUL",101127,8,19,64,83
"KABUL","KABUL",101130,1,244,339,583
"KABUL","KABUL",101130,2,271,311,582
"KABUL","KABUL",101130,3,271,308,579
"KABUL","KABUL",101130,4,102,89,191
"KABUL","KABUL",101130,5,74,67,141
"KABUL","KABUL",101130,6,54,36,90
"KABUL","KABUL",101130,7,45,51,96
"KABUL","KABUL",101130,8,70,95,165
"KABUL","KABUL",101130,9,51,60,111
"KABUL","KABUL",101130,10,67,77,144
"KABUL","KABUL",101129,1,150,357,507
"KABUL","KABUL",101129,2,149,352,501
"KABUL","KABUL",101129,3,150,377,527
"KABUL","KABUL",101129,4,25,101,126
"KABUL","KABUL",101129,5,25,133,158
"KABUL","KABUL",101129,6,37,101,138
"KABUL","KABUL",101014,2,181,14,195
"KABUL","KABUL",101021,1,89,102,191
"KABUL","KABUL",101021,2,96,100,196
"KABUL","KABUL",101021,3,39,37,76
"KABUL","KABUL",101021,4,52,32,84
"KABUL","KABUL",101086,3,86,159,245
"KABUL","KABUL",101086,4,85,136,221
"KABUL","KABUL",101086,5,31,79,110
"KABUL","KABUL",101086,6,53,76,129
"KABUL","KABUL",101086,7,30,85,115
"KABUL","KABUL",101086,8,39,88,127
"KABUL","KABUL",101085,1,135,456,591
"KABUL","KABUL",101085,2,49,235,284
"KABUL","KABUL",101085,3,99,313,412
"KABUL","KABUL",101089,1,176,402,578
"KABUL","KABUL",101089,2,166,418,584
"KABUL","KABUL",101089,3,152,386,538
"KABUL","KABUL",101089,4,126,345,471
"KABUL","KABUL",101089,5,89,272,361
"KABUL","KABUL",101089,6,71,176,247
"KABUL","KABUL",101089,7,118,213,331
"KABUL","KABUL",101089,8,68,185,253
"KABUL","KABUL",101088,1,202,217,419
"KABUL","KABUL",101088,2,151,193,344
"KABUL","KABUL",101088,3,146,151,297
"KABUL","KABUL",101088,4,95,160,255
"KABUL","KABUL",101088,5,66,123,189
"KABUL","KABUL",101087,1,222,342,564
"KABUL","KABUL",101087,2,134,232,366
"KABUL","KABUL",101087,3,190,259,449
"KABUL","KABUL",101087,4,19,58,77
"KABUL","KABUL",101087,5,77,111,188
"KABUL","KABUL",101087,6,90,165,255
"KABUL","KABUL",101087,7,39,66,105
"KABUL","KABUL",101087,8,32,36,68
"KABUL","KABUL",101033,1,270,312,582
"KABUL","KABUL",101033,2,37,45,82
"KABUL","KABUL",101033,3,37,79,116
"KABUL","KABUL",101033,4,18,54,72
"KABUL","KABUL",101091,4,32,71,103
"KABUL","KABUL",101091,5,33,66,99
"KABUL","KABUL",101091,6,52,70,122
"KABUL","KABUL",101091,7,26,66,92
"KABUL","KABUL",101094,1,187,391,578
"KABUL","KABUL",101022,2,67,19,86
"KABUL","KABUL",101022,3,27,20,47
"KABUL","KABUL",101022,4,50,13,63
"KABUL","KABUL",101022,5,18,3,21
"KABUL","KABUL",101022,6,19,8,27
"KABUL","KABUL",101022,7,51,8,59
"KABUL","KABUL",101022,8,40,18,58
"KABUL","KABUL",101024,1,275,73,348
"KABUL","KABUL",101024,2,280,87,367
"KABUL","KABUL",101024,3,85,54,139
"KABUL","KABUL",101024,4,97,37,134
"KABUL","KABUL",101024,5,80,27,107
"KABUL","KABUL",101024,6,115,30,145
"KABUL","KABUL",101029,1,36,33,69
"KABUL","KABUL",101029,2,37,41,78
"KABUL","KABUL",101029,3,14,9,23
"KABUL","KABUL",101029,4,14,11,25
"KABUL","KABUL",101029,5,9,5,14
"KABUL","KABUL",101027,1,421,135,556
"KABUL","KABUL",101027,2,252,88,340
"KABUL","KABUL",101041,1,86,59,145
"KABUL","KABUL",101041,2,48,46,94
"KABUL","KABUL",101041,3,55,29,84
"KABUL","KABUL",101041,4,57,35,92
"KABUL","KABUL",101041,5,56,40,96
"KABUL","KABUL",101035,1,273,174,447
"KABUL","KABUL",101035,2,135,77,212
"KABUL","KABUL",101035,3,81,53,134
"KABUL","KABUL",101035,4,65,45,110
"KABUL","KABUL",101035,5,72,32,104
"KABUL","KABUL",101035,6,26,27,53
"KABUL","KABUL",101035,7,62,27,89
"KABUL","KABUL",101035,8,69,43,112
"KABUL","KABUL",101035,9,109,59,168
"KABUL","KABUL",101032,1,238,213,451
"KABUL","KABUL",101032,2,196,194,390
"KABUL","KABUL",101032,3,138,163,301
"KABUL","KABUL",101032,4,74,90,164
"KABUL","KABUL",101032,5,40,47,87
"KABUL","KABUL",101032,6,33,53,86
"KABUL","KABUL",101032,7,54,42,96
"KABUL","KABUL",101030,1,500,61,561
"KABUL","KABUL",101096,5,148,34,182
"KABUL","KABUL",101096,6,174,33,207
"KABUL","KABUL",101100,1,36,41,77
"KABUL","KABUL",101100,2,86,42,128
"KABUL","KABUL",101100,3,72,54,126
"KABUL","KABUL",101100,4,141,94,235
"KABUL","KABUL",101100,5,171,100,271
"KABUL","KABUL",101100,6,119,73,192
"KABUL","KABUL",101100,7,91,90,181
"KABUL","KABUL",101100,8,97,32,129
"KABUL","KABUL",101100,9,118,48,166
"KABUL","KABUL",101100,10,151,46,197
"KABUL","KABUL",101100,11,90,40,130
"KABUL","KABUL",101100,12,93,35,128
"KABUL","KABUL",101100,13,69,41,110
"KABUL","KABUL",101098,1,111,41,152
"KABUL","KABUL",101098,2,160,58,218
"KABUL","KABUL",101098,3,221,91,312
"KABUL","KABUL",101098,4,145,52,197
"KABUL","KABUL",101098,5,77,9,86
"KABUL","KABUL",101098,6,61,5,66
"KABUL","KABUL",101098,7,46,27,73
"KABUL","KABUL",101098,8,183,45,228
"KABUL","KABUL",101098,9,91,28,119
"KABUL","KABUL",101104,1,146,217,363
"KABUL","KABUL",101104,2,127,223,350
"KABUL","KABUL",101104,3,63,112,175
"KABUL","KABUL",101104,4,85,143,228
"KABUL","KABUL",101104,5,56,53,109
"KABUL","KABUL",101104,6,58,43,101
"KABUL","KABUL",101104,7,29,39,68
"KABUL","KABUL",101104,8,36,32,68
"KABUL","KABUL",101099,1,168,74,242
"KABUL","KABUL",101099,2,113,33,146
"KABUL","KABUL",101099,3,115,23,138
"KABUL","KABUL",101099,4,149,46,195
"KABUL","KABUL",101109,1,96,80,176
"KABUL","KABUL",101109,2,80,89,169
"KABUL","KABUL",101039,2,211,186,397
"KABUL","KABUL",101039,3,243,218,461
"KABUL","KABUL",101039,4,142,94,236
"KABUL","KABUL",101039,5,112,98,210
"KABUL","KABUL",101047,1,180,173,353
"KABUL","KABUL",101047,2,160,130,290
"KABUL","KABUL",101047,3,82,88,170
"KABUL","KABUL",101047,4,54,81,135
"KABUL","KABUL",101047,5,54,82,136
"KABUL","KABUL",101045,1,220,186,406
"KABUL","KABUL",101045,2,165,124,289
"KABUL","KABUL",101045,3,92,85,177
"KABUL","KABUL",101045,4,89,126,215
"KABUL","KABUL",101045,5,61,67,128
"KABUL","KABUL",101046,1,45,47,92
"KABUL","KABUL",101046,2,25,22,47
"KABUL","KABUL",101046,3,39,37,76
"KABUL","KABUL",101046,4,1,16,17
"KABUL","KABUL",101046,5,20,10,30
"KABUL","KABUL",101046,6,0,37,37
"KABUL","KABUL",101048,1,292,160,452
"KABUL","KABUL",101048,2,212,120,332
"KABUL","KABUL",101048,3,196,109,305
"KABUL","KABUL",101048,4,112,41,153
"KABUL","KABUL",101048,5,107,57,164
"KABUL","KABUL",101048,6,122,53,175
"KABUL","KABUL",101050,1,256,313,569
"KABUL","KABUL",101050,2,233,278,511
"KABUL","KABUL",101050,3,278,281,559
"KABUL","KABUL",101050,4,69,213,282
"KABUL","KABUL",101050,5,61,143,204
"KABUL","KABUL",101050,6,64,114,178
"KABUL","KABUL",101050,7,39,79,118
"KABUL","KABUL",101050,8,43,83,126
"KABUL","KABUL",101050,9,61,133,194
"KABUL","KABUL",101049,1,323,267,590
"KABUL","KABUL",101049,2,324,268,592
"KABUL","KABUL",101049,3,4,6,10
"KABUL","KABUL",101049,4,1,11,12
"KABUL","KABUL",101049,5,6,7,13
"KABUL","KABUL",101049,6,4,2,6
"KABUL","KABUL",101049,7,11,9,20
"KABUL","KABUL",101053,1,62,38,100
"KABUL","KABUL",101053,2,109,69,178
"KABUL","KABUL",101053,3,112,89,201
"KABUL","KABUL",101053,4,100,84,184
"KABUL","KABUL",101053,5,20,28,48
"KABUL","KABUL",101053,6,18,36,54
"KABUL","KABUL",101053,7,12,39,51
"KABUL","KABUL",101053,8,21,19,40
"KABUL","KABUL",101053,9,12,15,27
"KABUL","KABUL",101052,1,255,151,406
"KABUL","KABUL",101052,2,182,111,293
"KABUL","KABUL",101052,3,44,32,76
"KABUL","KABUL",101052,4,62,51,113
"KABUL","KABUL",101052,5,61,44,105
"KABUL","KABUL",101051,1,122,373,495
"KABUL","KABUL",101051,2,131,366,497
"KABUL","KABUL",101051,3,156,428,584
"KABUL","KABUL",101051,4,142,440,582
"KABUL","KABUL",101051,5,74,302,376
"KABUL","KABUL",101051,6,93,312,405
"KABUL","KABUL",101051,7,92,336,428
"KABUL","KABUL",101054,1,167,149,316
"KABUL","KABUL",101054,2,262,197,459
"KABUL","KABUL",101054,3,172,116,288
"KABUL","KABUL",101054,4,172,115,287
"KABUL","KABUL",101054,5,178,83,261
"KABUL","KABUL",101054,6,143,68,211
"KABUL","KABUL",101054,7,109,66,175
"KABUL","KABUL",101054,8,100,69,169
"KABUL","KABUL",101057,1,115,65,180
"KABUL","KABUL",101057,2,136,67,203
"KABUL","KABUL",101057,3,170,113,283
"KABUL","KABUL",101057,4,141,59,200
"KABUL","KABUL",101057,5,22,8,30
"KABUL","KABUL",101057,6,68,26,94
"KABUL","KABUL",101057,7,87,21,108
"KABUL","KABUL",101055,1,158,24,182
"KABUL","KABUL",101055,2,90,22,112
"KABUL","KABUL",101055,3,101,18,119
"KABUL","KABUL",101055,4,48,17,65
"KABUL","KABUL",101055,5,27,13,40
"KABUL","KABUL",101055,6,19,12,31
"KABUL","KABUL",101056,1,120,78,198
"KABUL","KABUL",101056,2,16,13,29
"KABUL","KABUL",101056,3,80,28,108
"KABUL","KABUL",101056,4,29,32,61
"KABUL","KABUL",101056,5,21,13,34
"KABUL","KABUL",101056,6,38,24,62
"KABUL","KABUL",101058,1,204,84,288
"KABUL","KABUL",101058,2,132,81,213
"KABUL","KABUL",101058,3,167,61,228
"KABUL","KABUL",101058,4,128,82,210
"KABUL","KABUL",101058,5,49,49,98
"KABUL","KABUL",101058,6,42,25,67
"KABUL","KABUL",101058,7,29,23,52
"KABUL","KABUL",101060,1,427,148,575
"KABUL","KABUL",101060,2,248,96,344
"KABUL","KABUL",101060,3,356,97,453
"KABUL","KABUL",101060,4,122,51,173
"KABUL","KABUL",101060,5,94,42,136
"KABUL","KABUL",101060,6,108,55,163
"KABUL","KABUL",101060,7,152,42,194
"KABUL","KABUL",101060,8,74,23,97
"KABUL","KABUL",101059,1,250,140,390
"KABUL","KABUL",101059,2,167,85,252
"KABUL","KABUL",101059,3,88,58,146
"KABUL","KABUL",101059,4,147,50,197
"KABUL","KABUL",101059,5,74,33,107
"KABUL","KABUL",101059,6,67,20,87
"KABUL","KABUL",101062,1,280,313,593
"KABUL","KABUL",101062,2,215,214,429
"KABUL","KABUL",101062,3,183,237,420
"KABUL","KABUL",101062,4,120,135,255
"KABUL","KABUL",101062,5,126,133,259
"KABUL","KABUL",101062,6,185,240,425
"KABUL","KABUL",101062,7,247,346,593
"KABUL","KABUL",101062,8,81,128,209
"KABUL","KABUL",101062,9,86,111,197
"KABUL","KABUL",101063,1,196,78,274
"KABUL","KABUL",101063,2,191,82,273
"KABUL","KABUL",101063,3,168,93,261
"KABUL","KABUL",101063,4,180,68,248
"KABUL","KABUL",101063,5,113,39,152
"KABUL","KABUL",101063,6,78,24,102
"KABUL","KABUL",101063,7,87,27,114
"KABUL","KABUL",101064,1,292,300,592
"KABUL","KABUL",101064,2,231,268,499
"KABUL","KABUL",101064,3,151,175,326
"KABUL","KABUL",101064,4,173,149,322
"KABUL","KABUL",101064,5,129,147,276
"KABUL","KABUL",101064,6,99,110,209
"KABUL","KABUL",101064,7,89,118,207
"KABUL","KABUL",101061,1,138,221,359
"KABUL","KABUL",101061,2,96,170,266
"KABUL","KABUL",101061,3,64,96,160
"KABUL","KABUL",101061,4,95,102,197
"KABUL","KABUL",101068,1,296,284,580
"KABUL","KABUL",101068,2,202,183,385
"KABUL","KABUL",101068,3,83,83,166
"KABUL","KABUL",101068,4,68,48,116
"KABUL","KABUL",101068,5,50,58,108
"KABUL","KABUL",101066,1,261,128,389
"KABUL","KABUL",101066,2,229,148,377
"KABUL","KABUL",101066,3,271,119,390
"KABUL","KABUL",101066,4,159,83,242
"KABUL","KABUL",101066,5,127,69,196
"KABUL","KABUL",101065,1,159,79,238
"KABUL","KABUL",101217,1,284,304,588
"KABUL","KABUL",101217,2,344,126,470
"KABUL","KABUL",101217,3,21,14,35
"KABUL","KABUL",101221,1,97,111,208
"KABUL","KABUL",101221,2,98,94,192
"KABUL","KABUL",101221,3,68,62,130
"KABUL","KABUL",101221,4,65,57,122
"KABUL","KABUL",101197,1,152,75,227
"KABUL","KABUL",101197,2,131,78,209
"KABUL","KABUL",101197,3,87,88,175
"KABUL","KABUL",101184,5,38,121,159
"KABUL","KABUL",101184,6,75,134,209
"KABUL","KABUL",101182,1,241,340,581
"KABUL","KABUL",101182,2,235,353,588
"KABUL","KABUL",101182,3,177,296,473
"KABUL","KABUL",101182,4,173,312,485
"KABUL","KABUL",101182,5,147,319,466
"KABUL","KABUL",101182,6,70,167,237
"KABUL","KABUL",101182,7,6,23,29
"KABUL","KABUL",101181,1,80,164,244
"KABUL","KABUL",101181,2,70,137,207
"KABUL","KABUL",101181,3,122,198,320
"KABUL","KABUL",101181,4,9,21,30
"KABUL","KABUL",101181,5,8,44,52
"KABUL","KABUL",101181,6,27,53,80
"KABUL","KABUL",101181,7,25,81,106
"KABUL","KABUL",101180,1,168,183,351
"KABUL","KABUL",101180,2,158,131,289
"KABUL","KABUL",101180,3,108,99,207
"KABUL","KABUL",101180,4,59,45,104
"KABUL","KABUL",101214,2,85,63,148
"KABUL","KABUL",101200,1,227,189,416
"KABUL","KABUL",101200,2,125,212,337
"KABUL","KABUL",101200,3,148,172,320
"KABUL","KABUL",101200,4,201,127,328
"KABUL","KABUL",101200,5,185,138,323
"KABUL","KABUL",101222,1,138,79,217
"KABUL","KABUL",101222,2,103,83,186
"KABUL","KABUL",101007,4,21,10,31
"KABUL","KABUL",101007,5,18,8,26
"KABUL","KABUL",101007,6,14,2,16
"KABUL","KABUL",101010,1,112,82,194
"KABUL","KABUL",101010,2,108,73,181
"KABUL","KABUL",101010,3,80,51,131
"KABUL","KABUL",101010,4,21,19,40
"KABUL","KABUL",101010,5,13,5,18
"KABUL","KABUL",101009,1,49,25,74
"KABUL","KABUL",101009,2,43,20,63
"KABUL","KABUL",101009,3,13,7,20
"KABUL","KABUL",101009,4,12,10,22
"KABUL","KABUL",101015,1,70,65,135
"KABUL","KABUL",101015,2,68,60,128
"KABUL","KABUL",101015,3,18,8,26
"KABUL","KABUL",101004,1,172,71,243
"KABUL","KABUL",101004,2,138,81,219
"KABUL","KABUL",101004,3,141,78,219
"KABUL","KABUL",101004,4,58,44,102
"KABUL","KABUL",101004,5,70,29,99
"KABUL","KABUL",101004,6,73,28,101
"KABUL","KABUL",101028,1,283,202,485
"KABUL","KABUL",101028,2,183,127,310
"KABUL","KABUL",101078,4,35,83,118
"KABUL","KABUL",101078,5,19,53,72
"KABUL","KABUL",101078,6,18,53,71
"KABUL","KABUL",101078,7,11,48,59
"KABUL","KABUL",101078,8,42,75,117
"KABUL","KABUL",101079,1,138,448,586
"KABUL","KABUL",101079,2,146,424,570
"KABUL","KABUL",101079,3,77,384,461
"KABUL","KABUL",101079,4,33,76,109
"KABUL","KABUL",101080,1,243,345,588
"KABUL","KABUL",101080,2,236,311,547
"KABUL","KABUL",101080,3,207,215,422
"KABUL","KABUL",101081,1,75,294,369
"KABUL","KABUL",101081,2,60,275,335
"KABUL","KABUL",101081,3,46,255,301
"KABUL","KABUL",101076,1,109,477,586
"KABUL","KABUL",101076,2,72,370,442
"KABUL","KABUL",101076,3,67,353,420
"KABUL","KABUL",101076,4,88,346,434
"KABUL","KABUL",101082,1,189,402,591
"KABUL","KABUL",101082,2,155,430,585
"KABUL","KABUL",101082,3,201,390,591
"KABUL","KABUL",101082,4,83,195,278
"KABUL","KABUL",101082,5,62,157,219
"KABUL","KABUL",101082,6,73,142,215
"KABUL","KABUL",101082,7,57,77,134
"KABUL","KABUL",101083,1,260,324,584
"KABUL","KABUL",101083,2,235,328,563
"KABUL","KABUL",101083,3,147,182,329
"KABUL","KABUL",101084,1,170,409,579
"KABUL","KABUL",101084,2,50,147,197
"KABUL","KABUL",101084,3,87,139,226
"KABUL","KABUL",101084,4,75,176,251
"KABUL","KABUL",101086,1,143,236,379
"KABUL","KABUL",101086,2,153,217,370
"KABUL","KABUL",101109,5,69,63,132
"KABUL","KABUL",101109,6,132,132,264
"KABUL","KABUL",101109,7,88,57,145
"KABUL","KABUL",101109,8,47,39,86
"KABUL","KABUL",101109,9,16,12,28
"KABUL","KABUL",101109,10,12,8,20
"KABUL","KABUL",101109,11,23,28,51
"KABUL","KABUL",101110,1,291,107,398
"KABUL","KABUL",101110,2,282,92,374
"KABUL","KABUL",101110,3,208,37,245
"KABUL","KABUL",101110,4,193,38,231
"KABUL","KABUL",101112,1,74,42,116
"KABUL","KABUL",101112,2,73,36,109
"KABUL","KABUL",101112,3,72,38,110
"KABUL","KABUL",101112,4,44,13,57
"KABUL","KABUL",101112,5,31,18,49
"KABUL","KABUL",101112,6,37,21,58
"KABUL","KABUL",101112,7,83,88,171
"KABUL","KABUL",101112,8,89,84,173
"KABUL","KABUL",101102,1,325,72,397
"KABUL","KABUL",101102,2,244,69,313
"KABUL","KABUL",101102,3,498,44,542
"KABUL","KABUL",101133,3,177,344,521
"KABUL","KABUL",101143,1,270,311,581
"KABUL","KABUL",101143,2,261,317,578
"KABUL","KABUL",101143,3,259,323,582
"KABUL","KABUL",101143,4,108,131,239
"KABUL","KABUL",101143,5,95,98,193
"KABUL","KABUL",101143,6,92,101,193
"KABUL","KABUL",101320,2,48,28,76
"KABUL","KABUL",101087,9,31,43,74
"KABUL","KABUL",101091,1,88,163,251
"KABUL","KABUL",101091,2,58,91,149
"KABUL","KABUL",101091,3,76,114,190
"KABUL","KABUL",101319,4,29,19,48
"KABUL","KABUL",101319,5,22,35,57
"KABUL","KABUL",101319,6,14,40,54
"KABUL","KABUL",101319,7,16,70,86
"KABUL","KABUL",101318,1,172,136,308
"KABUL","KABUL",101094,2,73,138,211
"KABUL","KABUL",101094,3,73,246,319
"KABUL","KABUL",101094,4,69,172,241
"KABUL","KABUL",101094,5,78,137,215
"KABUL","KABUL",101094,6,50,69,119
"KABUL","KABUL",101094,7,34,96,130
"KABUL","KABUL",101094,8,53,87,140
"KABUL","KABUL",101094,9,66,91,157
"KABUL","KABUL",101092,1,112,456,568
"KABUL","KABUL",101092,2,97,486,583
"KABUL","KABUL",101092,3,123,460,583
"KABUL","KABUL",101092,4,97,476,573
"KABUL","KABUL",101092,5,97,485,582
"KABUL","KABUL",101092,6,100,487,587
"KABUL","KABUL",101092,7,35,116,151
"KABUL","KABUL",101090,1,192,396,588
"KABUL","KABUL",101090,2,92,182,274
"KABUL","KABUL",101090,3,8,20,28
"KABUL","KABUL",101093,1,138,324,462
"KABUL","KABUL",101093,2,144,304,448
"KABUL","KABUL",101093,3,141,307,448
"KABUL","KABUL",101095,1,194,203,397
"KABUL","KABUL",101095,2,160,216,376
"KABUL","KABUL",101095,3,159,187,346
"KABUL","KABUL",101095,4,142,159,301
"KABUL","KABUL",101095,5,165,121,286
"KABUL","KABUL",101095,6,101,71,172
"KABUL","KABUL",101095,7,86,72,158
"KABUL","KABUL",101095,8,50,31,81
"KABUL","KABUL",101097,1,158,46,204
"KABUL","KABUL",101097,2,180,36,216
"KABUL","KABUL",101097,3,174,41,215
"KABUL","KABUL",101097,4,174,47,221
"KABUL","KABUL",101097,5,42,6,48
"KABUL","KABUL",101097,6,43,7,50
"KABUL","KABUL",101097,7,71,19,90
"KABUL","KABUL",101097,8,85,24,109
"KABUL","KABUL",101097,9,65,20,85
"KABUL","KABUL",101096,1,337,123,460
"KABUL","KABUL",101096,2,267,90,357
"KABUL","KABUL",101096,3,221,107,328
"KABUL","KABUL",101096,4,172,37,209
"KABUL","KABUL",101296,8,101,22,123
"KABUL","KABUL",101289,1,301,67,368
"KABUL","KABUL",101289,2,307,80,387
"KABUL","KABUL",101289,3,468,113,581
"KABUL","KABUL",101289,4,490,98,588
"KABUL","KABUL",101289,5,332,40,372
"KABUL","KABUL",101289,6,250,32,282
"KABUL","KABUL",101289,7,175,26,201
"KABUL","KABUL",101289,8,169,24,193
"KABUL","KABUL",101298,1,211,129,340
"KABUL","KABUL",101107,5,533,64,597
"KABUL","KABUL",101107,6,240,21,261
"KABUL","KABUL",101106,1,381,66,447
"KABUL","KABUL",101106,2,392,58,450
"KABUL","KABUL",101106,3,389,39,428
"KABUL","KABUL",101106,4,533,49,582
"KABUL","KABUL",101106,5,545,30,575
"KABUL","KABUL",101105,1,335,162,497
"KABUL","KABUL",101105,2,323,134,457
"KABUL","KABUL",101105,3,290,59,349
"KABUL","KABUL",101115,1,292,131,423
"KABUL","KABUL",101115,2,304,108,412
"KABUL","KABUL",101115,3,229,82,311
"KABUL","KABUL",101115,4,105,27,132
"KABUL","KABUL",101115,5,105,26,131
"KABUL","KABUL",101114,1,133,44,177
"KABUL","KABUL",101114,2,127,44,171
"KABUL","KABUL",101114,3,96,34,130
"KABUL","KABUL",101114,4,113,13,126
"KABUL","KABUL",101114,5,77,21,98
"KABUL","KABUL",101124,1,419,126,545
"KABUL","KABUL",101124,2,297,91,388
"KABUL","KABUL",101124,3,337,90,427
"KABUL","KABUL",101241,5,476,114,590
"KABUL","KABUL",101241,6,420,116,536
"KABUL","KABUL",101241,7,461,127,588
"KABUL","KABUL",101124,7,345,66,411
"KABUL","KABUL",101122,1,266,312,578
"KABUL","KABUL",101109,3,79,91,170
"KABUL","KABUL",101109,4,28,27,55
"KABUL","KABUL",101122,4,132,164,296
"KABUL","KABUL",101108,9,71,25,96
"KABUL","KABUL",101108,10,78,28,106
"KABUL","KABUL",101121,1,358,221,579
"KABUL","KABUL",101121,2,349,235,584
"KABUL","KABUL",101121,3,394,200,594
"KABUL","KABUL",101121,4,309,140,449
"KABUL","KABUL",101121,5,284,139,423
"KABUL","KABUL",101121,6,193,87,280
"KABUL","KABUL",101121,7,189,51,240
"KABUL","KABUL",101101,1,373,134,507
"KABUL","KABUL",101101,2,363,115,478
"KABUL","KABUL",101101,3,349,100,449
"KABUL","KABUL",101101,4,406,99,505
"KABUL","KABUL",101101,5,447,105,552
"KABUL","KABUL",101111,1,319,166,485
"KABUL","KABUL",101111,2,284,118,402
"KABUL","KABUL",101111,3,303,107,410
"KABUL","KABUL",101278,2,497,86,583
"KABUL","KABUL",101278,3,494,86,580
"KABUL","KABUL",101103,1,442,145,587
"KABUL","KABUL",101103,2,406,154,560
"KABUL","KABUL",101113,1,234,135,369
"KABUL","KABUL",101113,2,203,169,372
"KABUL","KABUL",101113,3,228,119,347
"KABUL","KABUL",101113,4,96,36,132
"KABUL","KABUL",101113,5,128,59,187
"KABUL","KABUL",101113,6,175,75,250
"KABUL","KABUL",101116,1,229,118,347
"KABUL","KABUL",101116,2,196,126,322
"KABUL","KABUL",101116,3,92,34,126
"KABUL","KABUL",101116,4,88,38,126
"KABUL","KABUL",101116,5,90,34,124
"KABUL","KABUL",101108,1,137,81,218
"KABUL","KABUL",101108,2,176,143,319
"KABUL","KABUL",101108,3,231,131,362
"KABUL","KABUL",101108,4,186,98,284
"KABUL","KABUL",101108,5,63,38,101
"KABUL","KABUL",101108,6,77,31,108
"KABUL","KABUL",101108,7,46,46,92
"KABUL","KABUL",101108,8,59,39,98
"KABUL","KABUL",101120,3,119,195,314
"KABUL","KABUL",101120,4,131,246,377
"KABUL","KABUL",101120,5,12,28,40
"KABUL","KABUL",101120,6,12,44,56
"KABUL","KABUL",101120,7,58,70,128
"KABUL","KABUL",101120,8,30,50,80
"KABUL","KABUL",101107,1,442,72,514
"KABUL","KABUL",101107,2,345,59,404
"KABUL","KABUL",101107,3,496,92,588
"KABUL","KABUL",101107,4,530,56,586
"KABUL","KABUL",101028,7,23,13,36
"KABUL","KABUL",101011,1,80,59,139
"KABUL","KABUL",101011,2,48,27,75
"KABUL","KABUL",101011,3,48,12,60
"KABUL","KABUL",101012,1,149,97,246
"KABUL","KABUL",101012,2,63,60,123
"KABUL","KABUL",101016,1,139,75,214
"KABUL","KABUL",101111,4,305,39,344
"KABUL","KABUL",101111,5,473,101,574
"KABUL","KABUL",101016,4,33,19,52
"KABUL","KABUL",101016,5,33,15,48
"KABUL","KABUL",101103,3,341,145,486
"KABUL","KABUL",101103,4,509,77,586
"KABUL","KABUL",101103,5,394,67,461
"KABUL","KABUL",101103,6,345,44,389
"KABUL","KABUL",101118,1,275,113,388
"KABUL","KABUL",101118,2,236,123,359
"KABUL","KABUL",101118,3,207,82,289
"KABUL","KABUL",101118,4,182,65,247
"KABUL","KABUL",101118,5,162,49,211
"KABUL","KABUL",101118,6,149,45,194
"KABUL","KABUL",101118,7,165,36,201
"KABUL","KABUL",101118,8,108,32,140
"KABUL","KABUL",101118,9,262,62,324
"KABUL","KABUL",101117,1,329,159,488
"KABUL","KABUL",101117,2,245,113,358
"KABUL","KABUL",101117,3,240,74,314
"KABUL","KABUL",101117,4,247,87,334
"KABUL","KABUL",101120,1,112,148,260
"KABUL","KABUL",101120,2,108,144,252
"KABUL","KABUL",101072,3,159,68,227
"KABUL","KABUL",101072,4,144,57,201
"KABUL","KABUL",101071,1,390,156,546
"KABUL","KABUL",101071,2,325,147,472
"KABUL","KABUL",101071,3,345,99,444
"KABUL","KABUL",101071,4,321,99,420
"KABUL","KABUL",101069,1,143,147,290
"KABUL","KABUL",101069,2,117,123,240
"KABUL","KABUL",101069,3,27,31,58
"KABUL","KABUL",101070,1,169,390,559
"KABUL","KABUL",101070,2,168,404,572
"KABUL","KABUL",101070,3,134,432,566
"KABUL","KABUL",101070,4,115,217,332
"KABUL","KABUL",101070,5,78,92,170
"KABUL","KABUL",101070,6,69,82,151
"KABUL","KABUL",101070,7,92,112,204
"KABUL","KABUL",101070,8,99,102,201
"KABUL","KABUL",101016,2,57,47,104
"KABUL","KABUL",101016,3,48,41,89
"KABUL","KABUL",101077,2,211,188,399
"KABUL","KABUL",101077,3,264,294,558
"KABUL","KABUL",101013,1,103,45,148
"KABUL","KABUL",101013,2,155,61,216
"KABUL","KABUL",101013,3,190,98,288
"KABUL","KABUL",101013,4,125,37,162
"KABUL","KABUL",101013,5,166,34,200
"KABUL","KABUL",101018,1,82,32,114
"KABUL","KABUL",101018,2,67,32,99
"KABUL","KABUL",101018,3,53,19,72
"KABUL","KABUL",101019,1,166,90,256
"KABUL","KABUL",101019,2,179,83,262
"KABUL","KABUL",101019,3,72,23,95
"KABUL","KABUL",101019,4,80,32,112
"KABUL","KABUL",101124,4,318,96,414
"KABUL","KABUL",101124,5,483,97,580
"KABUL","KABUL",101124,6,476,82,558
"KABUL","KABUL",101017,3,366,94,460
"KABUL","KABUL",101014,1,420,54,474
"KABUL","KABUL",101122,2,174,216,390
"KABUL","KABUL",101122,3,161,206,367
"KABUL","KABUL",101296,6,78,32,110
"KABUL","KABUL",101296,7,70,37,107
"KABUL","KABUL",101318,3,125,95,220
"KABUL","KABUL",101318,4,176,175,351
"KABUL","KABUL",101318,5,97,76,173
"KABUL","KABUL",101497,5,31,390,421
"KABUL","KABUL",101497,6,22,427,449
"KABUL","KABUL",101028,3,155,93,248
"KABUL","KABUL",101028,4,183,115,298
"KABUL","KABUL",101028,5,23,7,30
"KABUL","KABUL",101028,6,9,22,31
"KABUL","KABUL",101521,3,27,244,271
"KABUL","KABUL",101521,4,13,125,138
"KABUL","KABUL",101508,1,190,222,412
"KABUL","KABUL",101508,2,357,216,573
"KABUL","KABUL",101508,3,160,35,195
"KABUL","KABUL",101508,4,110,28,138
"KABUL","KABUL",101070,9,22,52,74
"KABUL","KABUL",101077,1,132,121,253
"KABUL","KABUL",101513,2,70,463,533
"KABUL","KABUL",101513,3,59,535,594
"KABUL","KABUL",101077,4,39,59,98
"KABUL","KABUL",101077,5,40,50,90
"KABUL","KABUL",101077,6,47,45,92
"KABUL","KABUL",101213,3,42,41,83
"KABUL","KABUL",101213,4,49,41,90
"KABUL","KABUL",101212,1,131,125,256
"KABUL","KABUL",101212,2,100,95,195
"KABUL","KABUL",101065,2,179,101,280
"KABUL","KABUL",101065,3,236,138,374
"KABUL","KABUL",101065,4,167,62,229
"KABUL","KABUL",101065,5,108,30,138
"KABUL","KABUL",101184,1,210,378,588
"KABUL","KABUL",101184,2,151,234,385
"KABUL","KABUL",101184,3,159,228,387
"KABUL","KABUL",101184,4,57,165,222
"KABUL","KABUL",101067,3,28,24,52
"KABUL","KABUL",101067,4,23,21,44
"KABUL","KABUL",101072,1,268,157,425
"KABUL","KABUL",101072,2,304,149,453
"KABUL","KABUL",101235,1,252,80,332
"KABUL","KABUL",101318,2,128,185,313
"KABUL","KABUL",101140,3,146,116,262
"KABUL","KABUL",101235,2,219,77,296
"KABUL","KABUL",101235,3,305,88,393
"KABUL","KABUL",101318,6,33,52,85
"KABUL","KABUL",101318,7,70,71,141
"KABUL","KABUL",101315,1,53,161,214
"KABUL","KABUL",101315,2,61,167,228
"KABUL","KABUL",101315,3,24,77,101
"KABUL","KABUL",101315,4,14,78,92
"KABUL","KABUL",101312,1,112,314,426
"KABUL","KABUL",101312,2,125,381,506
"KABUL","KABUL",101312,3,134,262,396
"KABUL","KABUL",101139,5,236,69,305
"KABUL","KABUL",101139,6,259,109,368
"KABUL","KABUL",101139,7,246,75,321
"KABUL","KABUL",101508,5,199,39,238
"KABUL","KABUL",101513,1,48,324,372
"KABUL","KABUL",101141,3,142,74,216
"KABUL","KABUL",101141,4,120,79,199
"KABUL","KABUL",101513,4,34,325,359
"KABUL","KABUL",101186,4,107,237,344
"KABUL","KABUL",101186,5,90,104,194
"KABUL","KABUL",101073,1,145,436,581
"KABUL","KABUL",101073,2,120,449,569
"KABUL","KABUL",101073,3,118,443,561
"KABUL","KABUL",101073,4,77,155,232
"KABUL","KABUL",101073,5,72,180,252
"KABUL","KABUL",101073,6,72,181,253
"KABUL","KABUL",101073,7,52,166,218
"KABUL","KABUL",101073,8,99,276,375
"KABUL","KABUL",101073,9,119,377,496
"KABUL","KABUL",101075,1,165,318,483
"KABUL","KABUL",101075,2,141,232,373
"KABUL","KABUL",101075,3,158,267,425
"KABUL","KABUL",101075,4,109,187,296
"KABUL","KABUL",101296,3,95,39,134
"KABUL","KABUL",101296,4,61,35,96
"KABUL","KABUL",101296,5,84,28,112
"KABUL","KABUL",101140,1,201,173,374
"KABUL","KABUL",101140,2,110,115,225
"KABUL","KABUL",101002,4,106,47,153
"KABUL","KABUL",101002,5,84,38,122
"KABUL","KABUL",101141,1,352,233,585
"KABUL","KABUL",101235,4,220,91,311
"KABUL","KABUL",101235,5,188,95,283
"KABUL","KABUL",101237,1,341,137,478
"KABUL","KABUL",101497,7,26,158,184
"KABUL","KABUL",101497,8,38,215,253
"KABUL","KABUL",101521,1,30,225,255
"KABUL","KABUL",101521,2,53,539,592
"KABUL","KABUL",101002,1,221,166,387
"KABUL","KABUL",101002,2,204,158,362
"KABUL","KABUL",101002,3,138,112,250
"KABUL","KABUL",101237,7,158,58,216
"KABUL","KABUL",101212,3,115,110,225
"KABUL","KABUL",101228,1,180,132,312
"KABUL","KABUL",101141,2,323,254,577
"KABUL","KABUL",101008,2,259,291,550
"KABUL","KABUL",101180,5,35,36,71
"KABUL","KABUL",101141,5,79,61,140
"KABUL","KABUL",101141,6,69,58,127
"KABUL","KABUL",101141,7,111,85,196
"KABUL","KABUL",101186,6,94,135,229
"KABUL","KABUL",101185,1,175,411,586
"KABUL","KABUL",101185,2,114,456,570
"KABUL","KABUL",101007,2,32,22,54
"KABUL","KABUL",101007,1,46,12,58
"KABUL","KABUL",101236,1,397,174,571
"KABUL","KABUL",101236,2,269,124,393
"KABUL","KABUL",101228,2,145,196,341
"KABUL","KABUL",101320,3,83,25,108
"KABUL","KABUL",101319,1,68,126,194
"KABUL","KABUL",101019,5,69,30,99
"KABUL","KABUL",101017,1,254,84,338
"KABUL","KABUL",101017,2,200,46,246
"KABUL","KABUL",101233,5,169,100,269
"KABUL","KABUL",101233,6,232,124,356
"KABUL","KABUL",101233,7,117,55,172
"KABUL","KABUL",101137,3,31,53,84
"KABUL","KABUL",101135,5,63,115,178
"KABUL","KABUL",101135,6,53,51,104
"KABUL","KABUL",101135,7,97,80,177
"KABUL","KABUL",101002,6,45,19,64
"KABUL","KABUL",101140,4,76,46,122
"KABUL","KABUL",101140,5,107,68,175
"KABUL","KABUL",101140,6,89,67,156
"KABUL","KABUL",101237,2,189,72,261
"KABUL","KABUL",101237,3,171,53,224
"KABUL","KABUL",101006,5,17,27,44
"KABUL","KABUL",101006,6,52,45,97
"KABUL","KABUL",101237,5,226,78,304
"KABUL","KABUL",101237,6,190,63,253
"KABUL","KABUL",101008,6,20,19,39
"KABUL","KABUL",101008,5,30,10,40
"KABUL","KABUL",101008,4,18,7,25
"KABUL","KABUL",101139,1,318,146,464
"KABUL","KABUL",101008,1,240,351,591
"KABUL","KABUL",101236,5,102,49,151
"KABUL","KABUL",101236,6,96,39,135
"KABUL","KABUL",101177,1,302,203,505
"KABUL","KABUL",101186,2,263,326,589
"KABUL","KABUL",101186,3,237,359,596
"KABUL","KABUL",101141,8,101,79,180
"KABUL","KABUL",101177,6,74,27,101
"KABUL","KABUL",101007,3,22,7,29
"KABUL","KABUL",101137,4,15,31,46
"KABUL","KABUL",101247,5,298,155,453
"KABUL","KABUL",101139,4,266,128,394
"KABUL","KABUL",101319,2,40,57,97
"KABUL","KABUL",101236,3,340,157,497
"KABUL","KABUL",101236,4,105,52,157
"KABUL","KABUL",101296,2,186,64,250
"KABUL","KABUL",101067,2,153,154,307
"KABUL","KABUL",101319,3,26,36,62
"KABUL","KABUL",101233,4,137,75,212
"KABUL","KABUL",101137,2,32,32,64
"KABUL","KABUL",101139,3,269,150,419
"KABUL","KABUL",101137,5,14,26,40
"KABUL","KABUL",101247,4,354,178,532
"KABUL","KABUL",101139,2,197,105,302
"KABUL","KABUL",101135,3,82,90,172
"KABUL","KABUL",101237,4,117,50,167
"KABUL","KABUL",101135,1,239,317,556
"KABUL","KABUL",101135,2,233,344,577
"KABUL","KABUL",101008,3,115,159,274
"KABUL","KABUL",101177,3,273,159,432
"KABUL","KABUL",101135,4,75,108,183
"KABUL","KABUL",101137,1,39,36,75
"KABUL","KABUL",101177,2,271,185,456
"KABUL","KABUL",101065,6,101,38,139
"KABUL","KABUL",101177,4,61,62,123
"KABUL","KABUL",101236,7,239,95,334
"KABUL","KABUL",101143,7,86,104,190
"KABUL","KABUL",101247,3,323,162,485
"KABUL","KABUL",101296,1,230,118,348
"KABUL","KABUL",101177,5,55,37,92
"KABUL","KABUL",101228,3,17,79,96
"KABUL","KABUL",101065,7,53,20,73
"KABUL","KABUL",101233,2,394,186,580
"KABUL","KABUL",101067,1,182,124,306
"KABUL","KABUL",101233,3,235,128,363
"KABUL","KABUL",101247,1,362,170,532
"KABUL","KABUL",101247,2,338,175,513
"KABUL","KABUL",101233,1,378,210,588
"KABUL","PAGHMAN",102413,3,47,70,117
"KABUL","PAGHMAN",102415,1,129,120,249
"KABUL","PAGHMAN",102404,3,158,385,543
"KABUL","PAGHMAN",102408,3,12,307,319
"KABUL","PAGHMAN",102403,3,86,13,99
"KABUL","PAGHMAN",102413,2,50,127,177
"KABUL","PAGHMAN",102403,1,146,39,185
"KABUL","PAGHMAN",102403,2,119,40,159
"KABUL","PAGHMAN",102409,3,136,25,161
"KABUL","PAGHMAN",102403,4,64,15,79
"KABUL","PAGHMAN",102408,5,1,78,79
"KABUL","PAGHMAN",102417,1,8,150,158
"KABUL","PAGHMAN",102411,4,112,246,358
"KABUL","PAGHMAN",102409,4,128,22,150
"KABUL","PAGHMAN",102404,1,110,295,405
"KABUL","PAGHMAN",102414,1,12,184,196
"KABUL","PAGHMAN",102415,2,107,120,227
"KABUL","PAGHMAN",102408,4,0,83,83
"KABUL","PAGHMAN",102410,1,187,396,583
"KABUL","PAGHMAN",102404,2,158,394,552
"KABUL","PAGHMAN",102411,3,154,309,463
"KABUL","PAGHMAN",102414,6,0,17,17
"KABUL","PAGHMAN",102415,3,95,37,132
"KABUL","PAGHMAN",102410,2,176,410,586
"KABUL","PAGHMAN",102402,1,80,43,123
"KABUL","PAGHMAN",102400,3,35,238,273
"KABUL","PAGHMAN",102408,1,35,384,419
"KABUL","PAGHMAN",102405,3,150,145,295
"KABUL","PAGHMAN",102405,4,92,48,140
"KABUL","PAGHMAN",102410,4,89,157,246
"KABUL","PAGHMAN",102398,5,8,98,106
"KABUL","PAGHMAN",102417,2,23,265,288
"KABUL","PAGHMAN",102417,3,9,120,129
"KABUL","PAGHMAN",102400,2,49,239,288
"KABUL","PAGHMAN",102412,1,66,514,580
"KABUL","PAGHMAN",102399,5,3,0,3
"KABUL","PAGHMAN",102418,1,32,154,186
"KABUL","PAGHMAN",102417,4,1,148,149
"KABUL","PAGHMAN",102408,2,16,271,287
"KABUL","PAGHMAN",102416,3,206,83,289
"KABUL","PAGHMAN",102411,1,148,288,436
"KABUL","PAGHMAN",102411,2,130,304,434
"KABUL","PAGHMAN",102398,4,51,199,250
"KABUL","PAGHMAN",102400,1,35,173,208
"KABUL","PAGHMAN",102398,6,9,114,123
"KABUL","PAGHMAN",102399,1,81,80,161
"KABUL","PAGHMAN",102404,4,330,253,583
"KABUL","PAGHMAN",102413,1,95,157,252
"KABUL","PAGHMAN",102399,4,25,19,44
"KABUL","PAGHMAN",102402,2,57,29,86
"KABUL","PAGHMAN",102418,2,28,141,169
"KABUL","PAGHMAN",102416,2,24,121,145
"KABUL","PAGHMAN",102407,5,55,33,88
"KABUL","PAGHMAN",102414,5,1,17,18
"KABUL","PAGHMAN",102409,2,210,92,302
"KABUL","PAGHMAN",102405,2,89,66,155
"KABUL","PAGHMAN",102409,1,292,120,412
"KABUL","PAGHMAN",102401,1,217,108,325
"KABUL","PAGHMAN",102400,4,43,166,209
"KABUL","PAGHMAN",102399,2,38,54,92
"KABUL","PAGHMAN",102410,3,140,262,402
"KABUL","PAGHMAN",102418,3,1,49,50
"KABUL","PAGHMAN",102414,2,16,155,171
"KABUL","PAGHMAN",102402,3,195,80,275
"KABUL","PAGHMAN",102402,4,80,17,97
"KABUL","PAGHMAN",102405,1,252,176,428
"KABUL","PAGHMAN",102416,1,22,102,124
"KABUL","PAGHMAN",102398,3,24,151,175
"KABUL","PAGHMAN",102398,2,18,208,226
"KABUL","PAGHMAN",102400,6,4,1,5
"KABUL","PAGHMAN",102399,3,36,44,80
"KABUL","PAGHMAN",102407,3,239,39,278
"KABUL","PAGHMAN",102400,5,4,1,5
"KABUL","PAGHMAN",102406,2,92,57,149
"KABUL","PAGHMAN",102407,4,218,41,259
"KABUL","PAGHMAN",102399,6,4,1,5
"KABUL","PAGHMAN",102406,1,77,51,128
"KABUL","PAGHMAN",102406,4,184,63,247
"KABUL","PAGHMAN",102406,3,153,84,237
"KABUL","PAGHMAN",102412,3,80,508,588
"KABUL","PAGHMAN",102414,4,10,122,132
"KABUL","PAGHMAN",102401,2,216,121,337
"KABUL","PAGHMAN",102401,3,205,71,276
"KABUL","PAGHMAN",102407,2,467,125,592
"KABUL","PAGHMAN",102402,5,107,19,126
"KABUL","PAGHMAN",102398,1,34,250,284
"KABUL","PAGHMAN",102399,7,7,0,7
"KABUL","PAGHMAN",102407,1,465,120,585
"KABUL","PAGHMAN",102412,4,3,33,36
"KABUL","PAGHMAN",102414,3,4,190,194
"KABUL","PAGHMAN",102412,2,88,490,578
"KABUL","CHAHAR ASYAB",103423,3,27,75,102
"KABUL","CHAHAR ASYAB",103429,5,5,465,470
"KABUL","CHAHAR ASYAB",103419,4,6,203,209
"KABUL","CHAHAR ASYAB",103536,2,6,361,367
"KABUL","CHAHAR ASYAB",103429,3,41,11,52
"KABUL","CHAHAR ASYAB",103423,2,38,136,174
"KABUL","CHAHAR ASYAB",103429,1,71,29,100
"KABUL","CHAHAR ASYAB",103427,2,9,50,59
"KABUL","CHAHAR ASYAB",103429,4,11,584,595
"KABUL","CHAHAR ASYAB",103425,5,7,82,89
"KABUL","CHAHAR ASYAB",103429,2,69,70,139
"KABUL","CHAHAR ASYAB",103425,1,52,510,562
"KABUL","CHAHAR ASYAB",103425,2,58,346,404
"KABUL","CHAHAR ASYAB",103419,3,1,125,126
"KABUL","CHAHAR ASYAB",103427,1,12,138,150
"KABUL","CHAHAR ASYAB",103536,1,3,214,217
"KABUL","CHAHAR ASYAB",103424,2,4,110,114
"KABUL","CHAHAR ASYAB",103425,3,8,108,116
"KABUL","CHAHAR ASYAB",103421,5,11,39,50
"KABUL","CHAHAR ASYAB",103419,1,4,99,103
"KABUL","CHAHAR ASYAB",103419,2,2,274,276
"KABUL","CHAHAR ASYAB",103421,1,48,127,175
"KABUL","CHAHAR ASYAB",103426,2,4,21,25
"KABUL","CHAHAR ASYAB",103421,4,21,87,108
"KABUL","CHAHAR ASYAB",103424,1,18,468,486
"KABUL","CHAHAR ASYAB",103419,5,0,399,399
"KABUL","CHAHAR ASYAB",103428,2,4,26,30
"KABUL","CHAHAR ASYAB",103423,1,44,156,200
"KABUL","CHAHAR ASYAB",103428,1,28,161,189
"KABUL","CHAHAR ASYAB",103494,2,157,191,348
"KABUL","CHAHAR ASYAB",103426,1,33,98,131
"KABUL","CHAHAR ASYAB",103422,2,5,435,440
"KABUL","CHAHAR ASYAB",103537,1,10,244,254
"KABUL","CHAHAR ASYAB",103425,4,9,118,127
"KABUL","CHAHAR ASYAB",103536,3,0,279,279
"KABUL","CHAHAR ASYAB",103494,3,157,189,346
"KABUL","CHAHAR ASYAB",103420,4,7,581,588
"KABUL","CHAHAR ASYAB",103494,4,170,179,349
"KABUL","CHAHAR ASYAB",103494,1,185,216,401
"KABUL","CHAHAR ASYAB",103422,3,2,146,148
"KABUL","CHAHAR ASYAB",103421,3,37,93,130
"KABUL","CHAHAR ASYAB",103420,3,10,425,435
"KABUL","CHAHAR ASYAB",103420,2,9,472,481
"KABUL","CHAHAR ASYAB",103537,2,5,218,223
"KABUL","CHAHAR ASYAB",103421,2,56,105,161
"KABUL","CHAHAR ASYAB",103420,1,16,470,486
"KABUL","CHAHAR ASYAB",103537,3,9,375,384
"KABUL","CHAHAR ASYAB",103422,1,11,326,337
"KABUL","BAGRAMI",104456,4,86,309,395
"KABUL","BAGRAMI",104461,4,5,583,588
"KABUL","BAGRAMI",104461,1,13,572,585
"KABUL","BAGRAMI",104454,2,450,116,566
"KABUL","BAGRAMI",104456,5,107,380,487
"KABUL","BAGRAMI",104461,2,27,563,590
"KABUL","BAGRAMI",104456,1,125,460,585
"KABUL","BAGRAMI",104538,1,47,543,590
"KABUL","BAGRAMI",104540,5,20,264,284
"KABUL","BAGRAMI",104454,1,454,136,590
"KABUL","BAGRAMI",104455,3,78,512,590
"KABUL","BAGRAMI",104461,3,4,97,101
"KABUL","BAGRAMI",104461,5,9,582,591
"KABUL","BAGRAMI",104452,2,110,274,384
"KABUL","BAGRAMI",104451,4,17,22,39
"KABUL","BAGRAMI",104455,4,29,377,406
"KABUL","BAGRAMI",104456,2,156,424,580
"KABUL","BAGRAMI",104456,3,157,424,581
"KABUL","BAGRAMI",104455,1,30,550,580
"KABUL","BAGRAMI",104462,2,57,159,216
"KABUL","BAGRAMI",104462,3,72,179,251
"KABUL","BAGRAMI",104462,4,46,169,215
"KABUL","BAGRAMI",104540,4,30,414,444
"KABUL","BAGRAMI",104538,2,23,554,577
"KABUL","BAGRAMI",104538,3,29,127,156
"KABUL","BAGRAMI",104454,3,231,39,270
"KABUL","BAGRAMI",104453,3,64,86,150
"KABUL","BAGRAMI",104457,4,145,78,223
"KABUL","BAGRAMI",104453,1,273,318,591
"KABUL","BAGRAMI",104453,2,54,63,117
"KABUL","BAGRAMI",104457,1,250,116,366
"KABUL","BAGRAMI",104452,4,67,175,242
"KABUL","BAGRAMI",104455,2,56,532,588
"KABUL","BAGRAMI",104460,2,3,330,333
"KABUL","BAGRAMI",104540,3,11,242,253
"KABUL","BAGRAMI",104452,1,162,325,487
"KABUL","BAGRAMI",104460,1,3,240,243
"KABUL","BAGRAMI",104458,3,73,331,404
"KABUL","BAGRAMI",104460,3,1,326,327
"KABUL","BAGRAMI",104452,3,103,207,310
"KABUL","BAGRAMI",104458,1,100,468,568
"KABUL","BAGRAMI",104454,4,251,25,276
"KABUL","BAGRAMI",104540,2,38,551,589
"KABUL","BAGRAMI",104455,6,19,402,421
"KABUL","BAGRAMI",104457,2,149,78,227
"KABUL","BAGRAMI",104451,3,13,19,32
"KABUL","BAGRAMI",104451,2,87,69,156
"KABUL","BAGRAMI",104462,1,113,378,491
"KABUL","BAGRAMI",104457,3,145,91,236
"KABUL","BAGRAMI",104455,5,10,82,92
"KABUL","BAGRAMI",104453,4,98,136,234
"KABUL","BAGRAMI",104540,1,27,457,484
"KABUL","BAGRAMI",104459,4,48,109,157
"KABUL","BAGRAMI",104456,6,102,177,279
"KABUL","BAGRAMI",104450,2,108,70,178
"KABUL","BAGRAMI",104451,1,290,283,573
"KABUL","BAGRAMI",104539,2,139,335,474
"KABUL","BAGRAMI",104459,3,42,113,155
"KABUL","BAGRAMI",104455,7,12,315,327
"KABUL","BAGRAMI",104458,2,137,443,580
"KABUL","BAGRAMI",104450,1,112,87,199
"KABUL","BAGRAMI",104459,2,100,396,496
"KABUL","BAGRAMI",104450,3,90,47,137
"KABUL","BAGRAMI",104539,3,24,286,310
"KABUL","BAGRAMI",104539,1,183,327,510
"KABUL","BAGRAMI",104459,1,100,404,504
"KABUL","BAGRAMI",104450,4,127,120,247
"KABUL","DEHSABZ",105533,2,59,381,440
"KABUL","DEHSABZ",105463,2,151,9,160
"KABUL","DEHSABZ",105463,3,61,8,69
"KABUL","DEHSABZ",105533,3,0,16,16
"KABUL","DEHSABZ",105533,1,75,404,479
"KABUL","DEHSABZ",105468,7,30,68,98
"KABUL","DEHSABZ",105464,6,24,9,33
"KABUL","DEHSABZ",105467,2,47,150,197
"KABUL","DEHSABZ",105467,1,13,147,160
"KABUL","DEHSABZ",105465,4,4,38,42
"KABUL","DEHSABZ",105464,5,68,26,94
"KABUL","DEHSABZ",105468,6,22,36,58
"KABUL","DEHSABZ",105467,3,39,195,234
"KABUL","DEHSABZ",105472,2,10,9,19
"KABUL","DEHSABZ",105467,4,2,13,15
"KABUL","DEHSABZ",105467,5,5,9,14
"KABUL","DEHSABZ",105472,1,72,150,222
"KABUL","DEHSABZ",105471,2,9,53,62
"KABUL","DEHSABZ",105468,10,25,175,200
"KABUL","DEHSABZ",105468,5,7,80,87
"KABUL","DEHSABZ",105465,2,24,234,258
"KABUL","DEHSABZ",105470,3,9,161,170
"KABUL","DEHSABZ",105471,3,9,58,67
"KABUL","DEHSABZ",105470,1,31,401,432
"KABUL","DEHSABZ",105471,1,7,154,161
"KABUL","DEHSABZ",105464,2,163,131,294
"KABUL","DEHSABZ",105465,3,17,24,41
"KABUL","DEHSABZ",105468,8,16,54,70
"KABUL","DEHSABZ",105470,2,16,185,201
"KABUL","DEHSABZ",105468,3,82,299,381
"KABUL","DEHSABZ",105468,2,97,198,295
"KABUL","DEHSABZ",105466,1,486,111,597
"KABUL","DEHSABZ",105330,6,9,212,221
"KABUL","DEHSABZ",105471,5,0,39,39
"KABUL","DEHSABZ",105463,4,43,6,49
"KABUL","DEHSABZ",105468,9,166,144,310
"KABUL","DEHSABZ",105471,4,7,70,77
"KABUL","DEHSABZ",105469,1,65,506,571
"KABUL","DEHSABZ",105330,2,19,480,499
"KABUL","DEHSABZ",105330,3,17,418,435
"KABUL","DEHSABZ",105465,1,21,176,197
"KABUL","DEHSABZ",105464,4,26,6,32
"KABUL","DEHSABZ",105463,1,276,32,308
"KABUL","DEHSABZ",105474,1,8,89,97
"KABUL","DEHSABZ",105463,5,63,130,193
"KABUL","DEHSABZ",105463,6,50,3,53
"KABUL","DEHSABZ",105463,7,67,9,76
"KABUL","DEHSABZ",105463,8,69,1,70
"KABUL","DEHSABZ",105464,3,82,90,172
"KABUL","DEHSABZ",105330,7,5,117,122
"KABUL","DEHSABZ",105469,4,43,347,390
"KABUL","DEHSABZ",105468,4,26,41,67
"KABUL","DEHSABZ",105470,5,10,39,49
"KABUL","DEHSABZ",105474,2,22,109,131
"KABUL","DEHSABZ",105474,3,0,5,5
"KABUL","DEHSABZ",105470,4,8,86,94
"KABUL","DEHSABZ",105475,4,3,25,28
"KABUL","DEHSABZ",105464,1,136,115,251
"KABUL","DEHSABZ",105330,4,21,284,305
"KABUL","DEHSABZ",105330,5,21,188,209
"KABUL","DEHSABZ",105541,2,25,60,85
"KABUL","DEHSABZ",105330,1,31,538,569
"KABUL","DEHSABZ",105471,6,5,19,24
"KABUL","DEHSABZ",105541,1,22,60,82
"KABUL","DEHSABZ",105469,3,31,309,340
"KABUL","DEHSABZ",105475,1,27,90,117
"KABUL","DEHSABZ",105475,2,46,109,155
"KABUL","DEHSABZ",105469,2,44,378,422
"KABUL","DEHSABZ",105466,3,331,56,387
"KABUL","DEHSABZ",105475,3,0,30,30
"KABUL","DEHSABZ",105474,4,0,3,3
"KABUL","DEHSABZ",105468,1,111,127,238
"KABUL","DEHSABZ",105541,3,13,4,17
"KABUL","DEHSABZ",105466,2,483,111,594
"KABUL","SHAKAR DARA",106396,2,228,118,346
"KABUL","SHAKAR DARA",106392,5,31,37,68
"KABUL","SHAKAR DARA",106396,3,204,141,345
"KABUL","SHAKAR DARA",106389,5,47,33,80
"KABUL","SHAKAR DARA",106396,1,269,129,398
"KABUL","SHAKAR DARA",106389,3,81,180,261
"KABUL","SHAKAR DARA",106389,4,33,36,69
"KABUL","SHAKAR DARA",106390,3,77,24,101
"KABUL","SHAKAR DARA",106389,2,69,193,262
"KABUL","SHAKAR DARA",106392,4,20,32,52
"KABUL","SHAKAR DARA",106390,2,119,12,131
"KABUL","SHAKAR DARA",106386,1,100,60,160
"KABUL","SHAKAR DARA",106397,1,319,51,370
"KABUL","SHAKAR DARA",106394,1,91,275,366
"KABUL","SHAKAR DARA",106542,2,52,11,63
"KABUL","SHAKAR DARA",106394,2,53,146,199
"KABUL","SHAKAR DARA",106386,2,79,37,116
"KABUL","SHAKAR DARA",106392,3,120,105,225
"KABUL","SHAKAR DARA",106386,4,92,9,101
"KABUL","SHAKAR DARA",106397,7,110,12,122
"KABUL","SHAKAR DARA",106543,1,12,94,106
"KABUL","SHAKAR DARA",106542,3,13,11,24
"KABUL","SHAKAR DARA",106391,2,226,245,471
"KABUL","SHAKAR DARA",106390,1,104,16,120
"KABUL","SHAKAR DARA",106395,5,81,22,103
"KABUL","SHAKAR DARA",106387,3,208,19,227
"KABUL","SHAKAR DARA",106392,2,114,94,208
"KABUL","SHAKAR DARA",106387,5,68,2,70
"KABUL","SHAKAR DARA",106397,2,517,67,584
"KABUL","SHAKAR DARA",106397,3,202,35,237
"KABUL","SHAKAR DARA",106386,3,68,32,100
"KABUL","SHAKAR DARA",106397,5,157,23,180
"KABUL","SHAKAR DARA",106397,6,110,17,127
"KABUL","SHAKAR DARA",106393,5,89,11,100
"KABUL","SHAKAR DARA",106395,6,87,21,108
"KABUL","SHAKAR DARA",106392,1,94,108,202
"KABUL","SHAKAR DARA",106543,3,4,108,112
"KABUL","SHAKAR DARA",106542,1,69,33,102
"KABUL","SHAKAR DARA",106389,1,77,156,233
"KABUL","SHAKAR DARA",106387,4,182,16,198
"KABUL","SHAKAR DARA",106388,3,93,366,459
"KABUL","SHAKAR DARA",106387,6,70,2,72
"KABUL","SHAKAR DARA",106390,4,62,13,75
"KABUL","SHAKAR DARA",106397,4,239,44,283
"KABUL","SHAKAR DARA",106543,2,9,89,98
"KABUL","SHAKAR DARA",106388,5,8,18,26
"KABUL","SHAKAR DARA",106388,6,7,16,23
"KABUL","SHAKAR DARA",106393,6,76,7,83
"KABUL","SHAKAR DARA",106390,5,35,14,49
"KABUL","SHAKAR DARA",106391,4,47,110,157
"KABUL","SHAKAR DARA",106387,2,269,18,287
"KABUL","SHAKAR DARA",106388,1,111,393,504
"KABUL","SHAKAR DARA",106394,5,15,25,40
"KABUL","SHAKAR DARA",106396,4,219,120,339
"KABUL","SHAKAR DARA",106396,5,239,51,290
"KABUL","SHAKAR DARA",106391,3,134,129,263
"KABUL","SHAKAR DARA",106393,2,122,29,151
"KABUL","SHAKAR DARA",106394,6,21,18,39
"KABUL","SHAKAR DARA",106387,1,276,21,297
"KABUL","SHAKAR DARA",106395,4,92,23,115
"KABUL","SHAKAR DARA",106394,7,11,22,33
"KABUL","SHAKAR DARA",106388,2,83,240,323
"KABUL","SHAKAR DARA",106390,6,71,9,80
"KABUL","SHAKAR DARA",106393,1,196,39,235
"KABUL","SHAKAR DARA",106394,4,50,79,129
"KABUL","SHAKAR DARA",106393,3,146,20,166
"KABUL","SHAKAR DARA",106393,4,127,2,129
"KABUL","SHAKAR DARA",106395,3,316,79,395
"KABUL","SHAKAR DARA",106388,4,10,40,50
"KABUL","SHAKAR DARA",106391,1,284,303,587
"KABUL","SHAKAR DARA",106395,1,392,91,483
"KABUL","SHAKAR DARA",106395,2,260,70,330
"KABUL","SHAKAR DARA",106394,3,38,98,136
"KABUL","MUSAHI",107437,1,24,276,300
"KABUL","MUSAHI",107432,4,1,2,3
"KABUL","MUSAHI",107433,3,35,369,404
"KABUL","MUSAHI",107432,2,3,32,35
"KABUL","MUSAHI",107431,2,84,503,587
"KABUL","MUSAHI",107431,1,53,370,423
"KABUL","MUSAHI",107437,2,23,431,454
"KABUL","MUSAHI",107432,1,14,31,45
"KABUL","MUSAHI",107433,5,2,15,17
"KABUL","MUSAHI",107437,3,4,15,19
"KABUL","MUSAHI",107431,4,43,470,513
"KABUL","MUSAHI",107436,1,15,130,145
"KABUL","MUSAHI",107436,2,15,111,126
"KABUL","MUSAHI",107431,3,22,72,94
"KABUL","MUSAHI",107433,1,18,250,268
"KABUL","MUSAHI",107433,4,2,52,54
"KABUL","MUSAHI",107435,2,1,41,42
"KABUL","MUSAHI",107438,2,17,206,223
"KABUL","MUSAHI",107433,2,29,237,266
"KABUL","MUSAHI",107436,3,2,9,11
"KABUL","MUSAHI",107433,6,0,5,5
"KABUL","MUSAHI",107435,1,60,390,450
"KABUL","MUSAHI",107438,1,11,236,247
"KABUL","MUSAHI",107434,2,8,297,305
"KABUL","MUSAHI",107434,3,7,91,98
"KABUL","MUSAHI",107434,1,25,557,582
"KABUL","MIR BACHA KO",108344,1,107,11,118
"KABUL","MIR BACHA KO",108342,1,293,7,300
"KABUL","MIR BACHA KO",108340,3,179,16,195
"KABUL","MIR BACHA KO",108339,4,41,4,45
"KABUL","MIR BACHA KO",108340,2,500,34,534
"KABUL","MIR BACHA KO",108343,2,27,4,31
"KABUL","MIR BACHA KO",108340,4,150,4,154
"KABUL","MIR BACHA KO",108342,5,100,10,110
"KABUL","MIR BACHA KO",108341,1,410,41,451
"KABUL","MIR BACHA KO",108342,4,106,9,115
"KABUL","MIR BACHA KO",108333,3,133,5,138
"KABUL","MIR BACHA KO",108344,2,112,21,133
"KABUL","MIR BACHA KO",108337,4,196,4,200
"KABUL","MIR BACHA KO",108344,3,74,9,83
"KABUL","MIR BACHA KO",108338,3,72,6,78
"KABUL","MIR BACHA KO",108341,2,507,37,544
"KABUL","MIR BACHA KO",108343,1,64,15,79
"KABUL","MIR BACHA KO",108339,3,309,26,335
"KABUL","MIR BACHA KO",108333,4,65,4,69
"KABUL","MIR BACHA KO",108333,2,132,9,141
"KABUL","MIR BACHA KO",108341,3,154,16,170
"KABUL","MIR BACHA KO",108338,1,234,60,294
"KABUL","MIR BACHA KO",108338,2,112,34,146
"KABUL","MIR BACHA KO",108342,3,371,6,377
"KABUL","MIR BACHA KO",108343,3,44,6,50
"KABUL","MIR BACHA KO",108337,3,244,5,249
"KABUL","MIR BACHA KO",108341,4,133,53,186
"KABUL","MIR BACHA KO",108340,1,371,23,394
"KABUL","MIR BACHA KO",108337,1,559,28,587
"KABUL","MIR BACHA KO",108337,2,371,23,394
"KABUL","MIR BACHA KO",108339,2,363,31,394
"KABUL","MIR BACHA KO",108335,1,87,182,269
"KABUL","MIR BACHA KO",108333,5,56,9,65
"KABUL","MIR BACHA KO",108342,2,274,12,286
"KABUL","MIR BACHA KO",108336,3,142,41,183
"KABUL","MIR BACHA KO",108334,1,208,11,219
"KABUL","MIR BACHA KO",108339,1,389,30,419
"KABUL","MIR BACHA KO",108334,3,103,9,112
"KABUL","MIR BACHA KO",108336,2,307,8,315
"KABUL","MIR BACHA KO",108336,4,47,12,59
"KABUL","MIR BACHA KO",108334,2,194,6,200
"KABUL","MIR BACHA KO",108333,1,167,13,180
"KABUL","MIR BACHA KO",108336,1,291,11,302
"KABUL","MIR BACHA KO",108335,2,9,17,26
"KABUL","KHAK-E-JABAR",109444,1,227,90,317
"KABUL","KHAK-E-JABAR",109447,3,274,316,590
"KABUL","KHAK-E-JABAR",109442,1,86,468,554
"KABUL","KHAK-E-JABAR",109447,2,302,290,592
"KABUL","KHAK-E-JABAR",109447,1,290,291,581
"KABUL","KHAK-E-JABAR",109444,3,172,5,177
"KABUL","KHAK-E-JABAR",109439,3,17,495,512
"KABUL","KHAK-E-JABAR",109444,2,279,19,298
"KABUL","KHAK-E-JABAR",109445,4,48,377,425
"KABUL","KHAK-E-JABAR",109441,2,24,574,598
"KABUL","KHAK-E-JABAR",109439,2,36,165,201
"KABUL","KHAK-E-JABAR",109439,1,10,40,50
"KABUL","KHAK-E-JABAR",109445,2,102,454,556
"KABUL","KHAK-E-JABAR",109445,1,13,429,442
"KABUL","KHAK-E-JABAR",109440,1,8,579,587
"KABUL","KHAK-E-JABAR",109443,2,6,497,503
"KABUL","KHAK-E-JABAR",109445,3,5,496,501
"KABUL","KHAK-E-JABAR",109440,3,11,589,600
"KABUL","KHAK-E-JABAR",109442,3,50,549,599
"KABUL","KHAK-E-JABAR",109440,2,18,573,591
"KABUL","KHAK-E-JABAR",109442,2,54,480,534
"KABUL","KHAK-E-JABAR",109441,1,34,400,434
"KABUL","KHAK-E-JABAR",109446,1,57,422,479
"KABUL","KHAK-E-JABAR",109443,1,87,272,359
"KABUL","KHAK-E-JABAR",109446,2,68,524,592
"KABUL","KALAKAN",110358,1,248,10,258
"KABUL","KALAKAN",110544,2,82,20,102
"KABUL","KALAKAN",110352,1,451,38,489
"KABUL","KALAKAN",110355,4,50,16,66
"KABUL","KALAKAN",110354,3,97,1,98
"KABUL","KALAKAN",110358,2,67,7,74
"KABUL","KALAKAN",110353,3,232,16,248
"KABUL","KALAKAN",110357,2,49,66,115
"KABUL","KALAKAN",110354,2,174,7,181
"KABUL","KALAKAN",110357,4,33,12,45
"KABUL","KALAKAN",110354,1,263,16,279
"KABUL","KALAKAN",110354,4,109,3,112
"KABUL","KALAKAN",110544,3,50,1,51
"KABUL","KALAKAN",110357,1,61,74,135
"KABUL","KALAKAN",110352,2,452,30,482
"KABUL","KALAKAN",110355,3,74,43,117
"KABUL","KALAKAN",110352,3,389,24,413
"KABUL","KALAKAN",110357,3,83,117,200
"KABUL","KALAKAN",110544,1,100,18,118
"KABUL","KALAKAN",110355,2,157,67,224
"KABUL","KALAKAN",110356,1,247,71,318
"KABUL","KALAKAN",110356,3,201,5,206
"KABUL","KALAKAN",110352,4,397,35,432
"KABUL","KALAKAN",110356,2,240,65,305
"KABUL","KALAKAN",110352,5,346,4,350
"KABUL","KALAKAN",110355,1,131,45,176
"KABUL","KALAKAN",110353,1,273,49,322
"KABUL","KALAKAN",110352,6,303,9,312
"KABUL","KALAKAN",110353,2,252,32,284
"GHAZNI","GHAZNI",1101026,5,239,12,251
"GHAZNI","GHAZNI",1101031,1,122,15,137
"GHAZNI","GHAZNI",1101026,3,181,10,191
"GHAZNI","GHAZNI",1101026,4,208,29,237
"GHAZNI","GHAZNI",1101058,4,474,111,585
"GHAZNI","GHAZNI",1101045,1,19,2,21
"GHAZNI","GHAZNI",1101045,2,33,1,34
"GHAZNI","GHAZNI",1101045,3,30,0,30
"GHAZNI","GHAZNI",1101020,1,64,6,70
"GHAZNI","GHAZNI",1101020,2,54,7,61
"GHAZNI","GHAZNI",1101020,3,69,5,74
"GHAZNI","GHAZNI",1101020,4,61,7,68
"GHAZNI","GHAZNI",1101009,1,94,48,142
"GHAZNI","GHAZNI",1101026,1,228,22,250
"GHAZNI","GHAZNI",1101026,2,201,20,221
"GHAZNI","GHAZNI",1101009,4,64,7,71
"GHAZNI","GHAZNI",1101009,5,92,4,96
"GHAZNI","GHAZNI",1101014,1,91,20,111
"GHAZNI","GHAZNI",1101014,2,84,26,110
"GHAZNI","GHAZNI",1101014,3,70,10,80
"GHAZNI","GHAZNI",1101014,4,81,17,98
"GHAZNI","GHAZNI",1101014,5,53,10,63
"GHAZNI","GHAZNI",1101014,6,44,18,62
"GHAZNI","GHAZNI",1101022,1,236,4,240
"GHAZNI","GHAZNI",1101022,2,336,5,341
"GHAZNI","GHAZNI",1101022,3,259,3,262
"GHAZNI","GHAZNI",1101022,4,113,7,120
"GHAZNI","GHAZNI",1101022,5,346,5,351
"GHAZNI","GHAZNI",1101022,6,313,5,318
"GHAZNI","GHAZNI",1101036,1,145,11,156
"GHAZNI","GHAZNI",1101036,2,140,5,145
"GHAZNI","GHAZNI",1101036,3,185,7,192
"GHAZNI","GHAZNI",1101036,4,313,10,323
"GHAZNI","GHAZNI",1101036,5,204,15,219
"GHAZNI","GHAZNI",1101036,6,268,18,286
"GHAZNI","GHAZNI",1101036,7,162,13,175
"GHAZNI","GHAZNI",1101011,1,88,45,133
"GHAZNI","GHAZNI",1101011,2,77,46,123
"GHAZNI","GHAZNI",1101011,3,168,88,256
"GHAZNI","GHAZNI",1101011,4,234,17,251
"GHAZNI","GHAZNI",1101011,5,215,25,240
"GHAZNI","GHAZNI",1101043,1,91,26,117
"GHAZNI","GHAZNI",1101043,2,31,30,61
"GHAZNI","GHAZNI",1101043,3,42,29,71
"GHAZNI","GHAZNI",1101028,1,75,10,85
"GHAZNI","GHAZNI",1101028,2,44,9,53
"GHAZNI","GHAZNI",1101028,3,36,0,36
"GHAZNI","GHAZNI",1101028,4,48,4,52
"GHAZNI","GHAZNI",1101018,1,238,74,312
"GHAZNI","GHAZNI",1101018,2,149,86,235
"GHAZNI","GHAZNI",1101018,3,66,44,110
"GHAZNI","GHAZNI",1101018,4,119,27,146
"GHAZNI","GHAZNI",1101018,5,209,23,232
"GHAZNI","GHAZNI",1101024,1,230,44,274
"GHAZNI","GHAZNI",1101024,2,238,42,280
"GHAZNI","GHAZNI",1101024,3,177,29,206
"GHAZNI","GHAZNI",1101024,4,97,21,118
"GHAZNI","GHAZNI",1101024,5,62,16,78
"GHAZNI","GHAZNI",1101024,6,538,46,584
"GHAZNI","GHAZNI",1101024,7,512,54,566
"GHAZNI","GHAZNI",1101017,1,51,12,63
"GHAZNI","GHAZNI",1101017,2,46,40,86
"GHAZNI","GHAZNI",1101017,3,30,8,38
"GHAZNI","GHAZNI",1101017,4,28,3,31
"GHAZNI","GHAZNI",1101017,5,28,7,35
"GHAZNI","GHAZNI",1101017,6,32,0,32
"GHAZNI","GHAZNI",1101052,1,59,123,182
"GHAZNI","GHAZNI",1101052,2,3,3,6
"GHAZNI","GHAZNI",1101052,3,9,1,10
"GHAZNI","GHAZNI",1101012,1,279,68,347
"GHAZNI","GHAZNI",1101012,2,236,83,319
"GHAZNI","GHAZNI",1101012,3,143,44,187
"GHAZNI","GHAZNI",1101012,4,456,35,491
"GHAZNI","GHAZNI",1101057,1,84,291,375
"GHAZNI","GHAZNI",1101057,2,65,201,266
"GHAZNI","GHAZNI",1101057,3,59,241,300
"GHAZNI","GHAZNI",1101057,4,166,259,425
"GHAZNI","GHAZNI",1101056,1,126,424,550
"GHAZNI","GHAZNI",1101056,2,82,55,137
"GHAZNI","GHAZNI",1101056,3,45,41,86
"GHAZNI","GHAZNI",1101054,1,6,190,196
"GHAZNI","GHAZNI",1101054,2,5,0,5
"GHAZNI","GHAZNI",1101058,1,332,115,447
"GHAZNI","GHAZNI",1101058,2,230,61,291
"GHAZNI","GHAZNI",1101058,3,207,81,288
"GHAZNI","GHAZNI",1101046,1,161,43,204
"GHAZNI","GHAZNI",1101042,1,111,26,137
"GHAZNI","GHAZNI",1101042,2,57,12,69
"GHAZNI","GHAZNI",1101042,3,93,17,110
"GHAZNI","GHAZNI",1101053,1,6,84,90
"GHAZNI","GHAZNI",1101053,2,12,38,50
"GHAZNI","GHAZNI",1101053,3,5,47,52
"GHAZNI","GHAZNI",1101047,1,6,0,6
"GHAZNI","GHAZNI",1101048,1,20,84,104
"GHAZNI","GHAZNI",1101048,2,2,55,57
"GHAZNI","GHAZNI",1101055,1,14,306,320
"GHAZNI","GHAZNI",1101055,2,3,3,6
"GHAZNI","GHAZNI",1101023,1,177,32,209
"GHAZNI","GHAZNI",1101023,2,81,19,100
"GHAZNI","GHAZNI",1101023,3,94,6,100
"GHAZNI","GHAZNI",1101023,4,118,25,143
"GHAZNI","GHAZNI",1101023,5,219,5,224
"GHAZNI","GHAZNI",1101023,6,272,14,286
"GHAZNI","GHAZNI",1101029,1,164,17,181
"GHAZNI","GHAZNI",1101029,2,112,15,127
"GHAZNI","GHAZNI",1101029,3,107,15,122
"GHAZNI","GHAZNI",1101029,4,63,10,73
"GHAZNI","GHAZNI",1101029,5,152,6,158
"GHAZNI","GHAZNI",1101005,1,104,9,113
"GHAZNI","GHAZNI",1101005,2,50,5,55
"GHAZNI","GHAZNI",1101005,3,49,20,69
"GHAZNI","GHAZNI",1101005,4,105,14,119
"GHAZNI","GHAZNI",1101007,1,80,28,108
"GHAZNI","GHAZNI",1101007,2,77,9,86
"GHAZNI","GHAZNI",1101031,2,83,6,89
"GHAZNI","GHAZNI",1101031,3,37,8,45
"GHAZNI","GHAZNI",1101031,4,100,5,105
"GHAZNI","GHAZNI",1101031,5,137,18,155
"GHAZNI","GHAZNI",1101031,6,170,55,225
"GHAZNI","GHAZNI",1101031,7,203,19,222
"GHAZNI","GHAZNI",1101031,8,196,21,217
"GHAZNI","GHAZNI",1101030,1,88,3,91
"GHAZNI","GHAZNI",1101030,2,57,2,59
"GHAZNI","GHAZNI",1101033,1,137,11,148
"GHAZNI","GHAZNI",1101033,2,63,7,70
"GHAZNI","GHAZNI",1101033,3,43,8,51
"GHAZNI","GHAZNI",1101033,4,67,8,75
"GHAZNI","GHAZNI",1101035,1,243,26,269
"GHAZNI","GHAZNI",1101035,2,357,29,386
"GHAZNI","GHAZNI",1101035,3,138,22,160
"GHAZNI","GHAZNI",1101035,4,368,32,400
"GHAZNI","GHAZNI",1101035,5,163,14,177
"GHAZNI","GHAZNI",1101035,6,333,35,368
"GHAZNI","GHAZNI",1101035,7,286,26,312
"GHAZNI","GHAZNI",1101009,2,72,7,79
"GHAZNI","GHAZNI",1101009,3,73,43,116
"GHAZNI","GHAZNI",1101035,9,223,12,235
"GHAZNI","GHAZNI",1101035,10,575,24,599
"GHAZNI","GHAZNI",1101035,11,559,18,577
"GHAZNI","GHAZNI",1101034,1,5,1,6
"GHAZNI","GHAZNI",1101034,2,2,7,9
"GHAZNI","GHAZNI",1101034,3,6,0,6
"GHAZNI","GHAZNI",1101034,4,4,1,5
"GHAZNI","GHAZNI",1101034,5,9,7,16
"GHAZNI","GHAZNI",1101034,6,9,13,22
"GHAZNI","GHAZNI",1101034,7,14,18,32
"GHAZNI","GHAZNI",1101034,8,4,7,11
"GHAZNI","GHAZNI",1101034,9,5,2,7
"GHAZNI","GHAZNI",1101015,2,104,23,127
"GHAZNI","GHAZNI",1101015,3,81,30,111
"GHAZNI","GHAZNI",1101015,4,116,26,142
"GHAZNI","GHAZNI",1101015,5,126,43,169
"GHAZNI","GHAZNI",1101008,1,133,56,189
"GHAZNI","GHAZNI",1101008,2,140,58,198
"GHAZNI","GHAZNI",1101007,3,99,20,119
"GHAZNI","GHAZNI",1101007,4,72,27,99
"GHAZNI","GHAZNI",1101007,5,40,21,61
"GHAZNI","GHAZNI",1101003,1,35,12,47
"GHAZNI","GHAZNI",1101003,2,21,5,26
"GHAZNI","GHAZNI",1101003,3,20,7,27
"GHAZNI","GHAZNI",1101003,4,18,12,30
"GHAZNI","GHAZNI",1101006,1,230,121,351
"GHAZNI","GHAZNI",1101006,2,208,91,299
"GHAZNI","GHAZNI",1101006,3,329,127,456
"GHAZNI","GHAZNI",1101006,4,249,123,372
"GHAZNI","GHAZNI",1101006,5,179,58,237
"GHAZNI","GHAZNI",1101006,6,4,12,16
"GHAZNI","GHAZNI",1101006,7,73,50,123
"GHAZNI","GHAZNI",1101019,1,109,18,127
"GHAZNI","GHAZNI",1101019,2,84,15,99
"GHAZNI","GHAZNI",1101019,3,93,17,110
"GHAZNI","GHAZNI",1101019,4,117,13,130
"GHAZNI","GHAZNI",1101019,5,102,10,112
"GHAZNI","GHAZNI",1101021,1,291,11,302
"GHAZNI","GHAZNI",1101021,2,258,11,269
"GHAZNI","GHAZNI",1101021,3,247,13,260
"GHAZNI","GHAZNI",1101021,4,136,7,143
"GHAZNI","GHAZNI",1101021,5,128,12,140
"GHAZNI","GHAZNI",1101013,1,316,86,402
"GHAZNI","GHAZNI",1101013,3,139,38,177
"GHAZNI","GHAZNI",1101013,4,199,58,257
"GHAZNI","GHAZNI",1101010,1,83,35,118
"GHAZNI","GHAZNI",1101010,2,51,30,81
"GHAZNI","GHAZNI",1101010,3,49,27,76
"GHAZNI","GHAZNI",1101010,4,48,20,68
"GHAZNI","GHAZNI",1101010,5,66,25,91
"GHAZNI","GHAZNI",1101010,6,109,25,134
"GHAZNI","GHAZNI",1101015,1,105,35,140
"GHAZNI","GHAZNI",1101032,6,129,30,159
"GHAZNI","GHAZNI",1101027,1,226,29,255
"GHAZNI","GHAZNI",1101027,2,176,40,216
"GHAZNI","GHAZNI",1101027,3,121,24,145
"GHAZNI","GHAZNI",1101027,4,176,36,212
"GHAZNI","GHAZNI",1101001,1,83,45,128
"GHAZNI","GHAZNI",1101008,3,126,53,179
"GHAZNI","GHAZNI",1101008,4,104,63,167
"GHAZNI","GHAZNI",1101008,5,155,70,225
"GHAZNI","GHAZNI",1101016,1,317,87,404
"GHAZNI","GHAZNI",1101016,2,175,50,225
"GHAZNI","GHAZNI",1101016,3,131,58,189
"GHAZNI","GHAZNI",1101016,4,189,62,251
"GHAZNI","GHAZNI",1101016,5,132,68,200
"GHAZNI","GHAZNI",1101016,6,164,56,220
"GHAZNI","GHAZNI",1101044,1,238,31,269
"GHAZNI","GHAZNI",1101044,2,134,16,150
"GHAZNI","GHAZNI",1101044,3,152,19,171
"GHAZNI","GHAZNI",1101044,4,175,14,189
"GHAZNI","GHAZNI",1101004,4,194,41,235
"GHAZNI","GHAZNI",1101025,5,200,26,226
"GHAZNI","GHAZNI",1101025,6,294,63,357
"GHAZNI","GHAZNI",1101032,1,23,4,27
"GHAZNI","GHAZNI",1101032,2,42,5,47
"GHAZNI","GHAZNI",1101032,3,81,14,95
"GHAZNI","GHAZNI",1101032,4,133,18,151
"GHAZNI","GHAZNI",1101032,5,102,21,123
"GHAZNI","GHAZNI",1101002,4,165,55,220
"GHAZNI","GHAZNI",1101035,8,168,10,178
"GHAZNI","GHAZNI",1101025,1,385,62,447
"GHAZNI","GHAZNI",1101025,2,252,44,296
"GHAZNI","GHAZNI",1101025,3,285,42,327
"GHAZNI","GHAZNI",1101025,4,266,38,304
"GHAZNI","GHAZNI",1101001,2,114,41,155
"GHAZNI","GHAZNI",1101001,3,107,53,160
"GHAZNI","GHAZNI",1101001,4,53,19,72
"GHAZNI","GHAZNI",1101001,5,34,23,57
"GHAZNI","GHAZNI",1101002,1,104,49,153
"GHAZNI","GHAZNI",1101002,2,97,29,126
"GHAZNI","GHAZNI",1101002,3,98,37,135
"GHAZNI","GHAZNI",1101004,2,238,65,303
"GHAZNI","GHAZNI",1101002,5,176,76,252
"GHAZNI","GHAZNI",1101002,6,31,14,45
"GHAZNI","GHAZNI",1101004,1,294,83,377
"GHAZNI","GHAZNI",1101004,3,195,58,253
"GHAZNI","WALI MOHAM",1102096,3,1,0,1
"GHAZNI","WALI MOHAM",1102096,4,0,1,1
"GHAZNI","WALI MOHAM",1102096,1,5,4,9
"GHAZNI","WALI MOHAM",1102096,2,5,3,8
"GHAZNI","KHWAJA OMAR",1103085,1,62,13,75
"GHAZNI","KHWAJA OMAR",1103085,2,53,7,60
"GHAZNI","KHWAJA OMAR",1103081,4,288,66,354
"GHAZNI","KHWAJA OMAR",1103082,1,174,21,195
"GHAZNI","KHWAJA OMAR",1103082,2,162,44,206
"GHAZNI","KHWAJA OMAR",1103086,1,31,4,35
"GHAZNI","KHWAJA OMAR",1103085,3,95,21,116
"GHAZNI","KHWAJA OMAR",1103081,2,121,18,139
"GHAZNI","KHWAJA OMAR",1103081,3,68,15,83
"GHAZNI","KHWAJA OMAR",1103086,2,24,5,29
"GHAZNI","KHWAJA OMAR",1103086,3,28,3,31
"GHAZNI","KHWAJA OMAR",1103082,3,131,21,152
"GHAZNI","KHWAJA OMAR",1103081,1,139,40,179
"GHAZNI","WAGHAZ",1104131,1,0,185,185
"GHAZNI","WAGHAZ",1104124,1,36,139,175
"GHAZNI","WAGHAZ",1104130,3,85,215,300
"GHAZNI","WAGHAZ",1104130,4,12,88,100
"GHAZNI","WAGHAZ",1104130,1,94,226,320
"GHAZNI","WAGHAZ",1104130,2,47,151,198
"GHAZNI","DEH YAK",1105070,2,96,32,128
"GHAZNI","DEH YAK",1105066,2,0,300,300
"GHAZNI","DEH YAK",1105066,3,71,72,143
"GHAZNI","DEH YAK",1105067,3,70,13,83
"GHAZNI","DEH YAK",1105070,1,66,47,113
"GHAZNI","DEH YAK",1105063,3,4,13,17
"GHAZNI","DEH YAK",1105064,1,2,35,37
"GHAZNI","DEH YAK",1105064,2,4,34,38
"GHAZNI","DEH YAK",1105064,3,0,12,12
"GHAZNI","DEH YAK",1105062,1,21,69,90
"GHAZNI","DEH YAK",1105062,2,29,94,123
"GHAZNI","DEH YAK",1105062,4,6,73,79
"GHAZNI","DEH YAK",1105059,1,56,12,68
"GHAZNI","DEH YAK",1105059,2,36,3,39
"GHAZNI","DEH YAK",1105067,1,266,37,303
"GHAZNI","DEH YAK",1105067,2,345,13,358
"GHAZNI","DEH YAK",1105063,1,17,92,109
"GHAZNI","DEH YAK",1105063,2,10,237,247
"GHAZNI","DEH YAK",1105068,1,172,38,210
"GHAZNI","DEH YAK",1105068,2,123,31,154
"GHAZNI","DEH YAK",1105060,1,66,459,525
"GHAZNI","DEH YAK",1105060,2,1,597,598
"GHAZNI","DEH YAK",1105060,3,18,182,200
"GHAZNI","DEH YAK",1105066,1,0,600,600
"GHAZNI","DEH YAK",1105059,3,5,1,6
"GHAZNI","DEH YAK",1105059,4,15,7,22
"GHAZNI","JAGHATU",1106116,1,169,69,238
"GHAZNI","JAGHATU",1106116,2,133,96,229
"GHAZNI","JAGHATU",1106121,3,51,17,68
"GHAZNI","JAGHATU",1106121,4,44,16,60
"GHAZNI","JAGHATU",1106123,1,473,99,572
"GHAZNI","JAGHATU",1106105,1,171,8,179
"GHAZNI","JAGHATU",1106113,1,293,5,298
"GHAZNI","JAGHATU",1106113,2,169,7,176
"GHAZNI","JAGHATU",1106113,3,210,17,227
"GHAZNI","JAGHATU",1106121,1,40,6,46
"GHAZNI","JAGHATU",1106121,2,34,9,43
"GHAZNI","JAGHATU",1106120,2,71,20,91
"GHAZNI","JAGHATU",1106120,3,60,46,106
"GHAZNI","JAGHATU",1106123,2,200,115,315
"GHAZNI","JAGHATU",1106123,3,138,5,143
"GHAZNI","JAGHATU",1106115,3,70,43,113
"GHAZNI","JAGHATU",1106115,4,106,69,175
"GHAZNI","JAGHATU",1106117,1,196,265,461
"GHAZNI","JAGHATU",1106116,3,157,80,237
"GHAZNI","JAGHATU",1106107,1,58,13,71
"GHAZNI","JAGHATU",1106107,2,77,4,81
"GHAZNI","JAGHATU",1106107,3,94,2,96
"GHAZNI","JAGHATU",1106107,4,67,4,71
"GHAZNI","JAGHATU",1106109,1,337,263,600
"GHAZNI","JAGHATU",1106109,2,194,406,600
"GHAZNI","JAGHATU",1106109,3,130,470,600
"GHAZNI","JAGHATU",1106115,1,55,122,177
"GHAZNI","JAGHATU",1106115,2,49,167,216
"GHAZNI","JAGHATU",1106110,3,239,101,340
"GHAZNI","JAGHATU",1106111,1,180,416,596
"GHAZNI","JAGHATU",1106111,2,479,106,585
"GHAZNI","JAGHATU",1106111,3,422,177,599
"GHAZNI","JAGHATU",1106111,4,350,237,587
"GHAZNI","JAGHATU",1106105,2,59,18,77
"GHAZNI","JAGHATU",1106105,3,88,5,93
"GHAZNI","JAGHATU",1106118,1,193,306,499
"GHAZNI","JAGHATU",1106106,1,57,20,77
"GHAZNI","JAGHATU",1106106,2,63,20,83
"GHAZNI","JAGHATU",1106106,3,35,9,44
"GHAZNI","JAGHATU",1106110,1,128,152,280
"GHAZNI","JAGHATU",1106110,2,243,190,433
"GHAZNI","JAGHATU",1106108,3,276,324,600
"GHAZNI","JAGHATU",1106111,5,204,217,421
"GHAZNI","JAGHATU",1106112,1,90,12,102
"GHAZNI","JAGHATU",1106112,2,60,6,66
"GHAZNI","JAGHATU",1106117,2,172,126,298
"GHAZNI","JAGHATU",1106120,1,75,15,90
"GHAZNI","JAGHATU",1106117,3,208,262,470
"GHAZNI","JAGHATU",1106117,4,241,229,470
"GHAZNI","JAGHATU",1106112,3,64,7,71
"GHAZNI","JAGHATU",1106108,2,158,442,600
"GHAZNI","JAGHATU",1106108,1,263,337,600
"GHAZNI","ANDAR",1107230,3,6,500,506
"GHAZNI","ANDAR",1107232,1,5,509,514
"GHAZNI","ANDAR",1107232,2,0,600,600
"GHAZNI","ANDAR",1107223,1,8,72,80
"GHAZNI","ANDAR",1107223,2,25,41,66
"GHAZNI","ANDAR",1107223,3,52,212,264
"GHAZNI","ANDAR",1107226,1,1,187,188
"GHAZNI","ANDAR",1107226,2,10,589,599
"GHAZNI","ANDAR",1107230,2,24,573,597
"GHAZNI","ANDAR",1107231,1,0,600,600
"GHAZNI","ANDAR",1107231,2,1,446,447
"GHAZNI","ANDAR",1107231,3,0,600,600
"GHAZNI","ANDAR",1107225,1,20,575,595
"GHAZNI","ANDAR",1107225,2,3,206,209
"GHAZNI","ANDAR",1107229,1,22,489,511
"GHAZNI","ANDAR",1107229,2,11,503,514
"GHAZNI","ANDAR",1107229,3,16,445,461
"GHAZNI","ANDAR",1107229,4,3,205,208
"GHAZNI","ANDAR",1107235,1,0,22,22
"GHAZNI","ANDAR",1107235,2,2,28,30
"GHAZNI","ANDAR",1107235,3,4,78,82
"GHAZNI","ANDAR",1107236,1,1,18,19
"GHAZNI","ANDAR",1107236,2,1,30,31
"GHAZNI","ANDAR",1107236,3,0,33,33
"GHAZNI","ANDAR",1107237,1,0,113,113
"GHAZNI","ANDAR",1107237,2,0,73,73
"GHAZNI","ANDAR",1107224,4,8,592,600
"GHAZNI","ANDAR",1107248,1,74,421,495
"GHAZNI","ANDAR",1107248,2,66,394,460
"GHAZNI","ANDAR",1107248,3,37,555,592
"GHAZNI","ANDAR",1107246,1,42,525,567
"GHAZNI","ANDAR",1107246,2,37,531,568
"GHAZNI","ANDAR",1107246,3,63,524,587
"GHAZNI","ANDAR",1107249,1,15,580,595
"GHAZNI","ANDAR",1107249,2,13,580,593
"GHAZNI","ANDAR",1107249,3,8,570,578
"GHAZNI","ANDAR",1107249,4,13,488,501
"GHAZNI","ANDAR",1107244,1,44,261,305
"GHAZNI","ANDAR",1107244,2,23,412,435
"GHAZNI","ANDAR",1107219,1,14,583,597
"GHAZNI","ANDAR",1107219,2,32,507,539
"GHAZNI","ANDAR",1107219,3,204,324,528
"GHAZNI","ANDAR",1107219,4,97,459,556
"GHAZNI","ANDAR",1107253,1,41,457,498
"GHAZNI","ANDAR",1107253,2,402,76,478
"GHAZNI","ANDAR",1107253,3,50,550,600
"GHAZNI","ANDAR",1107253,4,0,600,600
"GHAZNI","ANDAR",1107238,1,3,552,555
"GHAZNI","ANDAR",1107238,2,15,578,593
"GHAZNI","ANDAR",1107230,1,11,585,596
"GHAZNI","ANDAR",1107250,3,11,164,175
"GHAZNI","ANDAR",1107245,1,20,493,513
"GHAZNI","ANDAR",1107245,2,10,572,582
"GHAZNI","ANDAR",1107245,3,78,484,562
"GHAZNI","ANDAR",1107234,1,2,190,192
"GHAZNI","ANDAR",1107234,2,6,97,103
"GHAZNI","ANDAR",1107234,3,2,140,142
"GHAZNI","ANDAR",1107240,1,26,567,593
"GHAZNI","ANDAR",1107240,2,24,481,505
"GHAZNI","ANDAR",1107242,1,0,600,600
"GHAZNI","ANDAR",1107242,2,53,526,579
"GHAZNI","ANDAR",1107242,3,0,600,600
"GHAZNI","ANDAR",1107241,1,126,474,600
"GHAZNI","ANDAR",1107241,2,45,550,595
"GHAZNI","ANDAR",1107241,3,165,435,600
"GHAZNI","ANDAR",1107224,1,6,593,599
"GHAZNI","ANDAR",1107224,2,5,594,599
"GHAZNI","ANDAR",1107224,3,12,588,600
"GHAZNI","ANDAR",1107252,2,1,594,595
"GHAZNI","ANDAR",1107252,3,0,600,600
"GHAZNI","ANDAR",1107243,1,23,223,246
"GHAZNI","ANDAR",1107243,2,14,275,289
"GHAZNI","ANDAR",1107247,1,39,544,583
"GHAZNI","ANDAR",1107247,2,8,575,583
"GHAZNI","ANDAR",1107247,3,8,576,584
"GHAZNI","ANDAR",1107250,1,7,549,556
"GHAZNI","ANDAR",1107250,2,2,593,595
"GHAZNI","ANDAR",1107239,1,27,571,598
"GHAZNI","ANDAR",1107239,2,15,150,165
"GHAZNI","ANDAR",1107252,1,3,596,599
"GHAZNI","ZANAKHAN",1108071,1,2,8,10
"GHAZNI","ZANAKHAN",1108071,2,0,2,2
"GHAZNI","ZANAKHAN",1108071,3,0,1,1
"GHAZNI","ZANAKHAN",1108072,1,3,4,7
"GHAZNI","ZANAKHAN",1108072,2,2,5,7
"GHAZNI","ZANAKHAN",1108071,4,2,8,10
"GHAZNI","RASHIDAN",1109094,2,73,0,73
"GHAZNI","RASHIDAN",1109093,2,36,7,43
"GHAZNI","RASHIDAN",1109093,3,38,8,46
"GHAZNI","RASHIDAN",1109093,1,4,1,5
"GHAZNI","RASHIDAN",1109087,3,12,6,18
"GHAZNI","RASHIDAN",1109094,3,48,6,54
"GHAZNI","RASHIDAN",1109087,1,1,3,4
"GHAZNI","RASHIDAN",1109094,1,18,6,24
"GHAZNI","RASHIDAN",1109087,2,5,6,11
"KABUL","GULDARA",111384,4,106,8,114
"KABUL","GULDARA",111545,3,17,48,65
"KABUL","GULDARA",111384,5,81,11,92
"KABUL","GULDARA",111383,2,174,19,193
"KABUL","GULDARA",111545,2,38,92,130
"KABUL","GULDARA",111383,1,378,47,425
"KABUL","GULDARA",111381,1,13,118,131
"KABUL","GULDARA",111384,3,111,18,129
"KABUL","GULDARA",111545,1,21,119,140
"KABUL","GULDARA",111385,4,87,8,95
"KABUL","GULDARA",111381,5,19,4,23
"KABUL","GULDARA",111384,2,172,23,195
"KABUL","GULDARA",111384,1,134,25,159
"KABUL","GULDARA",111381,3,22,126,148
"KABUL","GULDARA",111383,5,220,10,230
"KABUL","GULDARA",111383,3,155,14,169
"KABUL","GULDARA",111383,4,129,6,135
"KABUL","GULDARA",111385,3,44,31,75
"KABUL","GULDARA",111382,3,29,15,44
"KABUL","GULDARA",111382,2,26,16,42
"KABUL","GULDARA",111382,4,78,5,83
"KABUL","GULDARA",111385,2,54,16,70
"KABUL","GULDARA",111381,2,33,121,154
"KABUL","GULDARA",111381,4,22,2,24
"KABUL","GULDARA",111382,1,71,26,97
"KABUL","GULDARA",111385,1,71,26,97
"GHAZNI","NAWUR",1110261,4,212,14,226
"GHAZNI","NAWUR",1110254,1,465,134,599
"GHAZNI","NAWUR",1110284,2,421,173,594
"GHAZNI","NAWUR",1110283,1,325,263,588
"GHAZNI","NAWUR",1110283,2,246,317,563
"GHAZNI","NAWUR",1110278,1,426,170,596
"GHAZNI","NAWUR",1110278,2,531,66,597
"GHAZNI","NAWUR",1110278,3,581,17,598
"GHAZNI","NAWUR",1110278,4,503,94,597
"GHAZNI","NAWUR",1110279,1,427,122,549
"GHAZNI","NAWUR",1110279,2,550,45,595
"GHAZNI","NAWUR",1110254,2,475,123,598
"GHAZNI","NAWUR",1110254,3,427,173,600
"GHAZNI","NAWUR",1110254,4,489,110,599
"GHAZNI","NAWUR",1110284,1,364,225,589
"GHAZNI","NAWUR",1110266,3,409,189,598
"GHAZNI","NAWUR",1110267,1,314,280,594
"GHAZNI","NAWUR",1110267,2,416,180,596
"GHAZNI","NAWUR",1110267,3,332,264,596
"GHAZNI","NAWUR",1110263,2,464,134,598
"GHAZNI","NAWUR",1110261,1,238,39,277
"GHAZNI","NAWUR",1110261,2,101,20,121
"GHAZNI","NAWUR",1110261,3,227,2,229
"GHAZNI","NAWUR",1110270,1,511,87,598
"GHAZNI","NAWUR",1110270,2,550,49,599
"GHAZNI","NAWUR",1110271,1,448,143,591
"GHAZNI","NAWUR",1110271,2,487,104,591
"GHAZNI","NAWUR",1110271,3,480,116,596
"GHAZNI","NAWUR",1110254,5,426,174,600
"GHAZNI","NAWUR",1110260,1,44,22,66
"GHAZNI","NAWUR",1110260,2,75,32,107
"GHAZNI","NAWUR",1110260,3,39,30,69
"GHAZNI","NAWUR",1110262,1,103,13,116
"GHAZNI","NAWUR",1110262,2,161,16,177
"GHAZNI","NAWUR",1110262,3,493,18,511
"GHAZNI","NAWUR",1110275,1,403,94,497
"GHAZNI","NAWUR",1110275,2,540,57,597
"GHAZNI","NAWUR",1110274,1,533,67,600
"GHAZNI","NAWUR",1110274,2,513,83,596
"GHAZNI","NAWUR",1110274,3,526,74,600
"GHAZNI","NAWUR",1110265,1,403,183,586
"GHAZNI","NAWUR",1110265,2,513,77,590
"GHAZNI","NAWUR",1110265,3,386,99,485
"GHAZNI","NAWUR",1110264,1,559,40,599
"GHAZNI","NAWUR",1110264,2,437,157,594
"GHAZNI","NAWUR",1110264,3,392,199,591
"GHAZNI","NAWUR",1110264,4,403,184,587
"GHAZNI","NAWUR",1110269,1,263,28,291
"GHAZNI","NAWUR",1110269,2,159,2,161
"GHAZNI","NAWUR",1110256,1,350,227,577
"GHAZNI","NAWUR",1110256,2,68,430,498
"GHAZNI","NAWUR",1110281,1,419,180,599
"GHAZNI","NAWUR",1110281,2,500,98,598
"GHAZNI","NAWUR",1110266,1,334,266,600
"GHAZNI","NAWUR",1110266,2,396,201,597
"GHAZNI","NAWUR",1110255,1,57,543,600
"GHAZNI","NAWUR",1110255,2,570,25,595
"GHAZNI","NAWUR",1110255,3,498,69,567
"GHAZNI","NAWUR",1110263,1,399,194,593
"GHAZNI","NAWUR",1110280,2,391,205,596
"GHAZNI","NAWUR",1110280,3,441,150,591
"GHAZNI","NAWUR",1110276,1,409,166,575
"GHAZNI","NAWUR",1110276,2,436,151,587
"GHAZNI","NAWUR",1110286,1,536,56,592
"GHAZNI","NAWUR",1110286,3,521,67,588
"GHAZNI","NAWUR",1110282,1,515,83,598
"GHAZNI","NAWUR",1110282,2,170,429,599
"GHAZNI","NAWUR",1110285,1,499,86,585
"GHAZNI","NAWUR",1110268,1,470,127,597
"GHAZNI","NAWUR",1110268,2,417,178,595
"GHAZNI","NAWUR",1110273,1,345,254,599
"GHAZNI","NAWUR",1110273,2,292,306,598
"GHAZNI","NAWUR",1110273,3,418,179,597
"GHAZNI","NAWUR",1110273,4,394,206,600
"GHAZNI","NAWUR",1110272,1,460,128,588
"GHAZNI","NAWUR",1110272,3,313,275,588
"GHAZNI","NAWUR",1110257,2,108,478,586
"GHAZNI","NAWUR",1110285,2,525,70,595
"GHAZNI","NAWUR",1110256,3,348,247,595
"GHAZNI","NAWUR",1110257,1,103,497,600
"GHAZNI","NAWUR",1110277,2,242,145,387
"GHAZNI","NAWUR",1110280,1,445,150,595
"GHAZNI","NAWUR",1110285,3,500,87,587
"GHAZNI","NAWUR",1110277,1,206,93,299
"GHAZNI","NAWUR",1110258,1,347,252,599
"GHAZNI","NAWUR",1110258,2,475,112,587
"GHAZNI","QARA BAGH",1111185,4,182,401,583
"GHAZNI","QARA BAGH",1111189,5,24,30,54
"GHAZNI","QARA BAGH",1111183,1,421,177,598
"GHAZNI","QARA BAGH",1111183,2,452,145,597
"GHAZNI","QARA BAGH",1111183,3,288,304,592
"GHAZNI","QARA BAGH",1111185,1,476,98,574
"GHAZNI","QARA BAGH",1111185,2,507,93,600
"GHAZNI","QARA BAGH",1111185,3,280,306,586
"GHAZNI","QARA BAGH",1111166,1,225,271,496
"GHAZNI","QARA BAGH",1111166,2,79,473,552
"GHAZNI","QARA BAGH",1111176,1,51,1,52
"GHAZNI","QARA BAGH",1111176,2,21,1,22
"GHAZNI","QARA BAGH",1111176,3,20,1,21
"GHAZNI","QARA BAGH",1111144,1,10,226,236
"GHAZNI","QARA BAGH",1111189,4,88,13,101
"GHAZNI","QARA BAGH",1111162,1,156,433,589
"GHAZNI","QARA BAGH",1111162,2,23,79,102
"GHAZNI","QARA BAGH",1111160,1,23,573,596
"GHAZNI","QARA BAGH",1111160,2,12,584,596
"GHAZNI","QARA BAGH",1111180,2,251,349,600
"GHAZNI","QARA BAGH",1111180,3,311,289,600
"GHAZNI","QARA BAGH",1111180,4,225,375,600
"GHAZNI","QARA BAGH",1111180,5,295,305,600
"GHAZNI","QARA BAGH",1111195,1,3,595,598
"GHAZNI","QARA BAGH",1111195,2,17,582,599
"GHAZNI","QARA BAGH",1111193,1,411,189,600
"GHAZNI","QARA BAGH",1111193,2,448,151,599
"GHAZNI","QARA BAGH",1111193,3,300,300,600
"GHAZNI","QARA BAGH",1111154,1,19,568,587
"GHAZNI","QARA BAGH",1111154,3,8,504,512
"GHAZNI","QARA BAGH",1111132,1,117,454,571
"GHAZNI","QARA BAGH",1111132,2,100,500,600
"GHAZNI","QARA BAGH",1111132,3,100,500,600
"GHAZNI","QARA BAGH",1111132,4,100,500,600
"GHAZNI","QARA BAGH",1111132,5,100,500,600
"GHAZNI","QARA BAGH",1111134,1,64,526,590
"GHAZNI","QARA BAGH",1111134,2,170,430,600
"GHAZNI","QARA BAGH",1111173,2,226,172,398
"GHAZNI","QARA BAGH",1111177,1,21,2,23
"GHAZNI","QARA BAGH",1111177,2,20,3,23
"GHAZNI","QARA BAGH",1111177,3,22,1,23
"GHAZNI","QARA BAGH",1111181,1,35,300,335
"GHAZNI","QARA BAGH",1111144,2,1,19,20
"GHAZNI","QARA BAGH",1111174,1,247,159,406
"GHAZNI","QARA BAGH",1111174,2,110,288,398
"GHAZNI","QARA BAGH",1111174,3,134,137,271
"GHAZNI","QARA BAGH",1111146,1,39,109,148
"GHAZNI","QARA BAGH",1111146,2,6,12,18
"GHAZNI","QARA BAGH",1111178,1,206,394,600
"GHAZNI","QARA BAGH",1111178,2,434,163,597
"GHAZNI","QARA BAGH",1111178,3,96,503,599
"GHAZNI","QARA BAGH",1111168,1,125,75,200
"GHAZNI","QARA BAGH",1111168,2,124,68,192
"GHAZNI","QARA BAGH",1111172,1,206,315,521
"GHAZNI","QARA BAGH",1111172,2,226,371,597
"GHAZNI","QARA BAGH",1111135,1,7,278,285
"GHAZNI","QARA BAGH",1111135,2,0,593,593
"GHAZNI","QARA BAGH",1111135,3,106,471,577
"GHAZNI","QARA BAGH",1111135,4,50,550,600
"GHAZNI","QARA BAGH",1111133,1,14,552,566
"GHAZNI","QARA BAGH",1111133,2,21,579,600
"GHAZNI","QARA BAGH",1111152,1,11,411,422
"GHAZNI","QARA BAGH",1111152,2,5,227,232
"GHAZNI","QARA BAGH",1111155,1,29,270,299
"GHAZNI","QARA BAGH",1111155,2,41,548,589
"GHAZNI","QARA BAGH",1111175,1,253,47,300
"GHAZNI","QARA BAGH",1111175,2,162,132,294
"GHAZNI","QARA BAGH",1111169,1,116,9,125
"GHAZNI","QARA BAGH",1111169,2,95,19,114
"GHAZNI","QARA BAGH",1111179,1,186,381,567
"GHAZNI","QARA BAGH",1111179,2,374,211,585
"GHAZNI","QARA BAGH",1111179,3,244,356,600
"GHAZNI","QARA BAGH",1111153,1,19,364,383
"GHAZNI","QARA BAGH",1111153,2,13,125,138
"GHAZNI","QARA BAGH",1111191,1,125,133,258
"GHAZNI","QARA BAGH",1111191,2,164,107,271
"GHAZNI","QARA BAGH",1111173,1,163,232,395
"GHAZNI","QARA BAGH",1111161,1,0,591,591
"GHAZNI","QARA BAGH",1111161,2,45,554,599
"GHAZNI","QARA BAGH",1111189,1,48,2,50
"GHAZNI","QARA BAGH",1111189,2,57,12,69
"GHAZNI","QARA BAGH",1111189,3,45,17,62
"GHAZNI","QARA BAGH",1111181,2,98,156,254
"GHAZNI","QARA BAGH",1111181,3,123,106,229
"GHAZNI","QARA BAGH",1111187,1,280,232,512
"GHAZNI","QARA BAGH",1111187,2,321,279,600
"GHAZNI","QARA BAGH",1111187,3,275,231,506
"GHAZNI","QARA BAGH",1111187,4,258,310,568
"GHAZNI","QARA BAGH",1111167,1,418,177,595
"GHAZNI","QARA BAGH",1111167,2,122,447,569
"GHAZNI","QARA BAGH",1111194,1,20,573,593
"GHAZNI","QARA BAGH",1111190,1,112,154,266
"GHAZNI","QARA BAGH",1111190,2,139,106,245
"GHAZNI","QARA BAGH",1111190,3,186,100,286
"GHAZNI","QARA BAGH",1111194,2,93,501,594
"GHAZNI","GIRO",1112196,1,19,20,39
"GHAZNI","AB BAND",1113381,2,82,448,530
"GHAZNI","AB BAND",1113379,1,21,471,492
"GHAZNI","AB BAND",1113381,1,119,367,486
"GHAZNI","AB BAND",1113383,1,108,360,468
"GHAZNI","AB BAND",1113380,1,145,452,597
"GHAZNI","AB BAND",1113376,1,90,496,586
"GHAZNI","AB BAND",1113376,2,37,358,395
"GHAZNI","AB BAND",1113378,1,32,235,267
"GHAZNI","AB BAND",1113380,2,93,499,592
"GHAZNI","AB BAND",1113382,1,1,68,69
"GHAZNI","JAGHURI",1114342,4,144,21,165
"GHAZNI","JAGHURI",1114330,3,379,50,429
"GHAZNI","JAGHURI",1114340,1,515,84,599
"GHAZNI","JAGHURI",1114340,2,401,105,506
"GHAZNI","JAGHURI",1114340,3,472,124,596
"GHAZNI","JAGHURI",1114324,5,429,154,583
"GHAZNI","JAGHURI",1114324,6,498,92,590
"GHAZNI","JAGHURI",1114342,1,362,8,370
"GHAZNI","JAGHURI",1114342,2,56,7,63
"GHAZNI","JAGHURI",1114342,3,151,16,167
"GHAZNI","JAGHURI",1114341,11,515,80,595
"GHAZNI","JAGHURI",1114339,1,234,84,318
"GHAZNI","JAGHURI",1114339,2,205,60,265
"GHAZNI","JAGHURI",1114339,3,297,106,403
"GHAZNI","JAGHURI",1114355,1,165,37,202
"GHAZNI","JAGHURI",1114355,2,203,38,241
"GHAZNI","JAGHURI",1114353,1,555,45,600
"GHAZNI","JAGHURI",1114353,2,524,75,599
"GHAZNI","JAGHURI",1114352,1,378,215,593
"GHAZNI","JAGHURI",1114352,3,492,104,596
"GHAZNI","JAGHURI",1114350,1,448,150,598
"GHAZNI","JAGHURI",1114350,2,467,132,599
"GHAZNI","JAGHURI",1114349,1,333,80,413
"GHAZNI","JAGHURI",1114349,2,409,88,497
"GHAZNI","JAGHURI",1114348,1,405,171,576
"GHAZNI","JAGHURI",1114348,2,376,152,528
"GHAZNI","JAGHURI",1114347,1,484,116,600
"GHAZNI","JAGHURI",1114347,2,479,93,572
"GHAZNI","JAGHURI",1114347,3,441,98,539
"GHAZNI","JAGHURI",1114323,4,456,122,578
"GHAZNI","JAGHURI",1114323,5,454,131,585
"GHAZNI","JAGHURI",1114323,6,47,10,57
"GHAZNI","JAGHURI",1114323,7,68,20,88
"GHAZNI","JAGHURI",1114321,1,401,102,503
"GHAZNI","JAGHURI",1114321,2,414,43,457
"GHAZNI","JAGHURI",1114321,3,375,62,437
"GHAZNI","JAGHURI",1114321,4,550,38,588
"GHAZNI","JAGHURI",1114322,1,90,26,116
"GHAZNI","JAGHURI",1114322,2,268,89,357
"GHAZNI","JAGHURI",1114322,3,122,31,153
"GHAZNI","JAGHURI",1114322,4,179,32,211
"GHAZNI","JAGHURI",1114322,5,357,36,393
"GHAZNI","JAGHURI",1114322,6,295,44,339
"GHAZNI","JAGHURI",1114322,7,353,73,426
"GHAZNI","JAGHURI",1114337,1,402,125,527
"GHAZNI","JAGHURI",1114337,2,334,129,463
"GHAZNI","JAGHURI",1114337,3,393,143,536
"GHAZNI","JAGHURI",1114337,4,408,123,531
"GHAZNI","JAGHURI",1114335,1,496,99,595
"GHAZNI","JAGHURI",1114335,2,404,69,473
"GHAZNI","JAGHURI",1114334,1,405,190,595
"GHAZNI","JAGHURI",1114334,2,345,254,599
"GHAZNI","JAGHURI",1114334,3,329,270,599
"GHAZNI","JAGHURI",1114334,4,451,146,597
"GHAZNI","JAGHURI",1114334,5,404,190,594
"GHAZNI","JAGHURI",1114334,6,432,161,593
"GHAZNI","JAGHURI",1114334,7,476,122,598
"GHAZNI","JAGHURI",1114329,1,421,172,593
"GHAZNI","JAGHURI",1114329,2,392,206,598
"GHAZNI","JAGHURI",1114329,3,503,92,595
"GHAZNI","JAGHURI",1114329,4,418,172,590
"GHAZNI","JAGHURI",1114329,5,439,156,595
"GHAZNI","JAGHURI",1114329,6,470,121,591
"GHAZNI","JAGHURI",1114332,1,257,52,309
"GHAZNI","JAGHURI",1114332,2,299,113,412
"GHAZNI","JAGHURI",1114332,3,250,70,320
"GHAZNI","JAGHURI",1114332,4,448,71,519
"GHAZNI","JAGHURI",1114332,5,466,57,523
"GHAZNI","JAGHURI",1114331,1,453,142,595
"GHAZNI","JAGHURI",1114331,2,464,132,596
"GHAZNI","JAGHURI",1114325,1,142,19,161
"GHAZNI","JAGHURI",1114325,2,209,22,231
"GHAZNI","JAGHURI",1114325,3,370,187,557
"GHAZNI","JAGHURI",1114326,1,300,108,408
"GHAZNI","JAGHURI",1114326,2,208,92,300
"GHAZNI","JAGHURI",1114326,3,497,66,563
"GHAZNI","JAGHURI",1114327,1,399,196,595
"GHAZNI","JAGHURI",1114327,2,392,206,598
"GHAZNI","JAGHURI",1114327,3,467,129,596
"GHAZNI","JAGHURI",1114327,4,500,93,593
"GHAZNI","JAGHURI",1114327,5,493,96,589
"GHAZNI","JAGHURI",1114341,1,535,61,596
"GHAZNI","JAGHURI",1114341,2,444,59,503
"GHAZNI","JAGHURI",1114341,3,510,80,590
"GHAZNI","JAGHURI",1114341,4,524,70,594
"GHAZNI","JAGHURI",1114341,5,513,84,597
"GHAZNI","JAGHURI",1114341,6,314,56,370
"GHAZNI","JAGHURI",1114341,7,296,38,334
"GHAZNI","JAGHURI",1114341,8,337,57,394
"GHAZNI","JAGHURI",1114341,9,380,52,432
"GHAZNI","JAGHURI",1114341,10,521,47,568
"GHAZNI","JAGHURI",1114351,1,387,207,594
"GHAZNI","JAGHURI",1114351,2,387,213,600
"GHAZNI","JAGHURI",1114351,3,509,83,592
"GHAZNI","JAGHURI",1114354,1,391,199,590
"GHAZNI","JAGHURI",1114339,4,301,95,396
"GHAZNI","JAGHURI",1114328,1,197,82,279
"GHAZNI","JAGHURI",1114328,2,200,82,282
"GHAZNI","JAGHURI",1114328,3,424,173,597
"GHAZNI","JAGHURI",1114338,1,397,202,599
"GHAZNI","JAGHURI",1114338,2,526,72,598
"GHAZNI","JAGHURI",1114338,3,447,153,600
"GHAZNI","JAGHURI",1114338,4,410,184,594
"GHAZNI","JAGHURI",1114343,1,293,59,352
"GHAZNI","JAGHURI",1114343,2,329,71,400
"GHAZNI","JAGHURI",1114343,3,498,33,531
"GHAZNI","JAGHURI",1114343,4,536,25,561
"GHAZNI","JAGHURI",1114330,1,184,44,228
"GHAZNI","JAGHURI",1114330,2,73,11,84
"GHAZNI","JAGHURI",1114324,1,429,170,599
"GHAZNI","JAGHURI",1114324,2,422,176,598
"GHAZNI","JAGHURI",1114324,3,340,106,446
"GHAZNI","JAGHURI",1114324,4,251,112,363
"GHAZNI","JAGHURI",1114342,11,206,19,225
"GHAZNI","JAGHURI",1114342,12,194,51,245
"GHAZNI","JAGHURI",1114333,1,297,64,361
"GHAZNI","JAGHURI",1114333,2,197,52,249
"GHAZNI","JAGHURI",1114333,3,532,62,594
"GHAZNI","JAGHURI",1114336,2,418,165,583
"GHAZNI","JAGHURI",1114336,3,439,152,591
"GHAZNI","JAGHURI",1114342,5,50,14,64
"GHAZNI","JAGHURI",1114342,6,164,35,199
"GHAZNI","JAGHURI",1114342,7,303,34,337
"GHAZNI","JAGHURI",1114342,8,348,25,373
"GHAZNI","JAGHURI",1114342,9,323,31,354
"GHAZNI","JAGHURI",1114342,10,217,40,257
"GHAZNI","JAGHURI",1114344,2,502,84,586
"GHAZNI","JAGHURI",1114352,2,454,141,595
"GHAZNI","JAGHURI",1114408,1,316,54,370
"GHAZNI","JAGHURI",1114408,2,468,24,492
"GHAZNI","JAGHURI",1114336,1,461,94,555
"GHAZNI","JAGHURI",1114354,2,423,174,597
"GHAZNI","JAGHURI",1114346,1,310,212,522
"GHAZNI","JAGHURI",1114336,4,350,58,408
"GHAZNI","JAGHURI",1114336,5,402,160,562
"GHAZNI","JAGHURI",1114345,2,468,78,546
"GHAZNI","JAGHURI",1114323,1,486,105,591
"GHAZNI","JAGHURI",1114346,2,338,259,597
"GHAZNI","JAGHURI",1114344,1,326,74,400
"GHAZNI","JAGHURI",1114323,2,357,142,499
"GHAZNI","JAGHURI",1114345,1,519,76,595
"GHAZNI","JAGHURI",1114323,3,152,36,188
"GHAZNI","MUQUR",1115357,1,27,386,413
"GHAZNI","MUQUR",1115357,2,26,251,277
"GHAZNI","MUQUR",1115357,5,10,9,19
"GHAZNI","MUQUR",1115369,3,7,157,164
"GHAZNI","MUQUR",1115362,3,1,1,2
"GHAZNI","MUQUR",1115366,1,25,249,274
"GHAZNI","MUQUR",1115366,2,8,177,185
"GHAZNI","MUQUR",1115362,1,18,455,473
"GHAZNI","MUQUR",1115359,3,0,2,2
"GHAZNI","MUQUR",1115358,1,139,43,182
"GHAZNI","MUQUR",1115358,2,87,25,112
"GHAZNI","MUQUR",1115358,4,160,13,173
"GHAZNI","MUQUR",1115369,2,2,219,221
"GHAZNI","MUQUR",1115356,1,12,90,102
"GHAZNI","MUQUR",1115356,2,23,41,64
"GHAZNI","MUQUR",1115356,3,28,53,81
"GHAZNI","MUQUR",1115361,1,11,169,180
"GHAZNI","MUQUR",1115361,3,1,5,6
"GHAZNI","MUQUR",1115371,1,43,549,592
"GHAZNI","MUQUR",1115371,2,0,26,26
"GHAZNI","MUQUR",1115359,1,11,280,291
"GHAZNI","MUQUR",1115370,1,35,403,438
"GHAZNI","MUQUR",1115368,1,35,225,260
"GHAZNI","MUQUR",1115366,3,7,62,69
"GHAZNI","MUQUR",1115366,4,25,24,49
"GHAZNI","MALISTAN",1116311,2,396,195,591
"GHAZNI","MALISTAN",1116312,1,345,251,596
"GHAZNI","MALISTAN",1116312,2,371,229,600
"GHAZNI","MALISTAN",1116312,3,489,105,594
"GHAZNI","MALISTAN",1116304,1,466,125,591
"GHAZNI","MALISTAN",1116304,2,465,135,600
"GHAZNI","MALISTAN",1116306,1,400,199,599
"GHAZNI","MALISTAN",1116306,2,391,207,598
"GHAZNI","MALISTAN",1116306,3,495,96,591
"GHAZNI","MALISTAN",1116308,1,467,131,598
"GHAZNI","MALISTAN",1116309,1,435,163,598
"GHAZNI","MALISTAN",1116309,2,434,164,598
"GHAZNI","MALISTAN",1116309,3,555,43,598
"GHAZNI","MALISTAN",1116311,1,441,151,592
"GHAZNI","MALISTAN",1116407,1,410,183,593
"GHAZNI","MALISTAN",1116407,2,462,137,599
"GHAZNI","MALISTAN",1116296,1,56,7,63
"GHAZNI","MALISTAN",1116296,2,55,13,68
"GHAZNI","MALISTAN",1116296,3,86,11,97
"GHAZNI","MALISTAN",1116296,4,481,58,539
"GHAZNI","MALISTAN",1116299,1,105,58,163
"GHAZNI","MALISTAN",1116299,2,183,132,315
"GHAZNI","MALISTAN",1116299,3,71,44,115
"GHAZNI","MALISTAN",1116299,4,335,113,448
"GHAZNI","MALISTAN",1116317,1,508,84,592
"GHAZNI","MALISTAN",1116317,2,497,101,598
"GHAZNI","MALISTAN",1116317,3,571,25,596
"GHAZNI","MALISTAN",1116295,1,467,128,595
"GHAZNI","MALISTAN",1116295,2,452,146,598
"GHAZNI","MALISTAN",1116295,3,364,231,595
"GHAZNI","MALISTAN",1116295,4,477,116,593
"GHAZNI","MALISTAN",1116315,1,418,180,598
"GHAZNI","MALISTAN",1116315,2,503,94,597
"GHAZNI","MALISTAN",1116319,1,358,237,595
"GHAZNI","MALISTAN",1116319,2,323,275,598
"GHAZNI","MALISTAN",1116319,3,413,185,598
"GHAZNI","MALISTAN",1116316,1,530,68,598
"GHAZNI","MALISTAN",1116308,2,434,166,600
"GHAZNI","MALISTAN",1116307,1,457,138,595
"GHAZNI","MALISTAN",1116307,2,392,205,597
"GHAZNI","MALISTAN",1116307,3,531,62,593
"GHAZNI","MALISTAN",1116318,1,430,169,599
"GHAZNI","MALISTAN",1116318,2,381,217,598
"GHAZNI","MALISTAN",1116318,3,494,101,595
"GHAZNI","MALISTAN",1116320,1,493,103,596
"GHAZNI","MALISTAN",1116320,2,511,87,598
"GHAZNI","MALISTAN",1116310,1,484,102,586
"GHAZNI","MALISTAN",1116310,2,415,179,594
"GHAZNI","MALISTAN",1116310,3,454,145,599
"GHAZNI","MALISTAN",1116310,4,537,54,591
"GHAZNI","MALISTAN",1116310,5,512,80,592
"GHAZNI","MALISTAN",1116297,3,464,46,510
"GHAZNI","MALISTAN",1116313,1,381,212,593
"GHAZNI","MALISTAN",1116313,2,412,174,586
"GHAZNI","MALISTAN",1116313,3,372,223,595
"GHAZNI","MALISTAN",1116313,4,388,205,593
"GHAZNI","MALISTAN",1116313,5,434,159,593
"GHAZNI","MALISTAN",1116314,1,459,135,594
"GHAZNI","MALISTAN",1116314,2,537,57,594
"GHAZNI","MALISTAN",1116305,1,417,181,598
"GHAZNI","MALISTAN",1116305,2,531,66,597
"GHAZNI","MALISTAN",1116305,3,542,52,594
"GHAZNI","MALISTAN",1116305,4,406,188,594
"GHAZNI","MALISTAN",1116305,5,418,176,594
"GHAZNI","MALISTAN",1116302,1,523,70,593
"GHAZNI","MALISTAN",1116302,2,479,115,594
"GHAZNI","MALISTAN",1116302,3,539,54,593
"GHAZNI","MALISTAN",1116300,1,363,220,583
"GHAZNI","MALISTAN",1116300,2,526,64,590
"GHAZNI","MALISTAN",1116298,1,426,167,593
"GHAZNI","MALISTAN",1116298,2,430,169,599
"GHAZNI","MALISTAN",1116298,3,269,330,599
"GHAZNI","MALISTAN",1116298,4,303,292,595
"GHAZNI","MALISTAN",1116301,1,411,184,595
"GHAZNI","MALISTAN",1116301,2,529,70,599
"GHAZNI","MALISTAN",1116301,3,554,40,594
"GHAZNI","MALISTAN",1116297,1,365,187,552
"GHAZNI","MALISTAN",1116316,2,445,151,596
"GHAZNI","MALISTAN",1116316,3,569,25,594
"GHAZNI","MALISTAN",1116303,1,158,28,186
"GHAZNI","MALISTAN",1116303,2,281,53,334
"GHAZNI","MALISTAN",1116303,3,526,67,593
"GHAZNI","MALISTAN",1116297,2,455,135,590
"GHAZNI","GELAN",1117387,2,28,391,419
"GHAZNI","GELAN",1117394,1,0,549,549
"GHAZNI","GELAN",1117394,2,1,461,462
"GHAZNI","GELAN",1117394,3,1,405,406
"GHAZNI","GELAN",1117386,1,37,550,587
"GHAZNI","GELAN",1117386,2,25,260,285
"GHAZNI","GELAN",1117384,1,11,220,231
"GHAZNI","GELAN",1117387,1,35,554,589
"GHAZNI","GELAN",1117387,3,12,321,333
"GHAZNI","GELAN",1117385,1,7,222,229
"GHAZNI","GELAN",1117395,1,7,130,137
"GHAZNI","AJRISTAN",1118291,1,296,150,446
"GHAZNI","AJRISTAN",1118291,8,3,28,31
"GHAZNI","AJRISTAN",1118291,7,200,124,324
"GHAZNI","AJRISTAN",1118291,6,135,165,300
"GHAZNI","AJRISTAN",1118291,2,250,350,600
"GHAZNI","AJRISTAN",1118291,3,150,150,300
"GHAZNI","AJRISTAN",1118291,4,183,217,400
"GHAZNI","AJRISTAN",1118291,5,190,40,230
"KABUL","FARZA",112345,4,138,33,171
"KABUL","FARZA",112345,3,152,31,183
"KABUL","FARZA",112345,5,99,16,115
"KABUL","FARZA",112351,3,27,72,99
"KABUL","FARZA",112351,1,77,233,310
"KABUL","FARZA",112347,1,75,201,276
"KABUL","FARZA",112349,3,21,110,131
"KABUL","FARZA",112350,1,366,96,462
"KABUL","FARZA",112347,2,106,116,222
"KABUL","FARZA",112345,1,157,89,246
"KABUL","FARZA",112546,1,41,106,147
"KABUL","FARZA",112349,4,10,108,118
"KABUL","FARZA",112346,4,121,119,240
"KABUL","FARZA",112546,3,35,64,99
"KABUL","FARZA",112346,2,34,64,98
"KABUL","FARZA",112345,2,112,55,167
"KABUL","FARZA",112346,3,54,133,187
"KABUL","FARZA",112350,2,143,26,169
"KABUL","FARZA",112348,1,46,182,228
"KABUL","FARZA",112347,3,56,107,163
"KABUL","FARZA",112347,4,76,93,169
"KABUL","FARZA",112351,2,32,208,240
"KABUL","FARZA",112348,2,26,144,170
"KABUL","FARZA",112346,1,39,84,123
"KABUL","FARZA",112349,2,34,218,252
"KABUL","FARZA",112546,2,37,111,148
"KABUL","FARZA",112349,1,37,190,227
"KABUL","ESTALEF",113378,2,119,6,125
"KABUL","ESTALEF",113380,1,353,35,388
"KABUL","ESTALEF",113377,1,175,50,225
"KABUL","ESTALEF",113376,3,111,28,139
"KABUL","ESTALEF",113378,1,377,20,397
"KABUL","ESTALEF",113376,4,83,28,111
"KABUL","ESTALEF",113375,3,330,8,338
"KABUL","ESTALEF",113377,2,127,61,188
"KABUL","ESTALEF",113376,1,445,108,553
"KABUL","ESTALEF",113375,2,175,15,190
"KABUL","ESTALEF",113374,3,59,8,67
"KABUL","ESTALEF",113379,1,415,36,451
"KABUL","ESTALEF",113380,6,27,4,31
"KABUL","ESTALEF",113376,2,323,100,423
"KABUL","ESTALEF",113374,2,172,18,190
"KABUL","ESTALEF",113374,1,231,15,246
"KABUL","ESTALEF",113380,4,156,14,170
"KABUL","ESTALEF",113380,2,211,33,244
"KABUL","ESTALEF",113375,1,214,13,227
"KABUL","ESTALEF",113377,3,39,19,58
"KABUL","ESTALEF",113379,2,184,4,188
"KABUL","ESTALEF",113380,7,17,4,21
"KABUL","ESTALEF",113380,5,48,6,54
"KABUL","ESTALEF",113380,3,166,20,186
"KABUL","ESTALEF",113377,4,36,24,60
"KABUL","QARA BAGH",114362,2,26,6,32
"KABUL","QARA BAGH",114362,1,242,217,459
"KABUL","QARA BAGH",114368,2,110,152,262
"KABUL","QARA BAGH",114360,3,36,118,154
"KABUL","QARA BAGH",114548,2,112,218,330
"KABUL","QARA BAGH",114368,1,184,229,413
"KABUL","QARA BAGH",114360,5,56,197,253
"KABUL","QARA BAGH",114360,6,37,178,215
"KABUL","QARA BAGH",114359,3,30,70,100
"KABUL","QARA BAGH",114360,4,16,99,115
"KABUL","QARA BAGH",114359,4,18,37,55
"KABUL","QARA BAGH",114548,1,122,227,349
"KABUL","QARA BAGH",114547,3,49,32,81
"KABUL","QARA BAGH",114363,3,75,10,85
"KABUL","QARA BAGH",114373,5,35,26,61
"KABUL","QARA BAGH",114367,4,60,25,85
"KABUL","QARA BAGH",114369,2,207,16,223
"KABUL","QARA BAGH",114360,1,56,266,322
"KABUL","QARA BAGH",114547,2,227,54,281
"KABUL","QARA BAGH",114372,1,188,31,219
"KABUL","QARA BAGH",114369,1,330,14,344
"KABUL","QARA BAGH",114372,3,20,11,31
"KABUL","QARA BAGH",114360,7,20,185,205
"KABUL","QARA BAGH",114373,1,93,263,356
"KABUL","QARA BAGH",114364,4,1,64,65
"KABUL","QARA BAGH",114364,5,0,49,49
"KABUL","QARA BAGH",114549,2,94,162,256
"KABUL","QARA BAGH",114549,3,72,132,204
"KABUL","QARA BAGH",114361,2,118,10,128
"KABUL","QARA BAGH",114367,5,37,10,47
"KABUL","QARA BAGH",114359,2,12,52,64
"KABUL","QARA BAGH",114365,4,48,41,89
"KABUL","QARA BAGH",114363,2,299,46,345
"KABUL","QARA BAGH",114372,2,145,35,180
"KABUL","QARA BAGH",114373,2,71,178,249
"KABUL","QARA BAGH",114372,4,39,2,41
"KABUL","QARA BAGH",114369,3,204,27,231
"KABUL","QARA BAGH",114369,4,333,8,341
"KABUL","QARA BAGH",114360,2,60,237,297
"KABUL","QARA BAGH",114371,3,33,52,85
"KABUL","QARA BAGH",114371,4,2,0,2
"KABUL","QARA BAGH",114373,4,34,26,60
"KABUL","QARA BAGH",114363,1,400,99,499
"KABUL","QARA BAGH",114547,1,94,137,231
"KABUL","QARA BAGH",114367,3,209,209,418
"KABUL","QARA BAGH",114367,1,217,200,417
"KABUL","QARA BAGH",114364,1,29,307,336
"KABUL","QARA BAGH",114548,3,79,72,151
"KABUL","QARA BAGH",114549,1,99,138,237
"KABUL","QARA BAGH",114365,1,176,260,436
"KABUL","QARA BAGH",114365,2,119,200,319
"KABUL","QARA BAGH",114359,1,38,122,160
"KABUL","QARA BAGH",114365,3,42,22,64
"KABUL","QARA BAGH",114371,6,2,1,3
"KABUL","QARA BAGH",114366,3,10,37,47
"KABUL","QARA BAGH",114366,4,13,45,58
"KABUL","QARA BAGH",114364,3,21,245,266
"KABUL","QARA BAGH",114368,3,104,155,259
"KABUL","QARA BAGH",114369,5,326,7,333
"KABUL","QARA BAGH",114371,1,61,58,119
"KABUL","QARA BAGH",114361,1,284,41,325
"KABUL","QARA BAGH",114367,2,229,191,420
"KABUL","QARA BAGH",114371,2,27,29,56
"KABUL","QARA BAGH",114370,1,284,22,306
"KABUL","QARA BAGH",114370,3,83,6,89
"KABUL","QARA BAGH",114364,2,8,215,223
"KABUL","QARA BAGH",114373,6,10,45,55
"KABUL","QARA BAGH",114371,5,2,0,2
"KABUL","QARA BAGH",114373,3,141,294,435
"KABUL","QARA BAGH",114366,2,46,107,153
"KABUL","QARA BAGH",114370,2,227,12,239
"KABUL","QARA BAGH",114366,1,56,202,258
"KABUL","SURUBI",115516,1,46,545,591
"KABUL","SURUBI",115477,5,6,594,600
"KABUL","SURUBI",115518,1,53,547,600
"KABUL","SURUBI",115479,3,12,588,600
"KABUL","SURUBI",115518,2,40,558,598
"KABUL","SURUBI",115477,6,37,562,599
"KABUL","SURUBI",115477,4,36,162,198
"KABUL","SURUBI",115482,2,4,591,595
"KABUL","SURUBI",115483,3,32,564,596
"KABUL","SURUBI",115481,2,29,567,596
"KABUL","SURUBI",115516,2,10,588,598
"KABUL","SURUBI",115482,3,236,283,519
"KABUL","SURUBI",115483,5,0,598,598
"KABUL","SURUBI",115481,1,49,550,599
"KABUL","SURUBI",115481,3,30,564,594
"KABUL","SURUBI",115481,4,88,509,597
"KABUL","SURUBI",115486,2,500,100,600
"KABUL","SURUBI",115551,1,97,203,300
"KABUL","SURUBI",115550,1,234,359,593
"KABUL","SURUBI",115486,1,100,485,585
"KABUL","SURUBI",115479,2,26,572,598
"KABUL","SURUBI",115479,1,19,569,588
"KABUL","SURUBI",115551,2,98,482,580
"KABUL","SURUBI",115551,3,100,489,589
"KABUL","SURUBI",115515,1,83,506,589
"KABUL","SURUBI",115478,1,154,444,598
"KABUL","SURUBI",115482,1,50,550,600
"KABUL","SURUBI",115487,5,206,199,405
"KABUL","SURUBI",115476,2,10,590,600
"KABUL","SURUBI",115483,6,24,574,598
"KABUL","SURUBI",115486,3,100,495,595
"KABUL","SURUBI",115476,1,18,582,600
"KABUL","SURUBI",115477,3,41,556,597
"KABUL","SURUBI",115485,3,17,578,595
"KABUL","SURUBI",115483,4,9,591,600
"KABUL","SURUBI",115483,2,142,450,592
"KABUL","SURUBI",115515,2,2,18,20
"KABUL","SURUBI",115480,1,115,475,590
"KABUL","SURUBI",115480,2,100,500,600
"KABUL","SURUBI",115478,2,202,388,590
"KABUL","SURUBI",115486,4,0,600,600
"KABUL","SURUBI",115487,3,133,456,589
"KABUL","SURUBI",115477,2,15,585,600
"KABUL","SURUBI",115552,3,14,585,599
"KABUL","SURUBI",115552,1,11,587,598
"KABUL","SURUBI",115485,2,31,559,590
"KABUL","SURUBI",115484,4,167,420,587
"KABUL","SURUBI",115484,5,136,464,600
"KABUL","SURUBI",115487,4,147,442,589
"KABUL","SURUBI",115478,3,78,518,596
"KABUL","SURUBI",115487,2,255,343,598
"KABUL","SURUBI",115552,2,19,570,589
"KABUL","SURUBI",115480,3,117,482,599
"KABUL","SURUBI",115550,2,119,448,567
"KABUL","SURUBI",115487,1,100,498,598
"KABUL","SURUBI",115517,2,123,472,595
"KABUL","SURUBI",115476,4,73,524,597
"KABUL","SURUBI",115484,6,133,454,587
"KABUL","SURUBI",115483,1,54,544,598
"KABUL","SURUBI",115517,1,49,546,595
"KABUL","SURUBI",115484,1,89,319,408
"KABUL","SURUBI",115477,1,34,557,591
"KABUL","SURUBI",115484,2,116,282,398
"KABUL","SURUBI",115476,3,22,578,600
"KABUL","SURUBI",115485,1,21,572,593
"KABUL","SURUBI",115484,3,52,297,349
"PAKTIKA","SHARAN",1201009,1,11,581,592
"PAKTIKA","SHARAN",1201009,2,12,578,590
"PAKTIKA","SHARAN",1201009,3,22,568,590
"PAKTIKA","SHARAN",1201009,4,19,573,592
"PAKTIKA","SHARAN",1201282,1,132,125,257
"PAKTIKA","SHARAN",1201282,2,60,260,320
"PAKTIKA","SHARAN",1201015,3,1,42,43
"PAKTIKA","SHARAN",1201017,1,5,548,553
"PAKTIKA","SHARAN",1201017,2,8,528,536
"PAKTIKA","SHARAN",1201017,3,68,526,594
"PAKTIKA","SHARAN",1201013,4,0,500,500
"PAKTIKA","SHARAN",1201281,2,92,172,264
"PAKTIKA","SHARAN",1201281,3,76,250,326
"PAKTIKA","SHARAN",1201015,1,30,309,339
"PAKTIKA","SHARAN",1201015,2,7,277,284
"PAKTIKA","SHARAN",1201003,1,0,538,538
"PAKTIKA","SHARAN",1201015,4,2,18,20
"PAKTIKA","SHARAN",1201005,1,1,54,55
"PAKTIKA","SHARAN",1201005,2,2,75,77
"PAKTIKA","SHARAN",1201005,3,2,107,109
"PAKTIKA","SHARAN",1201005,4,8,100,108
"PAKTIKA","SHARAN",1201019,1,21,559,580
"PAKTIKA","SHARAN",1201019,2,10,574,584
"PAKTIKA","SHARAN",1201019,3,22,500,522
"PAKTIKA","SHARAN",1201019,4,74,442,516
"PAKTIKA","SHARAN",1201021,1,8,421,429
"PAKTIKA","SHARAN",1201021,3,5,317,322
"PAKTIKA","SHARAN",1201021,4,41,282,323
"PAKTIKA","SHARAN",1201022,1,5,92,97
"PAKTIKA","SHARAN",1201022,2,3,195,198
"PAKTIKA","SHARAN",1201022,3,10,190,200
"PAKTIKA","SHARAN",1201013,2,10,555,565
"PAKTIKA","SHARAN",1201013,3,0,500,500
"PAKTIKA","SHARAN",1201012,4,0,537,537
"PAKTIKA","SHARAN",1201018,1,5,545,550
"PAKTIKA","SHARAN",1201018,2,5,553,558
"PAKTIKA","SHARAN",1201018,3,6,513,519
"PAKTIKA","SHARAN",1201024,1,12,55,67
"PAKTIKA","SHARAN",1201009,5,0,600,600
"PAKTIKA","SHARAN",1201020,1,6,577,583
"PAKTIKA","SHARAN",1201020,2,12,585,597
"PAKTIKA","SHARAN",1201020,3,55,541,596
"PAKTIKA","SHARAN",1201020,4,11,583,594
"PAKTIKA","SHARAN",1201016,1,0,34,34
"PAKTIKA","SHARAN",1201004,1,3,351,354
"PAKTIKA","SHARAN",1201004,2,25,275,300
"PAKTIKA","SHARAN",1201004,3,2,154,156
"PAKTIKA","SHARAN",1201004,4,1,170,171
"PAKTIKA","SHARAN",1201002,1,1,26,27
"PAKTIKA","SHARAN",1201002,2,5,37,42
"PAKTIKA","SHARAN",1201002,3,1,12,13
"PAKTIKA","SHARAN",1201002,4,5,15,20
"PAKTIKA","SHARAN",1201007,1,26,300,326
"PAKTIKA","SHARAN",1201007,2,19,382,401
"PAKTIKA","SHARAN",1201007,3,5,572,577
"PAKTIKA","SHARAN",1201007,4,7,572,579
"PAKTIKA","SHARAN",1201003,2,3,576,579
"PAKTIKA","SHARAN",1201003,3,0,534,534
"PAKTIKA","SHARAN",1201003,4,6,563,569
"PAKTIKA","SHARAN",1201001,1,12,104,116
"PAKTIKA","SHARAN",1201001,2,50,224,274
"PAKTIKA","SHARAN",1201001,3,30,282,312
"PAKTIKA","SHARAN",1201001,4,8,107,115
"PAKTIKA","SHARAN",1201001,5,17,166,183
"PAKTIKA","SHARAN",1201001,6,0,46,46
"PAKTIKA","SHARAN",1201001,7,3,31,34
"PAKTIKA","SHARAN",1201011,1,5,543,548
"PAKTIKA","SHARAN",1201011,2,9,527,536
"PAKTIKA","SHARAN",1201011,3,6,29,35
"PAKTIKA","SHARAN",1201011,4,11,520,531
"PAKTIKA","SHARAN",1201013,1,15,545,560
"PAKTIKA","SHARAN",1201012,2,2,39,41
"PAKTIKA","SHARAN",1201012,3,2,30,32
"PAKTIKA","SHARAN",1201023,1,9,44,53
"PAKTIKA","SHARAN",1201023,2,2,9,11
"PAKTIKA","SHARAN",1201026,1,2,81,83
"PAKTIKA","SHARAN",1201026,2,26,94,120
"PAKTIKA","SHARAN",1201026,3,3,97,100
"PAKTIKA","SHARAN",1201026,4,13,262,275
"PAKTIKA","SHARAN",1201281,1,50,100,150
"PAKTIKA","SHARAN",1201014,1,80,271,351
"PAKTIKA","SHARAN",1201014,2,43,139,182
"PAKTIKA","SHARAN",1201014,3,0,570,570
"PAKTIKA","SHARAN",1201010,1,7,291,298
"PAKTIKA","SHARAN",1201010,2,6,293,299
"PAKTIKA","SHARAN",1201010,3,9,379,388
"PAKTIKA","SHARAN",1201010,4,29,505,534
"PAKTIKA","SHARAN",1201008,1,3,22,25
"PAKTIKA","SHARAN",1201008,2,3,522,525
"PAKTIKA","SHARAN",1201008,3,3,525,528
"PAKTIKA","SHARAN",1201006,1,12,588,600
"PAKTIKA","SHARAN",1201006,2,12,570,582
"PAKTIKA","SHARAN",1201006,3,10,580,590
"PAKTIKA","SHARAN",1201024,2,8,53,61
"PAKTIKA","SHARAN",1201014,4,50,550,600
"PAKTIKA","SHARAN",1201012,1,0,541,541
"PAKTIKA","MATA KHAN",1202028,3,3,249,252
"PAKTIKA","MATA KHAN",1202028,4,9,581,590
"PAKTIKA","MATA KHAN",1202032,1,8,202,210
"PAKTIKA","MATA KHAN",1202030,1,1,302,303
"PAKTIKA","MATA KHAN",1202030,2,6,172,178
"PAKTIKA","MATA KHAN",1202036,1,5,78,83
"PAKTIKA","MATA KHAN",1202036,3,13,91,104
"PAKTIKA","MATA KHAN",1202028,1,8,576,584
"PAKTIKA","MATA KHAN",1202028,2,5,507,512
"PAKTIKA","MATA KHAN",1202036,2,134,7,141
"PAKTIKA","MATA KHAN",1202035,2,91,429,520
"PAKTIKA","MATA KHAN",1202035,3,0,447,447
"PAKTIKA","MATA KHAN",1202027,1,23,168,191
"PAKTIKA","MATA KHAN",1202027,2,3,554,557
"PAKTIKA","MATA KHAN",1202032,2,3,203,206
"PAKTIKA","MATA KHAN",1202032,3,2,217,219
"PAKTIKA","MATA KHAN",1202032,4,41,297,338
"PAKTIKA","MATA KHAN",1202032,5,18,206,224
"PAKTIKA","MATA KHAN",1202283,1,13,259,272
"PAKTIKA","MATA KHAN",1202283,2,1,212,213
"PAKTIKA","MATA KHAN",1202029,1,3,99,102
"PAKTIKA","MATA KHAN",1202029,2,0,1,1
"PAKTIKA","MATA KHAN",1202035,1,65,344,409
"PAKTIKA","MATA KHAN",1202038,1,0,599,599
"PAKTIKA","MATA KHAN",1202038,2,0,599,599
"PAKTIKA","MATA KHAN",1202038,3,0,497,497
"PAKTIKA","MATA KHAN",1202034,1,47,497,544
"PAKTIKA","MATA KHAN",1202034,2,9,285,294
"PAKTIKA","MATA KHAN",1202034,3,0,298,298
"PAKTIKA","MATA KHAN",1202027,3,3,557,560
"PAKTIKA","YOSUF KHEL",1203040,3,1,578,579
"PAKTIKA","YOSUF KHEL",1203046,1,3,399,402
"PAKTIKA","YOSUF KHEL",1203040,2,17,383,400
"PAKTIKA","YOSUF KHEL",1203046,4,130,467,597
"PAKTIKA","YOSUF KHEL",1203046,5,100,498,598
"PAKTIKA","YOSUF KHEL",1203046,2,14,345,359
"PAKTIKA","YOSUF KHEL",1203046,3,10,443,453
"PAKTIKA","YOSUF KHEL",1203042,3,0,595,595
"PAKTIKA","YOSUF KHEL",1203042,4,1,299,300
"PAKTIKA","YOSUF KHEL",1203042,1,1,599,600
"PAKTIKA","YOSUF KHEL",1203042,2,0,600,600
"PAKTIKA","YOSUF KHEL",1203039,2,13,239,252
"PAKTIKA","YOSUF KHEL",1203039,3,12,322,334
"PAKTIKA","YOSUF KHEL",1203039,4,16,583,599
"PAKTIKA","YOSUF KHEL",1203041,1,4,263,267
"PAKTIKA","YOSUF KHEL",1203041,2,14,338,352
"PAKTIKA","YOSUF KHEL",1203041,3,66,445,511
"PAKTIKA","YOSUF KHEL",1203041,4,329,229,558
"PAKTIKA","YOSUF KHEL",1203043,1,14,98,112
"PAKTIKA","YOSUF KHEL",1203043,2,23,196,219
"PAKTIKA","YOSUF KHEL",1203043,3,8,71,79
"PAKTIKA","YOSUF KHEL",1203043,4,4,520,524
"PAKTIKA","YOSUF KHEL",1203044,1,67,435,502
"PAKTIKA","YOSUF KHEL",1203039,1,7,172,179
"PAKTIKA","YOSUF KHEL",1203040,1,10,335,345
"PAKTIKA","YAHYA KHEL",1204064,2,2,598,600
"PAKTIKA","YAHYA KHEL",1204064,1,0,590,590
"PAKTIKA","YAHYA KHEL",1204052,1,3,597,600
"PAKTIKA","YAHYA KHEL",1204052,2,0,599,599
"PAKTIKA","YAHYA KHEL",1204048,1,0,600,600
"PAKTIKA","YAHYA KHEL",1204048,2,250,350,600
"PAKTIKA","YAHYA KHEL",1204058,1,110,479,589
"PAKTIKA","YAHYA KHEL",1204058,2,112,488,600
"PAKTIKA","YAHYA KHEL",1204058,3,173,423,596
"PAKTIKA","YAHYA KHEL",1204058,4,196,400,596
"PAKTIKA","YAHYA KHEL",1204056,1,140,459,599
"PAKTIKA","YAHYA KHEL",1204056,2,198,400,598
"PAKTIKA","YAHYA KHEL",1204064,3,0,593,593
"PAKTIKA","YAHYA KHEL",1204064,4,0,593,593
"PAKTIKA","YAHYA KHEL",1204064,5,0,598,598
"PAKTIKA","YAHYA KHEL",1204060,3,12,588,600
"PAKTIKA","YAHYA KHEL",1204062,1,3,597,600
"PAKTIKA","YAHYA KHEL",1204062,2,29,564,593
"PAKTIKA","YAHYA KHEL",1204062,3,0,596,596
"PAKTIKA","YAHYA KHEL",1204047,1,0,595,595
"PAKTIKA","YAHYA KHEL",1204047,2,12,588,600
"PAKTIKA","YAHYA KHEL",1204047,3,7,593,600
"PAKTIKA","YAHYA KHEL",1204051,1,23,300,323
"PAKTIKA","YAHYA KHEL",1204051,2,2,598,600
"PAKTIKA","YAHYA KHEL",1204051,3,1,599,600
"PAKTIKA","YAHYA KHEL",1204051,4,0,600,600
"PAKTIKA","YAHYA KHEL",1204060,1,47,122,169
"PAKTIKA","YAHYA KHEL",1204060,2,48,549,597
"PAKTIKA","YAHYA KHEL",1204055,2,149,447,596
"PAKTIKA","YAHYA KHEL",1204055,1,128,454,582
"PAKTIKA","SAR RAWZA",1205073,3,0,600,600
"PAKTIKA","SAR RAWZA",1205073,4,0,600,600
"PAKTIKA","SAR RAWZA",1205073,5,0,598,598
"PAKTIKA","SAR RAWZA",1205074,1,0,594,594
"PAKTIKA","SAR RAWZA",1205074,2,0,581,581
"PAKTIKA","SAR RAWZA",1205074,3,0,565,565
"PAKTIKA","SAR RAWZA",1205074,4,0,600,600
"PAKTIKA","SAR RAWZA",1205074,5,0,574,574
"PAKTIKA","SAR RAWZA",1205286,1,1,599,600
"PAKTIKA","SAR RAWZA",1205286,2,1,599,600
"PAKTIKA","SAR RAWZA",1205080,1,4,537,541
"PAKTIKA","SAR RAWZA",1205080,2,0,530,530
"PAKTIKA","SAR RAWZA",1205084,1,0,600,600
"PAKTIKA","SAR RAWZA",1205084,2,0,72,72
"PAKTIKA","SAR RAWZA",1205078,1,14,143,157
"PAKTIKA","SAR RAWZA",1205078,2,2,125,127
"PAKTIKA","SAR RAWZA",1205078,3,7,102,109
"PAKTIKA","SAR RAWZA",1205082,1,0,29,29
"PAKTIKA","SAR RAWZA",1205076,1,2,587,589
"PAKTIKA","SAR RAWZA",1205076,2,7,589,596
"PAKTIKA","SAR RAWZA",1205076,3,4,592,596
"PAKTIKA","SAR RAWZA",1205081,2,3,513,516
"PAKTIKA","SAR RAWZA",1205285,1,0,600,600
"PAKTIKA","SAR RAWZA",1205285,2,0,600,600
"PAKTIKA","SAR RAWZA",1205285,3,1,599,600
"PAKTIKA","SAR RAWZA",1205073,1,0,600,600
"PAKTIKA","SAR RAWZA",1205073,2,0,600,600
"PAKTIKA","SAR RAWZA",1205079,1,0,593,593
"PAKTIKA","SAR RAWZA",1205079,2,6,590,596
"PAKTIKA","SAR RAWZA",1205079,3,4,586,590
"PAKTIKA","SAR RAWZA",1205075,1,10,550,560
"PAKTIKA","SAR RAWZA",1205075,2,1,590,591
"PAKTIKA","SAR RAWZA",1205075,3,11,506,517
"PAKTIKA","SAR RAWZA",1205083,1,0,600,600
"PAKTIKA","SAR RAWZA",1205083,2,0,240,240
"PAKTIKA","SAR RAWZA",1205077,4,0,42,42
"PAKTIKA","SAR RAWZA",1205077,1,3,190,193
"PAKTIKA","SAR RAWZA",1205077,2,4,36,40
"PAKTIKA","SAR RAWZA",1205077,3,0,592,592
"PAKTIKA","OMNA",1206066,1,4,594,598
"PAKTIKA","OMNA",1206066,2,26,570,596
"PAKTIKA","OMNA",1206066,3,1,598,599
"PAKTIKA","OMNA",1206066,4,6,594,600
"PAKTIKA","OMNA",1206070,1,0,600,600
"PAKTIKA","OMNA",1206070,2,0,600,600
"PAKTIKA","OMNA",1206070,3,0,600,600
"PAKTIKA","OMNA",1206071,1,0,600,600
"PAKTIKA","OMNA",1206072,1,230,356,586
"PAKTIKA","OMNA",1206072,2,150,440,590
"PAKTIKA","OMNA",1206068,1,0,600,600
"PAKTIKA","OMNA",1206068,2,0,600,600
"PAKTIKA","OMNA",1206068,3,6,594,600
"PAKTIKA","OMNA",1206071,2,0,600,600
"PAKTIKA","OMNA",1206284,1,10,526,536
"PAKTIKA","OMNA",1206284,2,0,599,599
"PAKTIKA","OMNA",1206284,3,5,582,587
"PAKTIKA","ZARGHUN SHAH",1207088,3,552,45,597
"PAKTIKA","ZARGHUN SHAH",1207098,1,4,109,113
"PAKTIKA","ZARGHUN SHAH",1207093,3,0,595,595
"PAKTIKA","ZARGHUN SHAH",1207088,1,516,82,598
"PAKTIKA","ZARGHUN SHAH",1207088,2,550,50,600
"PAKTIKA","ZARGHUN SHAH",1207093,2,68,529,597
"PAKTIKA","ZARGHUN SHAH",1207105,3,150,450,600
"PAKTIKA","ZARGHUN SHAH",1207104,1,0,595,595
"PAKTIKA","ZARGHUN SHAH",1207104,2,0,598,598
"PAKTIKA","ZARGHUN SHAH",1207105,2,5,593,598
"PAKTIKA","ZARGHUN SHAH",1207098,2,8,173,181
"PAKTIKA","ZARGHUN SHAH",1207098,3,0,600,600
"PAKTIKA","ZARGHUN SHAH",1207098,4,0,600,600
"PAKTIKA","ZARGHUN SHAH",1207096,1,44,528,572
"PAKTIKA","ZARGHUN SHAH",1207096,2,0,595,595
"PAKTIKA","ZARGHUN SHAH",1207096,3,0,600,600
"PAKTIKA","ZARGHUN SHAH",1207092,1,0,591,591
"PAKTIKA","ZARGHUN SHAH",1207092,2,0,595,595
"PAKTIKA","ZARGHUN SHAH",1207092,3,0,600,600
"PAKTIKA","ZARGHUN SHAH",1207092,4,0,597,597
"PAKTIKA","ZARGHUN SHAH",1207106,1,5,595,600
"PAKTIKA","ZARGHUN SHAH",1207106,2,0,599,599
"PAKTIKA","ZARGHUN SHAH",1207100,1,30,79,109
"PAKTIKA","ZARGHUN SHAH",1207100,2,65,97,162
"PAKTIKA","ZARGHUN SHAH",1207100,3,0,600,600
"PAKTIKA","ZARGHUN SHAH",1207100,4,0,600,600
"PAKTIKA","ZARGHUN SHAH",1207102,1,0,597,597
"PAKTIKA","ZARGHUN SHAH",1207102,2,0,595,595
"PAKTIKA","ZARGHUN SHAH",1207086,1,330,258,588
"PAKTIKA","ZARGHUN SHAH",1207086,2,188,412,600
"PAKTIKA","ZARGHUN SHAH",1207289,1,165,422,587
"PAKTIKA","ZARGHUN SHAH",1207289,2,0,596,596
"PAKTIKA","ZARGHUN SHAH",1207289,3,0,589,589
"PAKTIKA","ZARGHUN SHAH",1207289,4,0,600,600
"PAKTIKA","ZARGHUN SHAH",1207094,1,24,572,596
"PAKTIKA","ZARGHUN SHAH",1207094,2,228,343,571
"PAKTIKA","ZARGHUN SHAH",1207094,3,10,588,598
"PAKTIKA","ZARGHUN SHAH",1207090,1,0,600,600
"PAKTIKA","ZARGHUN SHAH",1207090,2,1,598,599
"PAKTIKA","ZARGHUN SHAH",1207090,3,0,600,600
"PAKTIKA","ZARGHUN SHAH",1207093,1,16,577,593
"PAKTIKA","ZARGHUN SHAH",1207085,4,89,496,585
"PAKTIKA","ZARGHUN SHAH",1207087,1,216,374,590
"PAKTIKA","ZARGHUN SHAH",1207087,2,238,360,598
"PAKTIKA","ZARGHUN SHAH",1207105,1,87,511,598
"PAKTIKA","ZARGHUN SHAH",1207107,1,0,582,582
"PAKTIKA","ZARGHUN SHAH",1207107,2,25,544,569
"PAKTIKA","ZARGHUN SHAH",1207287,1,227,371,598
"PAKTIKA","ZARGHUN SHAH",1207287,2,0,592,592
"PAKTIKA","ZARGHUN SHAH",1207089,1,0,589,589
"PAKTIKA","ZARGHUN SHAH",1207103,1,0,597,597
"PAKTIKA","ZARGHUN SHAH",1207103,2,0,597,597
"PAKTIKA","ZARGHUN SHAH",1207103,3,0,594,594
"PAKTIKA","ZARGHUN SHAH",1207095,1,0,592,592
"PAKTIKA","ZARGHUN SHAH",1207095,2,1,594,595
"PAKTIKA","ZARGHUN SHAH",1207101,1,0,595,595
"PAKTIKA","ZARGHUN SHAH",1207101,2,0,597,597
"PAKTIKA","ZARGHUN SHAH",1207101,3,0,593,593
"PAKTIKA","ZARGHUN SHAH",1207288,1,0,595,595
"PAKTIKA","ZARGHUN SHAH",1207288,2,194,406,600
"PAKTIKA","ZARGHUN SHAH",1207089,3,109,489,598
"PAKTIKA","ZARGHUN SHAH",1207085,1,3,593,596
"PAKTIKA","ZARGHUN SHAH",1207085,2,4,594,598
"PAKTIKA","ZARGHUN SHAH",1207089,2,0,600,600
"PAKTIKA","ZARGHUN SHAH",1207102,3,0,599,599
"PAKTIKA","ZARGHUN SHAH",1207108,1,0,593,593
"PAKTIKA","ZARGHUN SHAH",1207108,2,0,592,592
"PAKTIKA","ZARGHUN SHAH",1207085,3,0,600,600
"PAKTIKA","GOMAL",1208293,2,6,594,600
"PAKTIKA","GOMAL",1208293,3,1,599,600
"PAKTIKA","GOMAL",1208292,3,309,291,600
"PAKTIKA","GOMAL",1208125,1,7,593,600
"PAKTIKA","GOMAL",1208125,2,20,574,594
"PAKTIKA","GOMAL",1208125,3,5,584,589
"PAKTIKA","GOMAL",1208125,4,9,580,589
"PAKTIKA","GOMAL",1208125,5,10,589,599
"PAKTIKA","GOMAL",1208128,1,38,562,600
"PAKTIKA","GOMAL",1208128,2,60,516,576
"PAKTIKA","GOMAL",1208293,1,1,595,596
"PAKTIKA","GOMAL",1208146,1,2,408,410
"PAKTIKA","GOMAL",1208146,2,5,591,596
"PAKTIKA","GOMAL",1208292,1,59,541,600
"PAKTIKA","GOMAL",1208292,2,98,502,600
"PAKTIKA","GOMAL",1208136,1,0,598,598
"PAKTIKA","GOMAL",1208136,2,0,599,599
"PAKTIKA","GOMAL",1208142,1,5,583,588
"PAKTIKA","GOMAL",1208142,2,8,581,589
"PAKTIKA","GOMAL",1208141,1,7,592,599
"PAKTIKA","GOMAL",1208141,2,4,585,589
"PAKTIKA","GOMAL",1208126,1,0,600,600
"PAKTIKA","GOMAL",1208126,2,4,594,598
"PAKTIKA","GOMAL",1208128,3,75,522,597
"PAKTIKA","GOMAL",1208126,4,10,588,598
"PAKTIKA","GOMAL",1208129,1,1,595,596
"PAKTIKA","GOMAL",1208129,2,6,593,599
"PAKTIKA","GOMAL",1208129,3,5,595,600
"PAKTIKA","GOMAL",1208127,1,60,540,600
"PAKTIKA","GOMAL",1208127,2,6,594,600
"PAKTIKA","GOMAL",1208127,3,15,582,597
"PAKTIKA","GOMAL",1208291,1,3,594,597
"PAKTIKA","GOMAL",1208291,2,9,587,596
"PAKTIKA","GOMAL",1208291,3,278,303,581
"PAKTIKA","GOMAL",1208131,1,0,60,60
"PAKTIKA","GOMAL",1208131,2,4,100,104
"PAKTIKA","GOMAL",1208133,1,77,520,597
"PAKTIKA","GOMAL",1208133,2,6,592,598
"PAKTIKA","GOMAL",1208133,3,46,529,575
"PAKTIKA","GOMAL",1208133,4,407,188,595
"PAKTIKA","GOMAL",1208146,3,0,258,258
"PAKTIKA","GOMAL",1208146,4,0,300,300
"PAKTIKA","GOMAL",1208146,5,5,520,525
"PAKTIKA","GOMAL",1208146,6,2,595,597
"PAKTIKA","GOMAL",1208144,1,1,564,565
"PAKTIKA","GOMAL",1208144,2,1,597,598
"PAKTIKA","GOMAL",1208144,3,0,600,600
"PAKTIKA","GOMAL",1208134,1,331,213,544
"PAKTIKA","GOMAL",1208134,2,194,400,594
"PAKTIKA","GOMAL",1208134,3,0,181,181
"PAKTIKA","GOMAL",1208134,4,150,440,590
"PAKTIKA","GOMAL",1208132,1,19,122,141
"PAKTIKA","GOMAL",1208132,2,3,102,105
"PAKTIKA","GOMAL",1208137,1,2,594,596
"PAKTIKA","GOMAL",1208137,2,3,592,595
"PAKTIKA","GOMAL",1208139,1,1,589,590
"PAKTIKA","GOMAL",1208139,2,2,596,598
"PAKTIKA","GOMAL",1208135,1,300,300,600
"PAKTIKA","GOMAL",1208135,2,183,417,600
"PAKTIKA","GOMAL",1208138,1,1,593,594
"PAKTIKA","GOMAL",1208138,2,2,598,600
"PAKTIKA","GOMAL",1208138,3,0,600,600
"PAKTIKA","GOMAL",1208138,4,0,599,599
"PAKTIKA","GOMAL",1208126,3,0,600,600
"PAKTIKA","GOMAL",1208143,2,9,584,593
"PAKTIKA","GOMAL",1208143,3,8,583,591
"PAKTIKA","GOMAL",1208140,1,0,525,525
"PAKTIKA","GOMAL",1208140,2,0,518,518
"PAKTIKA","GOMAL",1208143,1,7,71,78
"PAKTIKA","JANI KHEL",1209124,1,2,592,594
"PAKTIKA","JANI KHEL",1209123,2,281,313,594
"PAKTIKA","JANI KHEL",1209114,3,1,594,595
"PAKTIKA","JANI KHEL",1209123,1,2,594,596
"PAKTIKA","JANI KHEL",1209116,1,7,593,600
"PAKTIKA","JANI KHEL",1209116,2,22,577,599
"PAKTIKA","JANI KHEL",1209116,3,0,595,595
"PAKTIKA","JANI KHEL",1209110,1,23,577,600
"PAKTIKA","JANI KHEL",1209110,2,18,532,550
"PAKTIKA","JANI KHEL",1209124,2,8,585,593
"PAKTIKA","JANI KHEL",1209114,1,0,592,592
"PAKTIKA","JANI KHEL",1209114,2,6,591,597
"PAKTIKA","JANI KHEL",1209122,3,100,496,596
"PAKTIKA","JANI KHEL",1209122,4,111,487,598
"PAKTIKA","JANI KHEL",1209120,1,6,594,600
"PAKTIKA","JANI KHEL",1209123,3,300,300,600
"PAKTIKA","JANI KHEL",1209117,1,10,587,597
"PAKTIKA","JANI KHEL",1209117,2,1,591,592
"PAKTIKA","JANI KHEL",1209115,1,4,596,600
"PAKTIKA","JANI KHEL",1209115,2,4,592,596
"PAKTIKA","JANI KHEL",1209115,3,25,575,600
"PAKTIKA","JANI KHEL",1209118,1,1,593,594
"PAKTIKA","JANI KHEL",1209110,3,27,570,597
"PAKTIKA","JANI KHEL",1209122,1,29,568,597
"PAKTIKA","JANI KHEL",1209122,2,63,537,600
"PAKTIKA","JANI KHEL",1209109,1,6,588,594
"PAKTIKA","JANI KHEL",1209109,2,2,595,597
"PAKTIKA","JANI KHEL",1209109,3,11,584,595
"PAKTIKA","JANI KHEL",1209120,2,10,497,507
"PAKTIKA","JANI KHEL",1209112,1,0,596,596
"PAKTIKA","JANI KHEL",1209112,2,2,598,600
"PAKTIKA","JANI KHEL",1209112,3,596,4,600
"PAKTIKA","JANI KHEL",1209290,1,3,594,597
"PAKTIKA","JANI KHEL",1209290,2,9,445,454
"PAKTIKA","JANI KHEL",1209290,3,9,589,598
"PAKTIKA","JANI KHEL",1209113,3,7,586,593
"PAKTIKA","JANI KHEL",1209111,1,6,589,595
"PAKTIKA","JANI KHEL",1209118,2,8,585,593
"PAKTIKA","JANI KHEL",1209109,5,11,583,594
"PAKTIKA","JANI KHEL",1209109,6,37,550,587
"PAKTIKA","JANI KHEL",1209113,2,11,585,596
"PAKTIKA","JANI KHEL",1209109,4,3,592,595
"PAKTIKA","JANI KHEL",1209111,3,9,591,600
"PAKTIKA","JANI KHEL",1209113,1,9,586,595
"PAKTIKA","JANI KHEL",1209111,2,592,7,599
"PAKTIKA","SURUBI",1210160,2,110,481,591
"PAKTIKA","SURUBI",1210158,2,98,502,600
"PAKTIKA","SURUBI",1210158,3,117,481,598
"PAKTIKA","SURUBI",1210154,1,18,582,600
"PAKTIKA","SURUBI",1210158,1,36,564,600
"PAKTIKA","SURUBI",1210160,1,50,550,600
"PAKTIKA","SURUBI",1210152,3,19,581,600
"PAKTIKA","SURUBI",1210155,1,71,529,600
"PAKTIKA","SURUBI",1210295,2,344,243,587
"PAKTIKA","SURUBI",1210294,1,18,575,593
"PAKTIKA","SURUBI",1210154,3,2,598,600
"PAKTIKA","SURUBI",1210148,1,75,525,600
"PAKTIKA","SURUBI",1210155,2,0,600,600
"PAKTIKA","SURUBI",1210148,3,48,548,596
"PAKTIKA","SURUBI",1210150,1,12,569,581
"PAKTIKA","SURUBI",1210150,2,0,542,542
"PAKTIKA","SURUBI",1210148,2,45,552,597
"PAKTIKA","SURUBI",1210152,1,7,592,599
"PAKTIKA","SURUBI",1210152,2,20,580,600
"PAKTIKA","SURUBI",1210156,2,46,536,582
"PAKTIKA","SURUBI",1210156,3,13,586,599
"PAKTIKA","SURUBI",1210151,1,6,594,600
"PAKTIKA","SURUBI",1210151,2,2,591,593
"PAKTIKA","SURUBI",1210294,2,49,492,541
"PAKTIKA","SURUBI",1210147,1,368,230,598
"PAKTIKA","SURUBI",1210147,2,76,524,600
"PAKTIKA","SURUBI",1210147,3,199,397,596
"PAKTIKA","SURUBI",1210147,4,160,440,600
"PAKTIKA","SURUBI",1210159,1,5,586,591
"PAKTIKA","SURUBI",1210150,3,0,580,580
"PAKTIKA","SURUBI",1210295,1,37,346,383
"PAKTIKA","SURUBI",1210156,1,300,300,600
"PAKTIKA","SURUBI",1210157,1,0,597,597
"PAKTIKA","SURUBI",1210154,2,59,541,600
"PAKTIKA","SURUBI",1210149,1,5,588,593
"PAKTIKA","SURUBI",1210149,2,0,598,598
"PAKTIKA","SURUBI",1210153,1,0,600,600
"PAKTIKA","SURUBI",1210153,2,5,594,599
"PAKTIKA","SURUBI",1210157,2,0,600,600
"PAKTIKA","SURUBI",1210159,2,5,589,594
"PAKTIKA","URGOON",1211161,2,100,108,208
"PAKTIKA","URGOON",1211171,1,379,218,597
"PAKTIKA","URGOON",1211171,2,519,72,591
"PAKTIKA","URGOON",1211179,1,111,486,597
"PAKTIKA","URGOON",1211179,2,0,600,600
"PAKTIKA","URGOON",1211165,2,41,559,600
"PAKTIKA","URGOON",1211163,1,73,527,600
"PAKTIKA","URGOON",1211163,2,434,163,597
"PAKTIKA","URGOON",1211161,1,134,177,311
"PAKTIKA","URGOON",1211172,1,423,113,536
"PAKTIKA","URGOON",1211172,2,474,89,563
"PAKTIKA","URGOON",1211178,2,0,600,600
"PAKTIKA","URGOON",1211186,1,5,595,600
"PAKTIKA","URGOON",1211186,2,43,557,600
"PAKTIKA","URGOON",1211186,3,0,600,600
"PAKTIKA","URGOON",1211186,4,0,600,600
"PAKTIKA","URGOON",1211297,1,284,312,596
"PAKTIKA","URGOON",1211297,2,28,71,99
"PAKTIKA","URGOON",1211168,1,228,191,419
"PAKTIKA","URGOON",1211168,2,194,387,581
"PAKTIKA","URGOON",1211162,1,0,597,597
"PAKTIKA","URGOON",1211162,3,2,595,597
"PAKTIKA","URGOON",1211164,1,246,351,597
"PAKTIKA","URGOON",1211164,2,260,335,595
"PAKTIKA","URGOON",1211166,1,50,550,600
"PAKTIKA","URGOON",1211166,2,10,590,600
"PAKTIKA","URGOON",1211173,1,119,15,134
"PAKTIKA","URGOON",1211173,2,433,32,465
"PAKTIKA","URGOON",1211173,3,582,16,598
"PAKTIKA","URGOON",1211296,1,121,479,600
"PAKTIKA","URGOON",1211296,2,6,593,599
"PAKTIKA","URGOON",1211167,1,255,222,477
"PAKTIKA","URGOON",1211167,2,217,296,513
"PAKTIKA","URGOON",1211165,1,5,595,600
"PAKTIKA","URGOON",1211176,2,1,598,599
"PAKTIKA","URGOON",1211180,1,148,451,599
"PAKTIKA","URGOON",1211180,2,0,600,600
"PAKTIKA","URGOON",1211161,3,51,89,140
"PAKTIKA","URGOON",1211161,4,29,31,60
"PAKTIKA","URGOON",1211182,2,0,600,600
"PAKTIKA","URGOON",1211182,3,0,600,600
"PAKTIKA","URGOON",1211170,1,351,200,551
"PAKTIKA","URGOON",1211170,2,300,250,550
"PAKTIKA","URGOON",1211170,3,335,256,591
"PAKTIKA","URGOON",1211184,1,19,581,600
"PAKTIKA","URGOON",1211184,2,0,600,600
"PAKTIKA","URGOON",1211176,1,349,250,599
"PAKTIKA","URGOON",1211181,2,0,600,600
"PAKTIKA","URGOON",1211177,1,0,600,600
"PAKTIKA","URGOON",1211177,2,0,600,600
"PAKTIKA","URGOON",1211178,1,1,599,600
"PAKTIKA","URGOON",1211183,2,0,600,600
"PAKTIKA","URGOON",1211183,3,0,600,600
"PAKTIKA","URGOON",1211169,1,400,200,600
"PAKTIKA","URGOON",1211169,2,400,200,600
"PAKTIKA","URGOON",1211298,1,350,250,600
"PAKTIKA","URGOON",1211298,2,375,210,585
"PAKTIKA","URGOON",1211175,1,532,68,600
"PAKTIKA","URGOON",1211175,2,0,600,600
"PAKTIKA","URGOON",1211181,1,1,599,600
"PAKTIKA","URGOON",1211182,1,8,520,528
"PAKTIKA","URGOON",1211183,1,0,600,600
"PAKTIKA","ZIRUK",1212188,1,89,511,600
"PAKTIKA","ZIRUK",1212188,2,20,280,300
"PAKTIKA","ZIRUK",1212188,3,31,519,550
"PAKTIKA","ZIRUK",1212194,1,26,574,600
"PAKTIKA","ZIRUK",1212194,2,86,514,600
"PAKTIKA","ZIRUK",1212193,1,39,150,189
"PAKTIKA","ZIRUK",1212193,2,3,11,14
"PAKTIKA","ZIRUK",1212189,1,36,453,489
"PAKTIKA","ZIRUK",1212190,1,45,520,565
"PAKTIKA","ZIRUK",1212190,2,0,593,593
"PAKTIKA","ZIRUK",1212191,1,31,497,528
"PAKTIKA","ZIRUK",1212191,2,50,355,405
"PAKTIKA","ZIRUK",1212196,1,6,594,600
"PAKTIKA","ZIRUK",1212195,1,21,579,600
"PAKTIKA","ZIRUK",1212195,2,15,585,600
"PAKTIKA","ZIRUK",1212187,4,49,551,600
"PAKTIKA","ZIRUK",1212192,2,23,478,501
"PAKTIKA","ZIRUK",1212189,2,50,549,599
"PAKTIKA","ZIRUK",1212189,3,41,554,595
"PAKTIKA","ZIRUK",1212192,1,49,442,491
"PAKTIKA","ZIRUK",1212196,2,12,588,600
"PAKTIKA","ZIRUK",1212192,3,50,445,495
"PAKTIKA","ZIRUK",1212187,1,52,548,600
"PAKTIKA","ZIRUK",1212187,2,60,540,600
"PAKTIKA","ZIRUK",1212187,3,47,553,600
"PAKTIKA","NIKA",1213198,3,6,594,600
"PAKTIKA","NIKA",1213198,4,23,577,600
"PAKTIKA","NIKA",1213198,5,0,600,600
"PAKTIKA","NIKA",1213198,2,0,600,600
"PAKTIKA","NIKA",1213201,2,9,498,507
"PAKTIKA","NIKA",1213201,3,9,489,498
"PAKTIKA","NIKA",1213203,1,0,600,600
"PAKTIKA","NIKA",1213201,1,35,397,432
"PAKTIKA","NIKA",1213203,3,0,600,600
"PAKTIKA","NIKA",1213200,1,1,597,598
"PAKTIKA","NIKA",1213200,2,0,598,598
"PAKTIKA","NIKA",1213203,2,0,600,600
"PAKTIKA","NIKA",1213197,1,0,600,600
"PAKTIKA","NIKA",1213197,2,0,600,600
"PAKTIKA","NIKA",1213197,3,0,592,592
"PAKTIKA","NIKA",1213197,4,0,600,600
"PAKTIKA","NIKA",1213197,5,0,600,600
"PAKTIKA","NIKA",1213197,6,0,600,600
"PAKTIKA","NIKA",1213202,1,32,526,558
"PAKTIKA","NIKA",1213202,2,6,444,450
"PAKTIKA","NIKA",1213202,3,16,583,599
"PAKTIKA","NIKA",1213204,1,0,600,600
"PAKTIKA","NIKA",1213204,2,0,600,600
"PAKTIKA","NIKA",1213199,1,2,598,600
"PAKTIKA","NIKA",1213199,2,0,597,597
"PAKTIKA","NIKA",1213198,1,0,600,600
"PAKTIKA","BARMAL",1214265,1,199,400,599
"PAKTIKA","BARMAL",1214265,2,130,466,596
"PAKTIKA","BARMAL",1214265,3,43,555,598
"PAKTIKA","BARMAL",1214265,4,7,591,598
"PAKTIKA","BARMAL",1214258,1,0,600,600
"PAKTIKA","BARMAL",1214258,2,0,600,600
"PAKTIKA","BARMAL",1214258,3,450,150,600
"PAKTIKA","BARMAL",1214258,4,588,12,600
"PAKTIKA","BARMAL",1214260,1,465,135,600
"PAKTIKA","BARMAL",1214260,2,435,165,600
"PAKTIKA","BARMAL",1214262,1,222,378,600
"PAKTIKA","BARMAL",1214262,2,350,250,600
"PAKTIKA","BARMAL",1214264,1,3,597,600
"PAKTIKA","BARMAL",1214264,2,9,591,600
"PAKTIKA","BARMAL",1214266,1,7,591,598
"PAKTIKA","BARMAL",1214266,2,292,308,600
"PAKTIKA","BARMAL",1214266,3,0,600,600
"PAKTIKA","BARMAL",1214266,4,500,0,500
"PAKTIKA","BARMAL",1214304,1,1,599,600
"PAKTIKA","BARMAL",1214304,2,8,592,600
"PAKTIKA","BARMAL",1214306,1,83,516,599
"PAKTIKA","BARMAL",1214306,2,74,524,598
"PAKTIKA","BARMAL",1214306,3,50,550,600
"PAKTIKA","BARMAL",1214263,4,191,409,600
"PAKTIKA","BARMAL",1214303,1,20,579,599
"PAKTIKA","BARMAL",1214303,2,70,530,600
"PAKTIKA","BARMAL",1214305,1,133,467,600
"PAKTIKA","BARMAL",1214305,2,528,72,600
"PAKTIKA","BARMAL",1214305,3,600,0,600
"PAKTIKA","BARMAL",1214261,1,350,250,600
"PAKTIKA","BARMAL",1214261,2,434,166,600
"PAKTIKA","BARMAL",1214259,1,50,550,600
"PAKTIKA","BARMAL",1214258,5,0,600,600
"PAKTIKA","BARMAL",1214263,1,128,472,600
"PAKTIKA","BARMAL",1214263,2,400,200,600
"PAKTIKA","BARMAL",1214263,3,104,496,600
"PAKTIKA","BARMAL",1214259,2,3,596,599
"PAKTIKA","BARMAL",1214259,3,1,599,600
"PAKTIKA","GIYAN",1215272,4,0,600,600
"PAKTIKA","GIYAN",1215272,5,0,600,600
"PAKTIKA","GIYAN",1215268,1,0,600,600
"PAKTIKA","GIYAN",1215272,3,0,600,600
"PAKTIKA","GIYAN",1215268,3,0,600,600
"PAKTIKA","GIYAN",1215274,1,0,600,600
"PAKTIKA","GIYAN",1215274,2,0,600,600
"PAKTIKA","GIYAN",1215268,2,0,600,600
"PAKTIKA","GIYAN",1215270,2,0,600,600
"PAKTIKA","GIYAN",1215270,3,0,600,600
"PAKTIKA","GIYAN",1215278,1,0,600,600
"PAKTIKA","GIYAN",1215278,2,0,600,600
"PAKTIKA","GIYAN",1215278,3,0,600,600
"PAKTIKA","GIYAN",1215278,4,0,600,600
"PAKTIKA","GIYAN",1215276,1,9,591,600
"PAKTIKA","GIYAN",1215276,2,2,598,600
"PAKTIKA","GIYAN",1215280,1,0,600,600
"PAKTIKA","GIYAN",1215280,2,0,600,600
"PAKTIKA","GIYAN",1215280,3,0,600,600
"PAKTIKA","GIYAN",1215267,1,0,600,600
"PAKTIKA","GIYAN",1215267,2,0,600,600
"PAKTIKA","GIYAN",1215267,3,0,600,600
"PAKTIKA","GIYAN",1215267,4,0,600,600
"PAKTIKA","GIYAN",1215273,1,0,600,600
"PAKTIKA","GIYAN",1215273,2,0,600,600
"PAKTIKA","GIYAN",1215272,1,0,600,600
"PAKTIKA","GIYAN",1215272,2,0,600,600
"PAKTIKA","GIYAN",1215275,1,0,600,600
"PAKTIKA","GIYAN",1215275,2,0,600,600
"PAKTIKA","GIYAN",1215269,1,0,600,600
"PAKTIKA","GIYAN",1215269,2,0,600,600
"PAKTIKA","GIYAN",1215269,3,0,600,600
"PAKTIKA","GIYAN",1215279,1,0,600,600
"PAKTIKA","GIYAN",1215279,2,0,599,599
"PAKTIKA","GIYAN",1215274,3,0,600,600
"PAKTIKA","GIYAN",1215270,1,0,600,600
"PAKTIKA","GIYAN",1215273,3,0,600,600
"PAKTIKA","GIYAN",1215279,3,0,500,500
"PAKTIKA","DILA WA KHUSH",1216206,2,28,569,597
"PAKTIKA","DILA WA KHUSH",1216210,1,23,572,595
"PAKTIKA","DILA WA KHUSH",1216210,2,38,562,600
"PAKTIKA","DILA WA KHUSH",1216210,3,38,562,600
"PAKTIKA","DILA WA KHUSH",1216216,4,11,582,593
"PAKTIKA","DILA WA KHUSH",1216206,3,14,586,600
"PAKTIKA","DILA WA KHUSH",1216206,4,16,576,592
"PAKTIKA","DILA WA KHUSH",1216206,5,0,595,595
"PAKTIKA","DILA WA KHUSH",1216218,1,26,572,598
"PAKTIKA","DILA WA KHUSH",1216218,2,24,571,595
"PAKTIKA","DILA WA KHUSH",1216210,4,11,589,600
"PAKTIKA","DILA WA KHUSH",1216208,1,18,580,598
"PAKTIKA","DILA WA KHUSH",1216208,3,5,586,591
"PAKTIKA","DILA WA KHUSH",1216208,4,20,580,600
"PAKTIKA","DILA WA KHUSH",1216216,1,11,587,598
"PAKTIKA","DILA WA KHUSH",1216216,2,8,590,598
"PAKTIKA","DILA WA KHUSH",1216216,3,11,582,593
"PAKTIKA","DILA WA KHUSH",1216217,3,26,569,595
"PAKTIKA","DILA WA KHUSH",1216216,5,23,575,598
"PAKTIKA","DILA WA KHUSH",1216212,1,23,572,595
"PAKTIKA","DILA WA KHUSH",1216212,2,29,568,597
"PAKTIKA","DILA WA KHUSH",1216215,3,37,559,596
"PAKTIKA","DILA WA KHUSH",1216215,4,18,577,595
"PAKTIKA","DILA WA KHUSH",1216215,1,25,570,595
"PAKTIKA","DILA WA KHUSH",1216215,2,0,593,593
"PAKTIKA","DILA WA KHUSH",1216217,2,33,564,597
"PAKTIKA","DILA WA KHUSH",1216206,1,13,582,595
"PAKTIKA","DILA WA KHUSH",1216215,5,18,579,597
"PAKTIKA","DILA WA KHUSH",1216217,1,32,565,597
"PAKTIKA","DILA WA KHUSH",1216208,2,33,562,595
"PAKTIKA","WAZAKHWAH",1217224,3,127,471,598
"PAKTIKA","WAZAKHWAH",1217224,4,29,571,600
"PAKTIKA","WAZAKHWAH",1217299,1,28,572,600
"PAKTIKA","WAZAKHWAH",1217299,2,24,568,592
"PAKTIKA","WAZAKHWAH",1217299,3,45,550,595
"PAKTIKA","WAZAKHWAH",1217220,1,9,569,578
"PAKTIKA","WAZAKHWAH",1217220,2,10,582,592
"PAKTIKA","WAZAKHWAH",1217220,3,25,570,595
"PAKTIKA","WAZAKHWAH",1217220,4,24,574,598
"PAKTIKA","WAZAKHWAH",1217228,1,0,595,595
"PAKTIKA","WAZAKHWAH",1217228,2,3,578,581
"PAKTIKA","WAZAKHWAH",1217224,1,201,398,599
"PAKTIKA","WAZAKHWAH",1217224,2,259,334,593
"PAKTIKA","WAZAKHWAH",1217221,1,0,600,600
"PAKTIKA","WAZAKHWAH",1217221,2,0,600,600
"PAKTIKA","WAZAKHWAH",1217221,3,6,594,600
"PAKTIKA","WAZAKHWAH",1217221,4,200,369,569
"PAKTIKA","WAZAKHWAH",1217230,1,0,600,600
"PAKTIKA","WAZAKHWAH",1217230,2,0,600,600
"PAKTIKA","WAZAKHWAH",1217230,3,1,599,600
"PAKTIKA","WAZAKHWAH",1217230,4,3,597,600
"PAKTIKA","WAZAKHWAH",1217230,5,550,41,591
"PAKTIKA","WAZAKHWAH",1217227,2,25,573,598
"PAKTIKA","WAZAKHWAH",1217219,3,400,172,572
"PAKTIKA","WAZAKHWAH",1217219,4,252,335,587
"PAKTIKA","WAZAKHWAH",1217219,5,1,599,600
"PAKTIKA","WAZAKHWAH",1217228,3,68,529,597
"PAKTIKA","WAZAKHWAH",1217222,1,0,597,597
"PAKTIKA","WAZAKHWAH",1217222,2,1,599,600
"PAKTIKA","WAZAKHWAH",1217222,3,0,600,600
"PAKTIKA","WAZAKHWAH",1217222,4,300,282,582
"PAKTIKA","WAZAKHWAH",1217229,1,2,597,599
"PAKTIKA","WAZAKHWAH",1217229,2,7,584,591
"PAKTIKA","WAZAKHWAH",1217229,3,0,600,600
"PAKTIKA","WAZAKHWAH",1217219,1,299,295,594
"PAKTIKA","WAZAKHWAH",1217219,2,62,530,592
"PAKTIKA","WAZAKHWAH",1217227,1,12,576,588
"PAKTIKA","WAZAKHWAH",1217300,2,70,523,593
"PAKTIKA","WAZAKHWAH",1217219,6,125,458,583
"PAKTIKA","WAZAKHWAH",1217300,1,31,563,594
"PAKTIKA","WOR MAMY",1218302,1,1,595,596
"PAKTIKA","WOR MAMY",1218301,2,164,435,599
"PAKTIKA","WOR MAMY",1218238,3,597,0,597
"PAKTIKA","WOR MAMY",1218240,1,500,100,600
"PAKTIKA","WOR MAMY",1218240,2,150,450,600
"PAKTIKA","WOR MAMY",1218240,3,100,500,600
"PAKTIKA","WOR MAMY",1218240,4,214,378,592
"PAKTIKA","WOR MAMY",1218239,1,100,500,600
"PAKTIKA","WOR MAMY",1218239,2,100,500,600
"PAKTIKA","WOR MAMY",1218301,1,164,436,600
"PAKTIKA","WOR MAMY",1218239,4,50,550,600
"PAKTIKA","WOR MAMY",1218246,1,100,500,600
"PAKTIKA","WOR MAMY",1218302,2,11,583,594
"PAKTIKA","WOR MAMY",1218238,1,592,0,592
"PAKTIKA","WOR MAMY",1218238,2,600,0,600
"PAKTIKA","WOR MAMY",1218237,2,16,583,599
"PAKTIKA","WOR MAMY",1218237,3,7,593,600
"PAKTIKA","WOR MAMY",1218237,4,0,600,600
"PAKTIKA","WOR MAMY",1218237,5,0,600,600
"PAKTIKA","WOR MAMY",1218241,1,5,595,600
"PAKTIKA","WOR MAMY",1218241,2,9,587,596
"PAKTIKA","WOR MAMY",1218241,3,10,590,600
"PAKTIKA","WOR MAMY",1218239,3,150,450,600
"PAKTIKA","WOR MAMY",1218241,4,8,592,600
"PAKTIKA","WOR MAMY",1218242,1,165,355,520
"PAKTIKA","WOR MAMY",1218242,2,200,400,600
"PAKTIKA","WOR MAMY",1218246,2,350,250,600
"PAKTIKA","WOR MAMY",1218246,3,300,300,600
"PAKTIKA","WOR MAMY",1218243,1,75,525,600
"PAKTIKA","WOR MAMY",1218243,2,423,177,600
"PAKTIKA","WOR MAMY",1218243,3,454,100,554
"PAKTIKA","WOR MAMY",1218245,1,50,550,600
"PAKTIKA","WOR MAMY",1218245,2,43,557,600
"PAKTIKA","WOR MAMY",1218245,3,50,550,600
"PAKTIKA","WOR MAMY",1218244,1,95,505,600
"PAKTIKA","WOR MAMY",1218244,2,125,475,600
"PAKTIKA","WOR MAMY",1218244,3,100,499,599
"PAKTIKA","WOR MAMY",1218237,1,50,550,600
"PAKTIKA","WOR MAMY",1218242,3,67,110,177
"PAKTIKA","WOR MAMY",1218242,4,2,598,600
"PAKTIKA","TURWO",1219234,4,242,346,588
"PAKTIKA","TURWO",1219236,2,2,594,596
"PAKTIKA","TURWO",1219231,1,28,547,575
"PAKTIKA","TURWO",1219236,1,422,176,598
"PAKTIKA","TURWO",1219231,3,150,450,600
"PAKTIKA","TURWO",1219231,4,586,11,597
"PAKTIKA","TURWO",1219231,5,4,594,598
"PAKTIKA","TURWO",1219234,1,152,430,582
"PAKTIKA","TURWO",1219231,2,200,400,600
"PAKTIKA","TURWO",1219234,2,150,450,600
"PAKTIKA","TURWO",1219234,3,233,364,597
"PAKTIKA","TURWO",1219236,4,528,62,590
"PAKTIKA","TURWO",1219236,3,306,283,589
"PAKTYA","GARDEZ",1301016,3,21,57,78
"PAKTYA","GARDEZ",1301003,3,9,173,182
"PAKTYA","GARDEZ",1301016,4,0,18,18
"PAKTYA","GARDEZ",1301003,5,91,337,428
"PAKTYA","GARDEZ",1301003,6,13,99,112
"PAKTYA","GARDEZ",1301003,7,71,278,349
"PAKTYA","GARDEZ",1301003,4,22,258,280
"PAKTYA","GARDEZ",1301012,6,4,8,12
"PAKTYA","GARDEZ",1301016,1,24,53,77
"PAKTYA","GARDEZ",1301016,2,14,25,39
"PAKTYA","GARDEZ",1301004,5,48,316,364
"PAKTYA","GARDEZ",1301004,6,18,191,209
"PAKTYA","GARDEZ",1301003,1,37,241,278
"PAKTYA","GARDEZ",1301003,2,55,331,386
"PAKTYA","GARDEZ",1301009,5,3,29,32
"PAKTYA","GARDEZ",1301009,6,1,141,142
"PAKTYA","GARDEZ",1301012,1,38,110,148
"PAKTYA","GARDEZ",1301012,2,18,38,56
"PAKTYA","GARDEZ",1301012,3,11,37,48
"PAKTYA","GARDEZ",1301004,1,54,384,438
"PAKTYA","GARDEZ",1301012,5,18,15,33
"PAKTYA","GARDEZ",1301018,4,0,83,83
"PAKTYA","GARDEZ",1301017,1,4,47,51
"PAKTYA","GARDEZ",1301017,2,3,98,101
"PAKTYA","GARDEZ",1301017,3,0,22,22
"PAKTYA","GARDEZ",1301017,4,0,15,15
"PAKTYA","GARDEZ",1301014,1,115,107,222
"PAKTYA","GARDEZ",1301014,2,58,88,146
"PAKTYA","GARDEZ",1301014,3,1,1,2
"PAKTYA","GARDEZ",1301204,1,7,55,62
"PAKTYA","GARDEZ",1301204,2,2,17,19
"PAKTYA","GARDEZ",1301204,3,1,28,29
"PAKTYA","GARDEZ",1301012,4,44,136,180
"PAKTYA","GARDEZ",1301006,2,0,301,301
"PAKTYA","GARDEZ",1301004,2,35,346,381
"PAKTYA","GARDEZ",1301004,3,47,414,461
"PAKTYA","GARDEZ",1301004,4,53,412,465
"PAKTYA","GARDEZ",1301006,5,3,282,285
"PAKTYA","GARDEZ",1301006,6,3,146,149
"PAKTYA","GARDEZ",1301010,1,14,74,88
"PAKTYA","GARDEZ",1301010,2,4,41,45
"PAKTYA","GARDEZ",1301010,3,9,83,92
"PAKTYA","GARDEZ",1301010,4,44,66,110
"PAKTYA","GARDEZ",1301010,5,41,108,149
"PAKTYA","GARDEZ",1301010,6,28,131,159
"PAKTYA","GARDEZ",1301006,1,5,302,307
"PAKTYA","GARDEZ",1301007,3,3,78,81
"PAKTYA","GARDEZ",1301007,4,0,50,50
"PAKTYA","GARDEZ",1301005,2,12,384,396
"PAKTYA","GARDEZ",1301005,3,7,397,404
"PAKTYA","GARDEZ",1301005,4,5,562,567
"PAKTYA","GARDEZ",1301005,5,3,585,588
"PAKTYA","GARDEZ",1301009,1,36,222,258
"PAKTYA","GARDEZ",1301009,2,6,31,37
"PAKTYA","GARDEZ",1301009,3,20,59,79
"PAKTYA","GARDEZ",1301009,4,27,50,77
"PAKTYA","GARDEZ",1301011,6,6,69,75
"PAKTYA","GARDEZ",1301203,1,4,73,77
"PAKTYA","GARDEZ",1301203,2,4,50,54
"PAKTYA","GARDEZ",1301203,3,0,3,3
"PAKTYA","GARDEZ",1301015,1,4,110,114
"PAKTYA","GARDEZ",1301015,2,2,77,79
"PAKTYA","GARDEZ",1301015,3,2,85,87
"PAKTYA","GARDEZ",1301013,1,10,74,84
"PAKTYA","GARDEZ",1301013,2,6,69,75
"PAKTYA","GARDEZ",1301013,3,1,6,7
"PAKTYA","GARDEZ",1301001,1,150,441,591
"PAKTYA","GARDEZ",1301001,2,215,370,585
"PAKTYA","GARDEZ",1301001,3,187,405,592
"PAKTYA","GARDEZ",1301001,4,157,423,580
"PAKTYA","GARDEZ",1301001,5,185,397,582
"PAKTYA","GARDEZ",1301001,6,146,436,582
"PAKTYA","GARDEZ",1301001,7,177,408,585
"PAKTYA","GARDEZ",1301001,8,113,305,418
"PAKTYA","GARDEZ",1301001,9,93,192,285
"PAKTYA","GARDEZ",1301001,10,54,123,177
"PAKTYA","GARDEZ",1301001,11,63,118,181
"PAKTYA","GARDEZ",1301001,12,24,131,155
"PAKTYA","GARDEZ",1301001,13,34,69,103
"PAKTYA","GARDEZ",1301006,7,0,215,215
"PAKTYA","GARDEZ",1301006,8,0,547,547
"PAKTYA","GARDEZ",1301002,1,20,132,152
"PAKTYA","GARDEZ",1301002,2,25,273,298
"PAKTYA","GARDEZ",1301002,3,7,352,359
"PAKTYA","GARDEZ",1301007,1,15,242,257
"PAKTYA","GARDEZ",1301007,2,14,180,194
"PAKTYA","GARDEZ",1301010,7,91,278,369
"PAKTYA","GARDEZ",1301202,1,3,477,480
"PAKTYA","GARDEZ",1301202,2,3,515,518
"PAKTYA","GARDEZ",1301202,3,8,513,521
"PAKTYA","GARDEZ",1301202,4,1,467,468
"PAKTYA","GARDEZ",1301011,1,17,238,255
"PAKTYA","GARDEZ",1301011,2,0,107,107
"PAKTYA","GARDEZ",1301011,3,9,302,311
"PAKTYA","GARDEZ",1301011,4,20,112,132
"PAKTYA","GARDEZ",1301011,5,25,203,228
"PAKTYA","GARDEZ",1301008,2,0,39,39
"PAKTYA","GARDEZ",1301008,3,0,63,63
"PAKTYA","GARDEZ",1301008,4,1,97,98
"PAKTYA","GARDEZ",1301018,1,24,208,232
"PAKTYA","GARDEZ",1301018,2,8,152,160
"PAKTYA","GARDEZ",1301018,3,19,137,156
"PAKTYA","GARDEZ",1301201,3,48,175,223
"PAKTYA","GARDEZ",1301006,3,6,271,277
"PAKTYA","GARDEZ",1301006,4,0,531,531
"PAKTYA","GARDEZ",1301201,6,276,321,597
"PAKTYA","GARDEZ",1301201,7,20,343,363
"PAKTYA","GARDEZ",1301201,8,14,422,436
"PAKTYA","GARDEZ",1301201,9,68,64,132
"PAKTYA","GARDEZ",1301008,1,4,75,79
"PAKTYA","GARDEZ",1301201,2,47,172,219
"PAKTYA","GARDEZ",1301002,6,7,149,156
"PAKTYA","GARDEZ",1301002,4,12,221,233
"PAKTYA","GARDEZ",1301201,1,35,146,181
"PAKTYA","GARDEZ",1301002,5,10,136,146
"PAKTYA","GARDEZ",1301201,4,1,5,6
"PAKTYA","GARDEZ",1301201,5,0,3,3
"PAKTYA","GARDEZ",1301005,1,5,583,588
"PAKTYA","AHMADABA",1302193,1,16,580,596
"PAKTYA","AHMADABA",1302193,4,2,428,430
"PAKTYA","AHMADABA",1302195,4,4,593,597
"PAKTYA","AHMADABA",1302193,2,15,584,599
"PAKTYA","AHMADABA",1302193,3,17,580,597
"PAKTYA","AHMADABA",1302200,1,3,589,592
"PAKTYA","AHMADABA",1302200,2,4,593,597
"PAKTYA","AHMADABA",1302195,5,11,586,597
"PAKTYA","AHMADABA",1302195,6,14,585,599
"PAKTYA","AHMADABA",1302192,1,18,339,357
"PAKTYA","AHMADABA",1302192,2,0,558,558
"PAKTYA","AHMADABA",1302192,3,0,600,600
"PAKTYA","AHMADABA",1302192,4,2,506,508
"PAKTYA","AHMADABA",1302196,1,10,587,597
"PAKTYA","AHMADABA",1302196,2,1,598,599
"PAKTYA","AHMADABA",1302196,3,7,593,600
"PAKTYA","AHMADABA",1302196,4,6,594,600
"PAKTYA","AHMADABA",1302194,1,1,598,599
"PAKTYA","AHMADABA",1302194,2,0,599,599
"PAKTYA","AHMADABA",1302194,3,2,598,600
"PAKTYA","AHMADABA",1302198,1,1,594,595
"PAKTYA","AHMADABA",1302198,2,6,592,598
"PAKTYA","AHMADABA",1302198,3,13,585,598
"PAKTYA","AHMADABA",1302198,4,33,563,596
"PAKTYA","AHMADABA",1302198,5,41,553,594
"PAKTYA","AHMADABA",1302198,6,11,577,588
"PAKTYA","AHMADABA",1302195,1,2,596,598
"PAKTYA","AHMADABA",1302195,2,2,597,599
"PAKTYA","AHMADABA",1302195,3,0,599,599
"PAKTYA","AHMADABA",1302191,7,8,591,599
"PAKTYA","AHMADABA",1302191,8,17,159,176
"PAKTYA","AHMADABA",1302190,1,2,588,590
"PAKTYA","AHMADABA",1302190,2,12,583,595
"PAKTYA","AHMADABA",1302190,3,14,585,599
"PAKTYA","AHMADABA",1302200,3,14,576,590
"PAKTYA","AHMADABA",1302200,4,5,588,593
"PAKTYA","AHMADABA",1302191,1,2,597,599
"PAKTYA","AHMADABA",1302191,2,9,581,590
"PAKTYA","AHMADABA",1302191,3,12,579,591
"PAKTYA","AHMADABA",1302191,4,13,585,598
"PAKTYA","AHMADABA",1302191,5,5,580,585
"PAKTYA","AHMADABA",1302191,6,6,590,596
"PAKTYA","AHMADABA",1302197,3,1,597,598
"PAKTYA","AHMADABA",1302197,4,0,599,599
"PAKTYA","AHMADABA",1302197,5,0,599,599
"PAKTYA","AHMADABA",1302218,1,5,595,600
"PAKTYA","AHMADABA",1302218,2,1,599,600
"PAKTYA","AHMADABA",1302190,4,11,589,600
"PAKTYA","AHMADABA",1302190,5,0,587,587
"PAKTYA","AHMADABA",1302190,6,1,596,597
"PAKTYA","AHMADABA",1302190,7,6,545,551
"PAKTYA","AHMADABA",1302190,8,10,587,597
"PAKTYA","AHMADABA",1302190,9,6,594,600
"PAKTYA","AHMADABA",1302197,1,1,596,597
"PAKTYA","AHMADABA",1302197,2,60,540,600
"PAKTYA","AHMADABA",1302199,2,6,592,598
"PAKTYA","AHMADABA",1302218,3,0,600,600
"PAKTYA","AHMADABA",1302218,4,0,506,506
"PAKTYA","AHMADABA",1302199,1,6,578,584
"PAKTYA","AHMADABA",1302199,3,31,560,591
"PAKTYA","AHMADABA",1302199,4,41,556,597
"PAKTYA","ZURMAT",1303090,2,0,227,227
"PAKTYA","ZURMAT",1303090,3,1,191,192
"PAKTYA","ZURMAT",1303096,1,8,20,28
"PAKTYA","ZURMAT",1303093,1,5,556,561
"PAKTYA","ZURMAT",1303086,1,6,557,563
"PAKTYA","ZURMAT",1303086,2,11,578,589
"PAKTYA","ZURMAT",1303088,1,9,110,119
"PAKTYA","ZURMAT",1303088,2,1,96,97
"PAKTYA","ZURMAT",1303088,3,0,47,47
"PAKTYA","ZURMAT",1303111,1,6,172,178
"PAKTYA","ZURMAT",1303111,2,46,0,46
"PAKTYA","ZURMAT",1303089,1,1,119,120
"PAKTYA","ZURMAT",1303103,5,0,76,76
"PAKTYA","ZURMAT",1303098,1,2,559,561
"PAKTYA","ZURMAT",1303098,2,1,575,576
"PAKTYA","ZURMAT",1303110,1,8,274,282
"PAKTYA","ZURMAT",1303081,2,18,162,180
"PAKTYA","ZURMAT",1303108,1,8,19,27
"PAKTYA","ZURMAT",1303088,4,2,91,93
"PAKTYA","ZURMAT",1303091,1,15,577,592
"PAKTYA","ZURMAT",1303091,2,42,550,592
"PAKTYA","ZURMAT",1303094,1,11,11,22
"PAKTYA","ZURMAT",1303090,1,6,295,301
"PAKTYA","ZURMAT",1303103,3,0,50,50
"PAKTYA","ZURMAT",1303103,4,0,62,62
"PAKTYA","ZURMAT",1303100,2,0,120,120
"PAKTYA","ZURMAT",1303105,1,3,55,58
"PAKTYA","ZURMAT",1303105,2,10,54,64
"PAKTYA","ZURMAT",1303105,3,0,86,86
"PAKTYA","ZURMAT",1303101,1,1,21,22
"PAKTYA","ZURMAT",1303101,2,1,100,101
"PAKTYA","ZURMAT",1303106,1,3,35,38
"PAKTYA","ZURMAT",1303106,2,7,30,37
"PAKTYA","ZURMAT",1303109,1,0,95,95
"PAKTYA","ZURMAT",1303109,2,4,26,30
"PAKTYA","ZURMAT",1303080,1,7,117,124
"PAKTYA","ZURMAT",1303103,1,0,100,100
"PAKTYA","ZURMAT",1303103,2,0,141,141
"PAKTYA","ZURMAT",1303078,3,3,563,566
"PAKTYA","ZURMAT",1303078,4,6,587,593
"PAKTYA","ZURMAT",1303103,6,2,78,80
"PAKTYA","ZURMAT",1303099,1,3,392,395
"PAKTYA","ZURMAT",1303099,2,0,503,503
"PAKTYA","ZURMAT",1303104,1,3,18,21
"PAKTYA","ZURMAT",1303104,2,5,33,38
"PAKTYA","ZURMAT",1303104,3,0,33,33
"PAKTYA","ZURMAT",1303104,4,1,20,21
"PAKTYA","ZURMAT",1303104,5,1,38,39
"PAKTYA","ZURMAT",1303104,6,1,63,64
"PAKTYA","ZURMAT",1303078,1,30,563,593
"PAKTYA","ZURMAT",1303078,2,10,582,592
"PAKTYA","ZURMAT",1303083,1,10,86,96
"PAKTYA","ZURMAT",1303083,2,5,74,79
"PAKTYA","ZURMAT",1303078,5,7,578,585
"PAKTYA","ZURMAT",1303078,6,5,586,591
"PAKTYA","ZURMAT",1303078,7,0,592,592
"PAKTYA","ZURMAT",1303107,1,2,47,49
"PAKTYA","ZURMAT",1303107,2,8,36,44
"PAKTYA","ZURMAT",1303079,1,4,150,154
"PAKTYA","ZURMAT",1303092,1,16,67,83
"PAKTYA","SHWAK",1304113,2,19,475,494
"PAKTYA","SHWAK",1304112,2,26,571,597
"PAKTYA","SHWAK",1304113,1,23,574,597
"PAKTYA","SHWAK",1304113,5,82,515,597
"PAKTYA","SHWAK",1304112,1,110,488,598
"PAKTYA","SHWAK",1304112,7,104,493,597
"PAKTYA","SHWAK",1304112,4,75,523,598
"PAKTYA","SHWAK",1304112,3,254,344,598
"PAKTYA","SHWAK",1304113,6,1,599,600
"PAKTYA","SHWAK",1304113,3,4,591,595
"PAKTYA","SHWAK",1304112,5,181,412,593
"PAKTYA","SHWAK",1304112,6,0,599,599
"PAKTYA","SHWAK",1304113,4,143,330,473
"PAKTYA","WUZA ZADRAN",1305131,2,1,597,598
"PAKTYA","WUZA ZADRAN",1305127,4,37,563,600
"PAKTYA","WUZA ZADRAN",1305131,3,3,597,600
"PAKTYA","WUZA ZADRAN",1305128,2,4,596,600
"PAKTYA","WUZA ZADRAN",1305131,1,61,537,598
"PAKTYA","WUZA ZADRAN",1305128,1,1,593,594
"PAKTYA","WUZA ZADRAN",1305206,2,130,468,598
"PAKTYA","WUZA ZADRAN",1305128,3,2,598,600
"PAKTYA","WUZA ZADRAN",1305130,1,0,599,599
"PAKTYA","WUZA ZADRAN",1305206,1,21,578,599
"PAKTYA","WUZA ZADRAN",1305127,1,2,598,600
"PAKTYA","WUZA ZADRAN",1305131,4,0,600,600
"PAKTYA","WUZA ZADRAN",1305127,3,0,600,600
"PAKTYA","WUZA ZADRAN",1305129,3,2,598,600
"PAKTYA","WUZA ZADRAN",1305129,4,1,596,597
"PAKTYA","WUZA ZADRAN",1305126,1,7,592,599
"PAKTYA","WUZA ZADRAN",1305126,2,13,586,599
"PAKTYA","WUZA ZADRAN",1305126,3,2,561,563
"PAKTYA","WUZA ZADRAN",1305118,2,0,560,560
"PAKTYA","WUZA ZADRAN",1305118,3,2,588,590
"PAKTYA","WUZA ZADRAN",1305123,1,13,430,443
"PAKTYA","WUZA ZADRAN",1305123,2,40,345,385
"PAKTYA","WUZA ZADRAN",1305130,2,0,598,598
"PAKTYA","WUZA ZADRAN",1305130,3,2,598,600
"PAKTYA","WUZA ZADRAN",1305127,2,15,583,598
"PAKTYA","WUZA ZADRAN",1305120,2,2,562,564
"PAKTYA","WUZA ZADRAN",1305124,1,9,591,600
"PAKTYA","WUZA ZADRAN",1305124,2,12,588,600
"PAKTYA","WUZA ZADRAN",1305124,3,5,595,600
"PAKTYA","WUZA ZADRAN",1305114,1,5,589,594
"PAKTYA","WUZA ZADRAN",1305114,2,4,589,593
"PAKTYA","WUZA ZADRAN",1305114,3,30,568,598
"PAKTYA","WUZA ZADRAN",1305116,1,5,144,149
"PAKTYA","WUZA ZADRAN",1305116,2,3,221,224
"PAKTYA","WUZA ZADRAN",1305119,1,0,592,592
"PAKTYA","WUZA ZADRAN",1305122,1,32,357,389
"PAKTYA","WUZA ZADRAN",1305122,2,27,413,440
"PAKTYA","WUZA ZADRAN",1305120,1,0,584,584
"PAKTYA","WUZA ZADRAN",1305121,2,24,566,590
"PAKTYA","WUZA ZADRAN",1305125,1,15,584,599
"PAKTYA","WUZA ZADRAN",1305125,2,26,556,582
"PAKTYA","WUZA ZADRAN",1305125,3,13,587,600
"PAKTYA","WUZA ZADRAN",1305117,1,3,597,600
"PAKTYA","WUZA ZADRAN",1305117,2,0,400,400
"PAKTYA","WUZA ZADRAN",1305118,1,2,588,590
"PAKTYA","WUZA ZADRAN",1305119,3,6,521,527
"PAKTYA","WUZA ZADRAN",1305121,1,103,483,586
"PAKTYA","WUZA ZADRAN",1305129,2,0,600,600
"PAKTYA","WUZA ZADRAN",1305119,2,0,595,595
"PAKTYA","WUZA ZADRAN",1305115,1,21,566,587
"PAKTYA","WUZA ZADRAN",1305115,2,47,540,587
"PAKTYA","WUZA ZADRAN",1305129,1,2,598,600
"PAKTYA","SAYYID KARAM",1306028,1,80,519,599
"PAKTYA","SAYYID KARAM",1306032,1,0,600,600
"PAKTYA","SAYYID KARAM",1306028,2,94,506,600
"PAKTYA","SAYYID KARAM",1306030,2,8,584,592
"PAKTYA","SAYYID KARAM",1306021,6,2,596,598
"PAKTYA","SAYYID KARAM",1306024,1,4,595,599
"PAKTYA","SAYYID KARAM",1306030,1,11,580,591
"PAKTYA","SAYYID KARAM",1306024,3,1,594,595
"PAKTYA","SAYYID KARAM",1306024,4,1,599,600
"PAKTYA","SAYYID KARAM",1306020,4,5,594,599
"PAKTYA","SAYYID KARAM",1306020,5,0,600,600
"PAKTYA","SAYYID KARAM",1306026,1,0,588,588
"PAKTYA","SAYYID KARAM",1306026,2,0,599,599
"PAKTYA","SAYYID KARAM",1306021,1,4,595,599
"PAKTYA","SAYYID KARAM",1306032,2,0,600,600
"PAKTYA","SAYYID KARAM",1306021,4,1,599,600
"PAKTYA","SAYYID KARAM",1306021,5,0,600,600
"PAKTYA","SAYYID KARAM",1306034,3,1,595,596
"PAKTYA","SAYYID KARAM",1306034,4,17,578,595
"PAKTYA","SAYYID KARAM",1306024,2,4,595,599
"PAKTYA","SAYYID KARAM",1306029,1,0,590,590
"PAKTYA","SAYYID KARAM",1306029,2,1,599,600
"PAKTYA","SAYYID KARAM",1306029,3,1,598,599
"PAKTYA","SAYYID KARAM",1306038,1,7,39,46
"PAKTYA","SAYYID KARAM",1306038,2,8,7,15
"PAKTYA","SAYYID KARAM",1306038,3,3,13,16
"PAKTYA","SAYYID KARAM",1306039,1,0,501,501
"PAKTYA","SAYYID KARAM",1306021,2,25,575,600
"PAKTYA","SAYYID KARAM",1306021,3,61,536,597
"PAKTYA","SAYYID KARAM",1306027,2,108,476,584
"PAKTYA","SAYYID KARAM",1306036,1,13,586,599
"PAKTYA","SAYYID KARAM",1306036,2,9,560,569
"PAKTYA","SAYYID KARAM",1306035,1,3,112,115
"PAKTYA","SAYYID KARAM",1306020,1,21,573,594
"PAKTYA","SAYYID KARAM",1306037,1,14,584,598
"PAKTYA","SAYYID KARAM",1306037,2,14,585,599
"PAKTYA","SAYYID KARAM",1306040,1,62,534,596
"PAKTYA","SAYYID KARAM",1306040,2,30,569,599
"PAKTYA","SAYYID KARAM",1306040,3,7,593,600
"PAKTYA","SAYYID KARAM",1306023,1,0,600,600
"PAKTYA","SAYYID KARAM",1306023,2,6,594,600
"PAKTYA","SAYYID KARAM",1306023,3,21,579,600
"PAKTYA","SAYYID KARAM",1306034,1,8,591,599
"PAKTYA","SAYYID KARAM",1306034,2,0,598,598
"PAKTYA","SAYYID KARAM",1306019,3,9,584,593
"PAKTYA","SAYYID KARAM",1306019,4,29,553,582
"PAKTYA","SAYYID KARAM",1306019,5,8,590,598
"PAKTYA","SAYYID KARAM",1306020,2,0,513,513
"PAKTYA","SAYYID KARAM",1306020,3,0,599,599
"PAKTYA","SAYYID KARAM",1306031,3,0,595,595
"PAKTYA","SAYYID KARAM",1306025,1,12,588,600
"PAKTYA","SAYYID KARAM",1306025,2,1,599,600
"PAKTYA","SAYYID KARAM",1306027,1,102,486,588
"PAKTYA","SAYYID KARAM",1306031,1,1,599,600
"PAKTYA","SAYYID KARAM",1306039,2,0,501,501
"PAKTYA","SAYYID KARAM",1306023,4,18,582,600
"PAKTYA","SAYYID KARAM",1306019,6,0,592,592
"PAKTYA","SAYYID KARAM",1306019,2,10,589,599
"PAKTYA","SAYYID KARAM",1306031,2,0,598,598
"PAKTYA","SAYYID KARAM",1306019,1,12,588,600
"PAKTYA","JAJI ARYOB",1307077,4,122,476,598
"PAKTYA","JAJI ARYOB",1307073,4,18,565,583
"PAKTYA","JAJI ARYOB",1307070,1,0,600,600
"PAKTYA","JAJI ARYOB",1307077,2,9,591,600
"PAKTYA","JAJI ARYOB",1307077,3,30,568,598
"PAKTYA","JAJI ARYOB",1307065,3,200,400,600
"PAKTYA","JAJI ARYOB",1307065,4,502,98,600
"PAKTYA","JAJI ARYOB",1307070,2,0,600,600
"PAKTYA","JAJI ARYOB",1307070,3,0,600,600
"PAKTYA","JAJI ARYOB",1307070,4,0,600,600
"PAKTYA","JAJI ARYOB",1307073,1,65,535,600
"PAKTYA","JAJI ARYOB",1307073,2,0,600,600
"PAKTYA","JAJI ARYOB",1307073,3,73,524,597
"PAKTYA","JAJI ARYOB",1307074,3,6,591,597
"PAKTYA","JAJI ARYOB",1307073,5,7,590,597
"PAKTYA","JAJI ARYOB",1307077,1,122,458,580
"PAKTYA","JAJI ARYOB",1307060,1,166,378,544
"PAKTYA","JAJI ARYOB",1307060,2,403,197,600
"PAKTYA","JAJI ARYOB",1307060,3,250,350,600
"PAKTYA","JAJI ARYOB",1307060,4,249,351,600
"PAKTYA","JAJI ARYOB",1307054,1,83,508,591
"PAKTYA","JAJI ARYOB",1307054,2,16,581,597
"PAKTYA","JAJI ARYOB",1307054,3,11,589,600
"PAKTYA","JAJI ARYOB",1307054,4,21,578,599
"PAKTYA","JAJI ARYOB",1307212,1,0,550,550
"PAKTYA","JAJI ARYOB",1307212,2,483,117,600
"PAKTYA","JAJI ARYOB",1307216,1,0,600,600
"PAKTYA","JAJI ARYOB",1307216,2,0,600,600
"PAKTYA","JAJI ARYOB",1307214,1,6,569,575
"PAKTYA","JAJI ARYOB",1307214,2,0,598,598
"PAKTYA","JAJI ARYOB",1307214,3,0,582,582
"PAKTYA","JAJI ARYOB",1307217,1,107,487,594
"PAKTYA","JAJI ARYOB",1307217,2,129,470,599
"PAKTYA","JAJI ARYOB",1307215,1,39,561,600
"PAKTYA","JAJI ARYOB",1307215,2,39,561,600
"PAKTYA","JAJI ARYOB",1307215,3,130,470,600
"PAKTYA","JAJI ARYOB",1307053,1,15,585,600
"PAKTYA","JAJI ARYOB",1307070,5,0,600,600
"PAKTYA","JAJI ARYOB",1307074,1,7,588,595
"PAKTYA","JAJI ARYOB",1307074,2,10,590,600
"PAKTYA","JAJI ARYOB",1307053,5,27,573,600
"PAKTYA","JAJI ARYOB",1307074,4,6,594,600
"PAKTYA","JAJI ARYOB",1307074,5,13,587,600
"PAKTYA","JAJI ARYOB",1307065,1,2,598,600
"PAKTYA","JAJI ARYOB",1307065,2,200,400,600
"PAKTYA","JAJI ARYOB",1307068,1,154,445,599
"PAKTYA","JAJI ARYOB",1307068,2,281,317,598
"PAKTYA","JAJI ARYOB",1307068,3,126,472,598
"PAKTYA","JAJI ARYOB",1307068,4,129,468,597
"PAKTYA","JAJI ARYOB",1307061,1,30,568,598
"PAKTYA","JAJI ARYOB",1307061,2,167,433,600
"PAKTYA","JAJI ARYOB",1307061,3,1,599,600
"PAKTYA","JAJI ARYOB",1307061,4,2,576,578
"PAKTYA","JAJI ARYOB",1307056,1,0,599,599
"PAKTYA","JAJI ARYOB",1307056,2,0,600,600
"PAKTYA","JAJI ARYOB",1307056,3,168,401,569
"PAKTYA","JAJI ARYOB",1307056,4,0,600,600
"PAKTYA","JAJI ARYOB",1307076,4,0,598,598
"PAKTYA","JAJI ARYOB",1307076,5,3,595,598
"PAKTYA","JAJI ARYOB",1307213,1,12,581,593
"PAKTYA","JAJI ARYOB",1307213,2,6,583,589
"PAKTYA","JAJI ARYOB",1307213,3,8,588,596
"PAKTYA","JAJI ARYOB",1307211,1,6,589,595
"PAKTYA","JAJI ARYOB",1307211,2,101,428,529
"PAKTYA","JAJI ARYOB",1307053,2,66,534,600
"PAKTYA","JAJI ARYOB",1307053,3,31,569,600
"PAKTYA","JAJI ARYOB",1307053,4,13,587,600
"PAKTYA","JAJI ARYOB",1307071,4,55,545,600
"PAKTYA","JAJI ARYOB",1307076,1,8,589,597
"PAKTYA","JAJI ARYOB",1307059,1,448,113,561
"PAKTYA","JAJI ARYOB",1307059,2,400,200,600
"PAKTYA","JAJI ARYOB",1307059,3,378,218,596
"PAKTYA","JAJI ARYOB",1307059,4,247,353,600
"PAKTYA","JAJI ARYOB",1307067,1,5,595,600
"PAKTYA","JAJI ARYOB",1307067,2,0,600,600
"PAKTYA","JAJI ARYOB",1307065,5,400,200,600
"PAKTYA","JAJI ARYOB",1307065,6,501,91,592
"PAKTYA","JAJI ARYOB",1307071,1,1,599,600
"PAKTYA","JAJI ARYOB",1307071,2,21,579,600
"PAKTYA","JAJI ARYOB",1307071,3,82,518,600
"PAKTYA","JAJI ARYOB",1307067,3,5,595,600
"PAKTYA","JAJI ARYOB",1307076,2,4,596,600
"PAKTYA","JAJI ARYOB",1307076,3,2,596,598
"PAKTYA","LAJA AHMAD K",1308142,3,0,600,600
"PAKTYA","LAJA AHMAD K",1308143,2,50,550,600
"PAKTYA","LAJA AHMAD K",1308142,1,200,400,600
"PAKTYA","LAJA AHMAD K",1308143,1,0,600,600
"PAKTYA","LAJA AHMAD K",1308134,2,61,539,600
"PAKTYA","LAJA AHMAD K",1308134,3,0,600,600
"PAKTYA","LAJA AHMAD K",1308142,2,62,538,600
"PAKTYA","LAJA AHMAD K",1308134,1,100,500,600
"PAKTYA","LAJA AHMAD K",1308135,2,0,600,600
"PAKTYA","LAJA AHMAD K",1308137,1,50,550,600
"PAKTYA","LAJA AHMAD K",1308133,2,52,547,599
"PAKTYA","LAJA AHMAD K",1308135,1,0,600,600
"PAKTYA","LAJA AHMAD K",1308138,2,3,597,600
"PAKTYA","LAJA AHMAD K",1308138,3,100,500,600
"PAKTYA","LAJA AHMAD K",1308137,2,50,550,600
"PAKTYA","LAJA AHMAD K",1308138,1,10,590,600
"PAKTYA","LAJA AHMAD K",1308141,1,115,485,600
"PAKTYA","LAJA AHMAD K",1308141,2,25,575,600
"PAKTYA","LAJA AHMAD K",1308220,1,143,439,582
"PAKTYA","LAJA AHMAD K",1308220,2,236,329,565
"PAKTYA","LAJA AHMAD K",1308220,3,132,458,590
"PAKTYA","LAJA AHMAD K",1308136,1,100,500,600
"PAKTYA","LAJA AHMAD K",1308136,2,77,523,600
"PAKTYA","LAJA AHMAD K",1308140,1,61,539,600
"PAKTYA","LAJA AHMAD K",1308140,2,133,467,600
"PAKTYA","LAJA AHMAD K",1308132,1,346,254,600
"PAKTYA","LAJA AHMAD K",1308132,2,108,491,599
"PAKTYA","LAJA AHMAD K",1308139,1,0,600,600
"PAKTYA","LAJA AHMAD K",1308139,2,0,600,600
"PAKTYA","LAJA AHMAD K",1308132,5,221,371,592
"PAKTYA","LAJA AHMAD K",1308219,1,0,600,600
"PAKTYA","LAJA AHMAD K",1308219,2,0,600,600
"PAKTYA","LAJA AHMAD K",1308219,3,300,300,600
"PAKTYA","LAJA AHMAD K",1308133,1,87,512,599
"PAKTYA","LAJA AHMAD K",1308207,2,500,100,600
"PAKTYA","LAJA AHMAD K",1308132,4,182,418,600
"PAKTYA","LAJA AHMAD K",1308207,1,100,500,600
"PAKTYA","LAJA AHMAD K",1308132,3,106,493,599
"PAKTYA","JANI KHEL",1309178,1,16,584,600
"PAKTYA","JANI KHEL",1309178,4,20,580,600
"PAKTYA","JANI KHEL",1309209,1,6,594,600
"PAKTYA","JANI KHEL",1309178,2,11,589,600
"PAKTYA","JANI KHEL",1309178,3,19,581,600
"PAKTYA","JANI KHEL",1309173,5,0,596,596
"PAKTYA","JANI KHEL",1309173,6,2,597,599
"PAKTYA","JANI KHEL",1309172,5,2,556,558
"PAKTYA","JANI KHEL",1309175,1,165,435,600
"PAKTYA","JANI KHEL",1309175,2,245,354,599
"PAKTYA","JANI KHEL",1309171,1,1,599,600
"PAKTYA","JANI KHEL",1309171,2,0,600,600
"PAKTYA","JANI KHEL",1309208,1,74,371,445
"PAKTYA","JANI KHEL",1309209,2,0,600,600
"PAKTYA","JANI KHEL",1309173,1,0,592,592
"PAKTYA","JANI KHEL",1309173,2,0,600,600
"PAKTYA","JANI KHEL",1309173,3,0,598,598
"PAKTYA","JANI KHEL",1309173,4,0,600,600
"PAKTYA","JANI KHEL",1309172,2,13,567,580
"PAKTYA","JANI KHEL",1309172,3,17,512,529
"PAKTYA","JANI KHEL",1309172,4,37,562,599
"PAKTYA","JANI KHEL",1309172,6,0,600,600
"PAKTYA","JANI KHEL",1309177,1,12,588,600
"PAKTYA","JANI KHEL",1309177,2,15,585,600
"PAKTYA","JANI KHEL",1309177,3,16,584,600
"PAKTYA","JANI KHEL",1309174,1,192,408,600
"PAKTYA","JANI KHEL",1309174,2,204,396,600
"PAKTYA","JANI KHEL",1309174,3,192,407,599
"PAKTYA","JANI KHEL",1309170,1,0,600,600
"PAKTYA","JANI KHEL",1309170,2,0,600,600
"PAKTYA","JANI KHEL",1309170,3,134,466,600
"PAKTYA","JANI KHEL",1309172,1,21,576,597
"PAKTYA","JANI KHEL",1309208,2,39,560,599
"PAKTYA","JANI KHEL",1309176,1,50,550,600
"PAKTYA","JANI KHEL",1309176,2,10,590,600
"PAKTYA","SAMKANI",1310160,4,4,590,594
"PAKTYA","SAMKANI",1310160,3,17,582,599
"PAKTYA","SAMKANI",1310166,4,22,578,600
"PAKTYA","SAMKANI",1310166,1,0,600,600
"PAKTYA","SAMKANI",1310160,2,18,576,594
"PAKTYA","SAMKANI",1310166,3,5,591,596
"PAKTYA","SAMKANI",1310168,3,3,596,599
"PAKTYA","SAMKANI",1310168,4,11,588,599
"PAKTYA","SAMKANI",1310166,2,3,595,598
"PAKTYA","SAMKANI",1310168,2,46,552,598
"PAKTYA","SAMKANI",1310163,1,0,594,594
"PAKTYA","SAMKANI",1310163,2,1,597,598
"PAKTYA","SAMKANI",1310160,1,7,589,596
"PAKTYA","SAMKANI",1310161,4,1,598,599
"PAKTYA","SAMKANI",1310165,1,4,585,589
"PAKTYA","SAMKANI",1310165,2,59,541,600
"PAKTYA","SAMKANI",1310163,3,1,595,596
"PAKTYA","SAMKANI",1310163,4,3,596,599
"PAKTYA","SAMKANI",1310156,1,24,571,595
"PAKTYA","SAMKANI",1310156,2,11,587,598
"PAKTYA","SAMKANI",1310156,3,8,586,594
"PAKTYA","SAMKANI",1310156,4,16,582,598
"PAKTYA","SAMKANI",1310156,5,23,572,595
"PAKTYA","SAMKANI",1310158,1,29,571,600
"PAKTYA","SAMKANI",1310158,2,5,589,594
"PAKTYA","SAMKANI",1310158,3,173,427,600
"PAKTYA","SAMKANI",1310158,4,6,594,600
"PAKTYA","SAMKANI",1310162,1,73,521,594
"PAKTYA","SAMKANI",1310162,2,68,511,579
"PAKTYA","SAMKANI",1310165,3,51,542,593
"PAKTYA","SAMKANI",1310165,4,76,522,598
"PAKTYA","SAMKANI",1310168,1,2,598,600
"PAKTYA","SAMKANI",1310157,2,0,600,600
"PAKTYA","SAMKANI",1310157,3,0,600,600
"PAKTYA","SAMKANI",1310157,4,0,599,599
"PAKTYA","SAMKANI",1310159,1,13,587,600
"PAKTYA","SAMKANI",1310159,2,74,525,599
"PAKTYA","SAMKANI",1310159,3,20,570,590
"PAKTYA","SAMKANI",1310159,4,1,597,598
"PAKTYA","SAMKANI",1310169,1,17,583,600
"PAKTYA","SAMKANI",1310169,2,42,557,599
"PAKTYA","SAMKANI",1310169,3,68,532,600
"PAKTYA","SAMKANI",1310169,4,12,588,600
"PAKTYA","SAMKANI",1310167,1,35,565,600
"PAKTYA","SAMKANI",1310167,2,79,515,594
"PAKTYA","SAMKANI",1310167,3,0,599,599
"PAKTYA","SAMKANI",1310167,4,0,594,594
"PAKTYA","SAMKANI",1310161,1,15,581,596
"PAKTYA","SAMKANI",1310161,2,18,582,600
"PAKTYA","SAMKANI",1310161,3,49,520,569
"PAKTYA","SAMKANI",1310157,1,0,600,600
"PAKTYA","SAMKANI",1310162,3,89,504,593
"PAKTYA","SAMKANI",1310162,4,63,531,594
"PAKTYA","DAND PATAN",1311182,3,9,589,598
"PAKTYA","DAND PATAN",1311182,2,7,593,600
"PAKTYA","DAND PATAN",1311221,3,86,508,594
"PAKTYA","DAND PATAN",1311182,4,8,592,600
"PAKTYA","DAND PATAN",1311221,1,47,553,600
"PAKTYA","DAND PATAN",1311221,2,73,526,599
"PAKTYA","DAND PATAN",1311183,2,3,593,596
"PAKTYA","DAND PATAN",1311187,1,0,599,599
"PAKTYA","DAND PATAN",1311187,2,3,595,598
"PAKTYA","DAND PATAN",1311187,3,0,600,600
"PAKTYA","DAND PATAN",1311185,1,7,591,598
"PAKTYA","DAND PATAN",1311185,2,3,595,598
"PAKTYA","DAND PATAN",1311179,1,40,559,599
"PAKTYA","DAND PATAN",1311179,2,11,587,598
"PAKTYA","DAND PATAN",1311179,3,30,569,599
"PAKTYA","DAND PATAN",1311179,4,12,586,598
"PAKTYA","DAND PATAN",1311210,1,5,595,600
"PAKTYA","DAND PATAN",1311210,2,0,600,600
"PAKTYA","DAND PATAN",1311183,1,1,599,600
"PAKTYA","DAND PATAN",1311188,1,0,597,597
"PAKTYA","DAND PATAN",1311188,2,0,599,599
"PAKTYA","DAND PATAN",1311180,1,52,543,595
"PAKTYA","DAND PATAN",1311180,2,21,578,599
"PAKTYA","DAND PATAN",1311180,3,2,588,590
"PAKTYA","DAND PATAN",1311184,1,4,592,596
"PAKTYA","DAND PATAN",1311184,2,15,580,595
"PAKTYA","DAND PATAN",1311181,1,0,600,600
"PAKTYA","DAND PATAN",1311181,2,30,570,600
"PAKTYA","DAND PATAN",1311181,3,6,594,600
"PAKTYA","DAND PATAN",1311181,4,565,34,599
"PAKTYA","DAND PATAN",1311189,1,25,573,598
"PAKTYA","DAND PATAN",1311189,2,3,596,599
"PAKTYA","DAND PATAN",1311189,3,2,595,597
"PAKTYA","DAND PATAN",1311189,4,4,596,600
"PAKTYA","DAND PATAN",1311186,1,0,597,597
"PAKTYA","DAND PATAN",1311186,2,2,594,596
"PAKTYA","DAND PATAN",1311182,1,39,560,599
NA,NA,1312151,1,600,0,600
NA,NA,1312151,2,9,591,600
NA,NA,1312145,1,135,465,600
NA,NA,1312145,2,32,568,600
NA,NA,1312155,1,0,600,600
NA,NA,1312155,2,0,600,600
NA,NA,1312223,1,0,600,600
NA,NA,1312223,2,2,590,592
NA,NA,1312223,3,0,600,600
NA,NA,1312222,1,0,600,600
NA,NA,1312144,2,115,484,599
NA,NA,1312153,3,21,579,600
NA,NA,1312153,4,0,600,600
NA,NA,1312147,1,0,600,600
NA,NA,1312149,2,0,600,600
NA,NA,1312144,3,138,462,600
NA,NA,1312150,3,83,506,589
NA,NA,1312148,1,0,600,600
NA,NA,1312148,2,0,600,600
NA,NA,1312148,3,0,600,600
NA,NA,1312144,1,115,485,600
NA,NA,1312152,1,350,250,600
NA,NA,1312154,1,0,600,600
NA,NA,1312154,2,0,600,600
NA,NA,1312153,2,200,400,600
NA,NA,1312150,2,0,600,600
NA,NA,1312147,2,0,600,600
NA,NA,1312153,1,500,100,600
NA,NA,1312149,1,0,600,600
NA,NA,1312150,1,0,600,600
NA,NA,1312146,2,0,600,600
NA,NA,1312222,3,5,595,600
NA,NA,1312152,2,600,0,600
NA,NA,1312152,5,429,150,579
NA,NA,1312152,4,400,200,600
NA,NA,1312146,1,0,600,600
NA,NA,1312222,2,0,600,600
NA,NA,1312152,3,400,200,600
NA,NA,1313205,2,1,599,600
NA,NA,1313205,3,0,600,600
NA,NA,1313205,4,0,600,600
NA,NA,1313047,1,0,599,599
NA,NA,1313047,2,32,540,572
NA,NA,1313047,3,23,577,600
NA,NA,1313047,4,0,600,600
NA,NA,1313051,1,1,599,600
NA,NA,1313051,2,99,501,600
NA,NA,1313051,3,77,522,599
NA,NA,1313051,4,0,600,600
NA,NA,1313044,3,25,544,569
NA,NA,1313044,4,0,600,600
NA,NA,1313044,5,2,598,600
NA,NA,1313044,6,0,600,600
NA,NA,1313044,7,0,600,600
NA,NA,1313046,1,8,592,600
NA,NA,1313046,2,6,594,600
NA,NA,1313046,5,0,600,600
NA,NA,1313046,6,0,600,600
NA,NA,1313046,3,6,593,599
NA,NA,1313046,4,56,544,600
NA,NA,1313050,1,0,599,599
NA,NA,1313050,2,0,600,600
NA,NA,1313044,2,1,597,598
NA,NA,1313052,1,49,550,599
NA,NA,1313052,2,0,600,600
NA,NA,1313205,1,10,590,600
NA,NA,1313049,1,0,598,598
NA,NA,1313049,2,0,599,599
NA,NA,1313049,3,0,600,600
NA,NA,1313044,1,6,594,600
NA,NA,1313048,1,22,575,597
NA,NA,1313048,2,16,584,600
"KHOST","KHOST",1401044,1,11,580,591
"KHOST","KHOST",1401044,2,14,576,590
"KHOST","KHOST",1401044,3,11,583,594
"KHOST","KHOST",1401044,4,4,595,599
"KHOST","KHOST",1401044,5,2,596,598
"KHOST","KHOST",1401015,1,5,572,577
"KHOST","KHOST",1401015,2,29,554,583
"KHOST","KHOST",1401015,3,6,558,564
"KHOST","KHOST",1401015,4,0,594,594
"KHOST","KHOST",1401015,5,0,595,595
"KHOST","KHOST",1401015,6,1,567,568
"KHOST","KHOST",1401015,7,0,590,590
"KHOST","KHOST",1401018,1,27,573,600
"KHOST","KHOST",1401018,2,13,582,595
"KHOST","KHOST",1401018,3,7,591,598
"KHOST","KHOST",1401018,4,9,568,577
"KHOST","KHOST",1401018,5,46,554,600
"KHOST","KHOST",1401018,6,106,482,588
"KHOST","KHOST",1401018,7,2,598,600
"KHOST","KHOST",1401014,1,23,564,587
"KHOST","KHOST",1401014,2,21,543,564
"KHOST","KHOST",1401014,3,3,587,590
"KHOST","KHOST",1401014,4,6,586,592
"KHOST","KHOST",1401014,5,0,600,600
"KHOST","KHOST",1401013,1,11,577,588
"KHOST","KHOST",1401013,2,6,588,594
"KHOST","KHOST",1401013,3,41,546,587
"KHOST","KHOST",1401013,4,10,578,588
"KHOST","KHOST",1401013,5,15,577,592
"KHOST","KHOST",1401013,6,2,597,599
"KHOST","KHOST",1401001,1,40,558,598
"KHOST","KHOST",1401001,2,0,590,590
"KHOST","KHOST",1401001,3,17,569,586
"KHOST","KHOST",1401001,4,6,594,600
"KHOST","KHOST",1401001,5,9,591,600
"KHOST","KHOST",1401001,6,6,594,600
"KHOST","KHOST",1401003,1,8,585,593
"KHOST","KHOST",1401003,2,7,589,596
"KHOST","KHOST",1401003,3,6,592,598
"KHOST","KHOST",1401003,4,7,590,597
"KHOST","KHOST",1401003,5,1,51,52
"KHOST","KHOST",1401002,1,11,582,593
"KHOST","KHOST",1401002,2,9,591,600
"KHOST","KHOST",1401002,3,97,480,577
"KHOST","KHOST",1401002,4,61,527,588
"KHOST","KHOST",1401002,5,90,500,590
"KHOST","KHOST",1401004,1,4,594,598
"KHOST","KHOST",1401004,2,4,593,597
"KHOST","KHOST",1401004,3,4,397,401
"KHOST","KHOST",1401004,4,12,71,83
"KHOST","KHOST",1401006,1,11,588,599
"KHOST","KHOST",1401006,2,6,588,594
"KHOST","KHOST",1401006,3,6,498,504
"KHOST","KHOST",1401005,1,83,516,599
"KHOST","KHOST",1401005,2,2,598,600
"KHOST","KHOST",1401005,3,1,597,598
"KHOST","KHOST",1401011,1,48,549,597
"KHOST","KHOST",1401011,2,0,585,585
"KHOST","KHOST",1401011,3,15,578,593
"KHOST","KHOST",1401009,1,35,508,543
"KHOST","KHOST",1401009,2,14,521,535
"KHOST","KHOST",1401009,3,10,558,568
"KHOST","KHOST",1401009,4,5,571,576
"KHOST","KHOST",1401008,1,2,548,550
"KHOST","KHOST",1401008,2,14,586,600
"KHOST","KHOST",1401008,3,14,586,600
"KHOST","KHOST",1401008,4,10,576,586
"KHOST","KHOST",1401010,1,7,580,587
"KHOST","KHOST",1401010,2,13,585,598
"KHOST","KHOST",1401010,3,16,564,580
"KHOST","KHOST",1401010,4,6,586,592
"KHOST","KHOST",1401016,3,1,599,600
"KHOST","KHOST",1401016,4,20,580,600
"KHOST","KHOST",1401016,5,77,193,270
"KHOST","KHOST",1401016,6,0,600,600
"KHOST","KHOST",1401021,1,19,580,599
"KHOST","KHOST",1401021,2,16,576,592
"KHOST","KHOST",1401021,3,5,595,600
"KHOST","KHOST",1401021,4,3,558,561
"KHOST","KHOST",1401021,5,7,586,593
"KHOST","KHOST",1401021,6,5,563,568
"KHOST","KHOST",1401025,1,2,531,533
"KHOST","KHOST",1401025,2,4,573,577
"KHOST","KHOST",1401025,3,6,593,599
"KHOST","KHOST",1401025,4,4,472,476
"KHOST","KHOST",1401020,1,28,571,599
"KHOST","KHOST",1401020,2,8,588,596
"KHOST","KHOST",1401020,3,21,573,594
"KHOST","KHOST",1401020,4,23,564,587
"KHOST","KHOST",1401020,5,14,580,594
"KHOST","KHOST",1401020,6,37,558,595
"KHOST","KHOST",1401020,7,9,590,599
"KHOST","KHOST",1401019,1,31,563,594
"KHOST","KHOST",1401019,2,10,577,587
"KHOST","KHOST",1401019,3,1,586,587
"KHOST","KHOST",1401019,4,15,584,599
"KHOST","KHOST",1401019,5,10,589,599
"KHOST","KHOST",1401019,6,2,579,581
"KHOST","KHOST",1401027,1,1,593,594
"KHOST","KHOST",1401027,2,3,591,594
"KHOST","KHOST",1401027,3,10,585,595
"KHOST","KHOST",1401027,4,2,598,600
"KHOST","KHOST",1401024,1,16,524,540
"KHOST","KHOST",1401024,2,52,487,539
"KHOST","KHOST",1401024,3,37,165,202
"KHOST","KHOST",1401026,1,13,573,586
"KHOST","KHOST",1401026,2,6,585,591
"KHOST","KHOST",1401026,3,2,598,600
"KHOST","KHOST",1401030,1,3,590,593
"KHOST","KHOST",1401030,2,3,592,595
"KHOST","KHOST",1401030,3,6,590,596
"KHOST","KHOST",1401030,4,6,509,515
"KHOST","KHOST",1401030,5,5,578,583
"KHOST","KHOST",1401036,1,5,590,595
"KHOST","KHOST",1401036,2,10,585,595
"KHOST","KHOST",1401036,3,19,581,600
"KHOST","KHOST",1401036,4,0,595,595
"KHOST","KHOST",1401031,1,24,576,600
"KHOST","KHOST",1401031,2,14,567,581
"KHOST","KHOST",1401031,3,0,598,598
"KHOST","KHOST",1401028,1,8,586,594
"KHOST","KHOST",1401028,2,5,595,600
"KHOST","KHOST",1401028,3,8,584,592
"KHOST","KHOST",1401028,4,1,599,600
"KHOST","KHOST",1401028,5,0,600,600
"KHOST","KHOST",1401022,1,30,568,598
"KHOST","KHOST",1401022,2,27,568,595
"KHOST","KHOST",1401022,3,19,581,600
"KHOST","KHOST",1401022,4,7,573,580
"KHOST","KHOST",1401022,5,15,585,600
"KHOST","KHOST",1401043,1,16,576,592
"KHOST","KHOST",1401043,2,2,587,589
"KHOST","KHOST",1401043,3,18,565,583
"KHOST","KHOST",1401043,4,3,596,599
"KHOST","KHOST",1401033,1,13,583,596
"KHOST","KHOST",1401033,2,41,553,594
"KHOST","KHOST",1401033,3,9,586,595
"KHOST","KHOST",1401033,4,1,599,600
"KHOST","KHOST",1401032,1,2,595,597
"KHOST","KHOST",1401032,2,11,583,594
"KHOST","KHOST",1401032,3,6,585,591
"KHOST","KHOST",1401032,4,7,554,561
"KHOST","KHOST",1401038,1,17,374,391
"KHOST","KHOST",1401038,2,5,209,214
"KHOST","KHOST",1401038,3,5,145,150
"KHOST","KHOST",1401038,4,17,580,597
"KHOST","KHOST",1401035,1,16,575,591
"KHOST","KHOST",1401035,2,0,583,583
"KHOST","KHOST",1401035,3,4,594,598
"KHOST","KHOST",1401035,4,1,593,594
"KHOST","KHOST",1401162,1,6,562,568
"KHOST","KHOST",1401162,2,3,573,576
"KHOST","KHOST",1401162,3,14,586,600
"KHOST","KHOST",1401162,4,16,571,587
"KHOST","KHOST",1401162,5,1,582,583
"KHOST","KHOST",1401162,6,12,585,597
"KHOST","KHOST",1401162,7,4,596,600
"KHOST","KHOST",1401162,8,6,579,585
"KHOST","KHOST",1401162,9,0,576,576
"KHOST","KHOST",1401162,10,1,580,581
"KHOST","KHOST",1401162,11,1,595,596
"KHOST","KHOST",1401040,1,15,572,587
"KHOST","KHOST",1401040,2,14,578,592
"KHOST","KHOST",1401040,3,6,583,589
"KHOST","KHOST",1401040,4,52,547,599
"KHOST","KHOST",1401039,1,0,600,600
"KHOST","KHOST",1401039,2,8,588,596
"KHOST","KHOST",1401039,3,0,586,586
"KHOST","KHOST",1401041,1,0,599,599
"KHOST","KHOST",1401041,2,11,584,595
"KHOST","KHOST",1401041,3,8,590,598
"KHOST","KHOST",1401041,4,11,589,600
"KHOST","KHOST",1401045,1,2,590,592
"KHOST","KHOST",1401045,2,2,593,595
"KHOST","KHOST",1401045,3,6,590,596
"KHOST","KHOST",1401045,4,1,596,597
"KHOST","KHOST",1401161,1,3,592,595
"KHOST","KHOST",1401161,2,3,589,592
"KHOST","KHOST",1401161,3,7,590,597
"KHOST","KHOST",1401161,4,3,592,595
"KHOST","KHOST",1401161,5,0,596,596
"KHOST","KHOST",1401161,6,1,596,597
"KHOST","KHOST",1401161,7,4,591,595
"KHOST","KHOST",1401042,1,27,566,593
"KHOST","KHOST",1401042,2,16,581,597
"KHOST","KHOST",1401042,3,13,564,577
"KHOST","KHOST",1401042,4,9,588,597
"KHOST","KHOST",1401176,1,13,585,598
"KHOST","KHOST",1401176,2,5,595,600
"KHOST","KHOST",1401176,3,7,591,598
"KHOST","KHOST",1401046,1,16,552,568
"KHOST","KHOST",1401046,2,3,538,541
"KHOST","KHOST",1401046,3,7,561,568
"KHOST","KHOST",1401046,4,5,548,553
"KHOST","KHOST",1401047,1,29,381,410
"KHOST","KHOST",1401047,2,2,517,519
"KHOST","KHOST",1401047,3,18,519,537
"KHOST","KHOST",1401047,4,6,513,519
"KHOST","KHOST",1401007,1,16,580,596
"KHOST","KHOST",1401007,2,10,589,599
"KHOST","KHOST",1401007,3,32,561,593
"KHOST","KHOST",1401007,4,13,582,595
"KHOST","KHOST",1401023,7,9,590,599
"KHOST","KHOST",1401037,1,2,588,590
"KHOST","KHOST",1401037,2,10,568,578
"KHOST","KHOST",1401037,3,15,585,600
"KHOST","KHOST",1401037,4,1,581,582
"KHOST","KHOST",1401034,1,8,589,597
"KHOST","KHOST",1401034,2,17,583,600
"KHOST","KHOST",1401034,3,3,589,592
"KHOST","KHOST",1401034,4,23,482,505
"KHOST","KHOST",1401017,4,14,111,125
"KHOST","KHOST",1401017,5,23,55,78
"KHOST","KHOST",1401017,6,7,33,40
"KHOST","KHOST",1401017,7,2,593,595
"KHOST","KHOST",1401017,8,2,579,581
"KHOST","KHOST",1401012,1,0,581,581
"KHOST","KHOST",1401012,2,2,580,582
"KHOST","KHOST",1401012,3,11,569,580
"KHOST","KHOST",1401029,1,30,560,590
"KHOST","KHOST",1401029,2,60,538,598
"KHOST","KHOST",1401017,1,8,574,582
"KHOST","KHOST",1401017,2,3,577,580
"KHOST","KHOST",1401017,3,3,591,594
"KHOST","KHOST",1401023,2,4,591,595
"KHOST","KHOST",1401023,3,4,594,598
"KHOST","KHOST",1401023,4,3,596,599
"KHOST","KHOST",1401023,5,97,496,593
"KHOST","KHOST",1401023,6,1,596,597
"KHOST","KHOST",1401016,1,7,572,579
"KHOST","KHOST",1401029,3,0,599,599
"KHOST","KHOST",1401029,4,4,594,598
"KHOST","KHOST",1401023,1,0,599,599
"KHOST","KHOST",1401016,2,0,576,576
"KHOST","MANDUZAY",1402088,1,4,585,589
"KHOST","MANDUZAY",1402079,1,20,574,594
"KHOST","MANDUZAY",1402094,2,3,588,591
"KHOST","MANDUZAY",1402079,5,3,584,587
"KHOST","MANDUZAY",1402079,2,6,304,310
"KHOST","MANDUZAY",1402079,3,12,585,597
"KHOST","MANDUZAY",1402079,4,58,441,499
"KHOST","MANDUZAY",1402091,3,2,598,600
"KHOST","MANDUZAY",1402080,2,9,584,593
"KHOST","MANDUZAY",1402088,2,3,583,586
"KHOST","MANDUZAY",1402091,2,4,582,586
"KHOST","MANDUZAY",1402087,1,2,589,591
"KHOST","MANDUZAY",1402087,2,3,583,586
"KHOST","MANDUZAY",1402081,1,5,580,585
"KHOST","MANDUZAY",1402081,2,12,585,597
"KHOST","MANDUZAY",1402081,3,2,593,595
"KHOST","MANDUZAY",1402080,1,8,587,595
"KHOST","MANDUZAY",1402095,3,5,589,594
"KHOST","MANDUZAY",1402178,1,6,589,595
"KHOST","MANDUZAY",1402178,2,2,593,595
"KHOST","MANDUZAY",1402178,3,4,584,588
"KHOST","MANDUZAY",1402089,1,17,581,598
"KHOST","MANDUZAY",1402089,2,11,586,597
"KHOST","MANDUZAY",1402089,3,21,569,590
"KHOST","MANDUZAY",1402094,1,4,591,595
"KHOST","MANDUZAY",1402083,1,3,585,588
"KHOST","MANDUZAY",1402083,2,0,548,548
"KHOST","MANDUZAY",1402083,3,3,510,513
"KHOST","MANDUZAY",1402095,1,3,285,288
"KHOST","MANDUZAY",1402095,2,5,289,294
"KHOST","MANDUZAY",1402093,1,5,588,593
"KHOST","MANDUZAY",1402093,2,3,596,599
"KHOST","MANDUZAY",1402090,1,2,592,594
"KHOST","MANDUZAY",1402090,2,3,589,592
"KHOST","MANDUZAY",1402096,1,4,590,594
"KHOST","MANDUZAY",1402096,2,590,7,597
"KHOST","MANDUZAY",1402085,1,1,579,580
"KHOST","MANDUZAY",1402085,2,6,572,578
"KHOST","MANDUZAY",1402084,1,0,594,594
"KHOST","MANDUZAY",1402084,2,0,597,597
"KHOST","MANDUZAY",1402084,3,1,594,595
"KHOST","MANDUZAY",1402092,1,5,573,578
"KHOST","MANDUZAY",1402092,2,1,597,598
"KHOST","MANDUZAY",1402082,7,2,579,581
"KHOST","MANDUZAY",1402082,8,14,578,592
"KHOST","MANDUZAY",1402091,1,16,567,583
"KHOST","MANDUZAY",1402093,3,1,542,543
"KHOST","MANDUZAY",1402177,1,4,592,596
"KHOST","MANDUZAY",1402090,3,6,594,600
"KHOST","MANDUZAY",1402086,1,11,589,600
"KHOST","MANDUZAY",1402086,2,5,561,566
"KHOST","MANDUZAY",1402082,1,1,589,590
"KHOST","MANDUZAY",1402082,2,4,592,596
"KHOST","MANDUZAY",1402082,3,4,586,590
"KHOST","MANDUZAY",1402082,4,0,580,580
"KHOST","MANDUZAY",1402082,5,1,599,600
"KHOST","MANDUZAY",1402082,6,9,584,593
"KHOST","MANDUZAY",1402179,2,5,454,459
"KHOST","MANDUZAY",1402177,2,1,598,599
"KHOST","MANDUZAY",1402177,3,2,593,595
"KHOST","MANDUZAY",1402179,1,7,584,591
"KHOST","MANDUZAY",1402179,3,0,598,598
"KHOST","GURBUZ",1403153,3,20,570,590
"KHOST","GURBUZ",1403175,2,0,599,599
"KHOST","GURBUZ",1403151,1,16,300,316
"KHOST","GURBUZ",1403175,1,26,570,596
"KHOST","GURBUZ",1403152,2,13,584,597
"KHOST","GURBUZ",1403152,3,9,588,597
"KHOST","GURBUZ",1403174,3,0,600,600
"KHOST","GURBUZ",1403152,1,13,582,595
"KHOST","GURBUZ",1403174,1,8,591,599
"KHOST","GURBUZ",1403174,2,0,599,599
"KHOST","GURBUZ",1403153,2,2,594,596
"KHOST","GURBUZ",1403154,1,6,586,592
"KHOST","GURBUZ",1403154,2,2,588,590
"KHOST","GURBUZ",1403154,3,0,597,597
"KHOST","GURBUZ",1403154,4,0,598,598
"KHOST","GURBUZ",1403148,1,22,572,594
"KHOST","GURBUZ",1403151,2,5,4,9
"KHOST","GURBUZ",1403150,3,10,309,319
"KHOST","GURBUZ",1403150,4,7,498,505
"KHOST","GURBUZ",1403148,2,20,578,598
"KHOST","GURBUZ",1403174,4,0,600,600
"KHOST","GURBUZ",1403174,5,0,600,600
"KHOST","GURBUZ",1403174,6,0,600,600
"KHOST","GURBUZ",1403174,7,0,600,600
"KHOST","GURBUZ",1403153,1,9,586,595
"KHOST","GURBUZ",1403149,1,17,576,593
"KHOST","GURBUZ",1403149,2,25,572,597
"KHOST","GURBUZ",1403149,3,15,583,598
"KHOST","GURBUZ",1403149,4,17,577,594
"KHOST","GURBUZ",1403150,1,6,135,141
"KHOST","GURBUZ",1403150,2,3,149,152
"KHOST","GURBUZ",1403147,3,1,590,591
"KHOST","GURBUZ",1403150,5,7,576,583
"KHOST","GURBUZ",1403147,1,4,593,597
"KHOST","GURBUZ",1403147,2,10,585,595
"KHOST","GURBUZ",1403147,4,4,592,596
"KHOST","GURBUZ",1403147,5,3,593,596
"KHOST","GURBUZ",1403148,5,0,589,589
"KHOST","GURBUZ",1403148,3,10,588,598
"KHOST","GURBUZ",1403148,4,7,590,597
"KHOST","TANAY",1404140,1,30,552,582
"KHOST","TANAY",1404140,2,14,562,576
"KHOST","TANAY",1404145,3,11,584,595
"KHOST","TANAY",1404145,4,13,584,597
"KHOST","TANAY",1404181,1,16,347,363
"KHOST","TANAY",1404145,2,19,580,599
"KHOST","TANAY",1404138,2,12,556,568
"KHOST","TANAY",1404138,3,8,570,578
"KHOST","TANAY",1404138,4,6,572,578
"KHOST","TANAY",1404133,1,35,556,591
"KHOST","TANAY",1404133,2,42,556,598
"KHOST","TANAY",1404133,3,37,551,588
"KHOST","TANAY",1404133,4,2,587,589
"KHOST","TANAY",1404133,5,5,587,592
"KHOST","TANAY",1404144,4,0,587,587
"KHOST","TANAY",1404137,1,1,598,599
"KHOST","TANAY",1404137,2,1,589,590
"KHOST","TANAY",1404140,3,60,449,509
"KHOST","TANAY",1404181,2,8,196,204
"KHOST","TANAY",1404181,3,41,341,382
"KHOST","TANAY",1404146,1,18,582,600
"KHOST","TANAY",1404146,2,13,586,599
"KHOST","TANAY",1404146,3,35,561,596
"KHOST","TANAY",1404146,4,16,574,590
"KHOST","TANAY",1404144,1,13,580,593
"KHOST","TANAY",1404144,2,5,593,598
"KHOST","TANAY",1404144,3,5,592,597
"KHOST","TANAY",1404143,5,4,587,591
"KHOST","TANAY",1404135,2,3,595,598
"KHOST","TANAY",1404135,3,5,593,598
"KHOST","TANAY",1404135,4,4,595,599
"KHOST","TANAY",1404142,1,5,595,600
"KHOST","TANAY",1404142,2,5,592,597
"KHOST","TANAY",1404142,3,4,596,600
"KHOST","TANAY",1404142,4,2,598,600
"KHOST","TANAY",1404142,5,0,600,600
"KHOST","TANAY",1404143,1,18,570,588
"KHOST","TANAY",1404143,2,8,589,597
"KHOST","TANAY",1404143,3,41,555,596
"KHOST","TANAY",1404143,4,0,599,599
"KHOST","TANAY",1404180,3,16,194,210
"KHOST","TANAY",1404145,1,4,595,599
"KHOST","TANAY",1404143,6,0,600,600
"KHOST","TANAY",1404139,1,12,587,599
"KHOST","TANAY",1404141,1,44,554,598
"KHOST","TANAY",1404141,2,18,582,600
"KHOST","TANAY",1404141,3,96,490,586
"KHOST","TANAY",1404141,4,2,597,599
"KHOST","TANAY",1404138,1,13,561,574
"KHOST","TANAY",1404182,2,4,244,248
"KHOST","TANAY",1404182,3,13,587,600
"KHOST","TANAY",1404180,1,15,251,266
"KHOST","TANAY",1404180,2,43,368,411
"KHOST","TANAY",1404136,4,45,322,367
"KHOST","TANAY",1404137,3,4,595,599
"KHOST","TANAY",1404135,1,0,597,597
"KHOST","TANAY",1404137,5,3,596,599
"KHOST","TANAY",1404182,1,9,391,400
"KHOST","TANAY",1404134,2,42,407,449
"KHOST","TANAY",1404137,4,3,594,597
"KHOST","TANAY",1404136,1,4,337,341
"KHOST","TANAY",1404136,2,2,302,304
"KHOST","TANAY",1404136,3,5,291,296
"KHOST","TANAY",1404134,3,23,409,432
"KHOST","TANAY",1404139,3,10,588,598
"KHOST","TANAY",1404139,4,11,585,596
"KHOST","TANAY",1404134,1,46,553,599
"KHOST","TANAY",1404139,2,6,593,599
"KHOST","MUSA KHEL",1405078,2,0,592,592
"KHOST","MUSA KHEL",1405077,5,3,595,598
"KHOST","MUSA KHEL",1405074,1,5,582,587
"KHOST","MUSA KHEL",1405074,2,0,595,595
"KHOST","MUSA KHEL",1405078,3,0,596,596
"KHOST","MUSA KHEL",1405067,3,4,586,590
"KHOST","MUSA KHEL",1405067,4,5,473,478
"KHOST","MUSA KHEL",1405078,1,0,596,596
"KHOST","MUSA KHEL",1405073,3,15,576,591
"KHOST","MUSA KHEL",1405075,1,0,600,600
"KHOST","MUSA KHEL",1405078,4,0,587,587
"KHOST","MUSA KHEL",1405078,5,0,300,300
"KHOST","MUSA KHEL",1405072,1,0,596,596
"KHOST","MUSA KHEL",1405074,3,3,570,573
"KHOST","MUSA KHEL",1405074,4,0,582,582
"KHOST","MUSA KHEL",1405074,5,0,597,597
"KHOST","MUSA KHEL",1405067,1,4,594,598
"KHOST","MUSA KHEL",1405067,2,11,583,594
"KHOST","MUSA KHEL",1405068,2,4,592,596
"KHOST","MUSA KHEL",1405073,1,10,590,600
"KHOST","MUSA KHEL",1405073,2,17,580,597
"KHOST","MUSA KHEL",1405077,2,0,597,597
"KHOST","MUSA KHEL",1405077,3,8,588,596
"KHOST","MUSA KHEL",1405077,4,9,589,598
"KHOST","MUSA KHEL",1405075,2,0,600,600
"KHOST","MUSA KHEL",1405075,3,10,589,599
"KHOST","MUSA KHEL",1405072,2,0,579,579
"KHOST","MUSA KHEL",1405072,3,19,574,593
"KHOST","MUSA KHEL",1405071,1,3,592,595
"KHOST","MUSA KHEL",1405071,2,2,595,597
"KHOST","MUSA KHEL",1405068,1,10,575,585
"KHOST","MUSA KHEL",1405076,1,0,592,592
"KHOST","MUSA KHEL",1405076,2,0,600,600
"KHOST","MUSA KHEL",1405076,3,0,600,600
"KHOST","MUSA KHEL",1405077,1,20,570,590
"KHOST","MUSA KHEL",1405070,1,0,599,599
"KHOST","MUSA KHEL",1405069,1,0,580,580
"KHOST","MUSA KHEL",1405069,2,0,590,590
"KHOST","MUSA KHEL",1405069,3,0,594,594
"KHOST","MUSA KHEL",1405070,2,0,599,599
"KHOST","MUSA KHEL",1405070,3,0,590,590
"KHOST","NADIRSHAH KO",1406124,3,1,159,160
"KHOST","NADIRSHAH KO",1406122,2,1,585,586
"KHOST","NADIRSHAH KO",1406122,3,3,578,581
"KHOST","NADIRSHAH KO",1406126,1,8,580,588
"KHOST","NADIRSHAH KO",1406122,1,5,575,580
"KHOST","NADIRSHAH KO",1406124,1,5,481,486
"KHOST","NADIRSHAH KO",1406124,2,1,430,431
"KHOST","NADIRSHAH KO",1406125,1,8,572,580
"KHOST","NADIRSHAH KO",1406125,2,5,567,572
"KHOST","NADIRSHAH KO",1406126,2,5,591,596
"KHOST","NADIRSHAH KO",1406117,1,20,577,597
"KHOST","NADIRSHAH KO",1406117,2,10,490,500
"KHOST","NADIRSHAH KO",1406122,4,1,564,565
"KHOST","NADIRSHAH KO",1406123,1,6,593,599
"KHOST","NADIRSHAH KO",1406123,2,2,581,583
"KHOST","NADIRSHAH KO",1406123,3,80,500,580
"KHOST","NADIRSHAH KO",1406121,1,10,535,545
"KHOST","NADIRSHAH KO",1406121,2,8,583,591
"KHOST","NADIRSHAH KO",1406118,1,3,584,587
"KHOST","NADIRSHAH KO",1406118,2,2,583,585
"KHOST","NADIRSHAH KO",1406119,2,10,581,591
"KHOST","NADIRSHAH KO",1406120,1,33,545,578
"KHOST","NADIRSHAH KO",1406120,2,4,575,579
"KHOST","NADIRSHAH KO",1406114,1,69,519,588
"KHOST","NADIRSHAH KO",1406125,3,2,442,444
"KHOST","NADIRSHAH KO",1406115,1,1,578,579
"KHOST","NADIRSHAH KO",1406115,2,2,583,585
"KHOST","NADIRSHAH KO",1406113,1,6,583,589
"KHOST","NADIRSHAH KO",1406114,2,1,584,585
"KHOST","NADIRSHAH KO",1406116,1,5,584,589
"KHOST","NADIRSHAH KO",1406116,2,4,592,596
"KHOST","NADIRSHAH KO",1406113,2,2,579,581
"KHOST","NADIRSHAH KO",1406113,3,0,574,574
"KHOST","NADIRSHAH KO",1406119,1,1,589,590
"KHOST","SABARI",1407064,1,7,583,590
"KHOST","SABARI",1407065,3,0,421,421
"KHOST","SABARI",1407065,4,0,519,519
"KHOST","SABARI",1407065,5,2,437,439
"KHOST","SABARI",1407065,7,0,571,571
"KHOST","SABARI",1407065,8,1,588,589
"KHOST","SABARI",1407066,3,10,287,297
"KHOST","SABARI",1407065,6,0,597,597
"KHOST","SABARI",1407066,4,8,252,260
"KHOST","SABARI",1407066,5,6,137,143
"KHOST","SABARI",1407064,3,3,581,584
"KHOST","SABARI",1407064,2,0,597,597
"KHOST","SABARI",1407065,1,3,319,322
"KHOST","SABARI",1407065,2,3,350,353
"KHOST","SABARI",1407064,7,4,506,510
"KHOST","SABARI",1407064,8,10,546,556
"KHOST","SABARI",1407064,9,2,595,597
"KHOST","SABARI",1407066,1,7,413,420
"KHOST","SABARI",1407066,2,24,266,290
"KHOST","SABARI",1407167,5,21,570,591
"KHOST","SABARI",1407064,4,7,579,586
"KHOST","SABARI",1407064,5,17,578,595
"KHOST","SABARI",1407064,6,4,586,590
"KHOST","SABARI",1407066,6,2,112,114
"KHOST","SABARI",1407166,3,3,387,390
"KHOST","SABARI",1407167,1,11,585,596
"KHOST","SABARI",1407167,2,11,589,600
"KHOST","SABARI",1407166,2,8,550,558
"KHOST","SABARI",1407167,4,3,595,598
"KHOST","SABARI",1407066,7,3,97,100
"KHOST","SABARI",1407167,3,25,564,589
"KHOST","SABARI",1407166,1,15,542,557
"KHOST","ALI SHER",1408054,4,1,594,595
"KHOST","ALI SHER",1408054,5,4,596,600
"KHOST","ALI SHER",1408164,1,72,509,581
"KHOST","ALI SHER",1408049,3,2,592,594
"KHOST","ALI SHER",1408049,4,0,597,597
"KHOST","ALI SHER",1408054,6,0,583,583
"KHOST","ALI SHER",1408054,2,0,600,600
"KHOST","ALI SHER",1408054,3,0,600,600
"KHOST","ALI SHER",1408051,5,5,580,585
"KHOST","ALI SHER",1408054,1,14,582,596
"KHOST","ALI SHER",1408052,1,8,193,201
"KHOST","ALI SHER",1408052,2,4,85,89
"KHOST","ALI SHER",1408164,2,30,523,553
"KHOST","ALI SHER",1408051,6,0,587,587
"KHOST","ALI SHER",1408052,5,7,21,28
"KHOST","ALI SHER",1408049,1,27,565,592
"KHOST","ALI SHER",1408049,2,30,549,579
"KHOST","ALI SHER",1408050,2,2,232,234
"KHOST","ALI SHER",1408050,3,0,100,100
"KHOST","ALI SHER",1408050,4,15,48,63
"KHOST","ALI SHER",1408050,5,0,36,36
"KHOST","ALI SHER",1408050,6,4,588,592
"KHOST","ALI SHER",1408163,1,0,173,173
"KHOST","ALI SHER",1408163,2,100,500,600
"KHOST","ALI SHER",1408165,1,0,598,598
"KHOST","ALI SHER",1408052,3,6,350,356
"KHOST","ALI SHER",1408052,4,41,105,146
"KHOST","ALI SHER",1408164,3,28,564,592
"KHOST","ALI SHER",1408164,4,32,487,519
"KHOST","ALI SHER",1408050,1,2,257,259
"KHOST","ALI SHER",1408053,4,0,584,584
"KHOST","ALI SHER",1408053,5,0,585,585
"KHOST","ALI SHER",1408051,1,1,587,588
"KHOST","ALI SHER",1408051,2,17,564,581
"KHOST","ALI SHER",1408051,3,5,589,594
"KHOST","ALI SHER",1408051,4,0,585,585
"KHOST","ALI SHER",1408184,2,8,583,591
"KHOST","ALI SHER",1408184,3,9,590,599
"KHOST","ALI SHER",1408055,2,12,506,518
"KHOST","ALI SHER",1408163,3,97,503,600
"KHOST","ALI SHER",1408053,1,14,560,574
"KHOST","ALI SHER",1408053,2,0,580,580
"KHOST","ALI SHER",1408053,3,10,588,598
"KHOST","ALI SHER",1408165,5,56,541,597
"KHOST","ALI SHER",1408165,6,96,480,576
"KHOST","ALI SHER",1408165,7,47,457,504
"KHOST","ALI SHER",1408183,1,3,178,181
"KHOST","ALI SHER",1408183,2,9,79,88
"KHOST","ALI SHER",1408183,3,23,148,171
"KHOST","ALI SHER",1408184,1,7,587,594
"KHOST","ALI SHER",1408055,1,100,500,600
"KHOST","ALI SHER",1408165,4,196,399,595
"KHOST","ALI SHER",1408163,5,119,357,476
"KHOST","ALI SHER",1408165,2,0,589,589
"KHOST","ALI SHER",1408165,3,0,597,597
"KHOST","ALI SHER",1408048,2,196,402,598
"KHOST","ALI SHER",1408048,3,396,200,596
"KHOST","ALI SHER",1408163,6,0,600,600
"KHOST","ALI SHER",1408048,1,38,562,600
"KHOST","ALI SHER",1408056,2,374,223,597
"KHOST","ALI SHER",1408163,4,0,280,280
"KHOST","ALI SHER",1408048,4,102,498,600
"KHOST","ALI SHER",1408056,1,4,525,529
"KHOST","BAAK",1409061,3,2,573,575
"KHOST","BAAK",1409059,1,12,581,593
"KHOST","BAAK",1409059,2,10,584,594
"KHOST","BAAK",1409057,1,30,569,599
"KHOST","BAAK",1409057,2,28,572,600
"KHOST","BAAK",1409057,3,11,588,599
"KHOST","BAAK",1409057,4,7,591,598
"KHOST","BAAK",1409057,5,52,543,595
"KHOST","BAAK",1409057,6,11,586,597
"KHOST","BAAK",1409057,7,2,598,600
"KHOST","BAAK",1409057,8,13,586,599
"KHOST","BAAK",1409062,1,9,493,502
"KHOST","BAAK",1409062,2,1,484,485
"KHOST","BAAK",1409062,3,15,453,468
"KHOST","BAAK",1409063,5,7,593,600
"KHOST","BAAK",1409063,6,9,589,598
"KHOST","BAAK",1409059,3,12,585,597
"KHOST","BAAK",1409060,1,11,581,592
"KHOST","BAAK",1409060,2,4,593,597
"KHOST","BAAK",1409060,3,6,590,596
"KHOST","BAAK",1409058,1,23,534,557
"KHOST","BAAK",1409058,2,33,550,583
"KHOST","BAAK",1409058,3,12,294,306
"KHOST","BAAK",1409063,1,7,593,600
"KHOST","BAAK",1409063,2,7,593,600
"KHOST","BAAK",1409063,3,22,551,573
"KHOST","BAAK",1409063,4,12,584,596
"KHOST","BAAK",1409061,1,18,580,598
"KHOST","BAAK",1409061,2,12,568,580
"KHOST","QALANDAR",1410112,2,16,580,596
"KHOST","QALANDAR",1410112,1,5,590,595
"KHOST","QALANDAR",1410105,3,10,587,597
"KHOST","QALANDAR",1410111,1,2,597,599
"KHOST","QALANDAR",1410109,3,11,568,579
"KHOST","QALANDAR",1410109,4,0,594,594
"KHOST","QALANDAR",1410109,1,10,565,575
"KHOST","QALANDAR",1410109,2,5,595,600
"KHOST","QALANDAR",1410110,1,8,589,597
"KHOST","QALANDAR",1410110,2,10,585,595
"KHOST","QALANDAR",1410110,3,5,594,599
"KHOST","QALANDAR",1410110,4,5,592,597
"KHOST","QALANDAR",1410106,1,2,592,594
"KHOST","QALANDAR",1410106,2,20,578,598
"KHOST","QALANDAR",1410105,2,1,587,588
"KHOST","QALANDAR",1410105,4,0,598,598
"KHOST","QALANDAR",1410107,2,1,586,587
"KHOST","QALANDAR",1410107,3,5,593,598
"KHOST","QALANDAR",1410111,2,3,578,581
"KHOST","QALANDAR",1410107,1,0,585,585
"KHOST","QALANDAR",1410105,1,0,599,599
"KHOST","QALANDAR",1410108,1,29,557,586
"KHOST","QALANDAR",1410108,3,11,581,592
"KHOST","QALANDAR",1410111,3,1,591,592
"KHOST","QALANDAR",1410108,2,8,580,588
"KHOST","SPERA",1411172,2,8,582,590
"KHOST","SPERA",1411172,1,6,564,570
"KHOST","SPERA",1411129,3,2,545,547
"KHOST","SPERA",1411173,1,6,581,587
"KHOST","SPERA",1411168,1,5,583,588
"KHOST","SPERA",1411168,2,7,558,565
"KHOST","SPERA",1411170,1,4,479,483
"KHOST","SPERA",1411170,2,0,580,580
"KHOST","SPERA",1411171,1,0,375,375
"KHOST","SPERA",1411171,2,3,591,594
"KHOST","SPERA",1411169,2,11,584,595
"KHOST","SPERA",1411129,1,3,593,596
"KHOST","SPERA",1411129,4,3,584,587
"KHOST","SPERA",1411131,1,8,573,581
"KHOST","SPERA",1411131,2,10,579,589
"KHOST","SPERA",1411131,3,20,511,531
"KHOST","SPERA",1411132,1,0,581,581
"KHOST","SPERA",1411132,2,7,593,600
"KHOST","SPERA",1411132,3,6,588,594
"KHOST","SPERA",1411127,5,4,595,599
"KHOST","SPERA",1411127,6,1,594,595
"KHOST","SPERA",1411127,7,4,595,599
"KHOST","SPERA",1411169,1,0,563,563
"KHOST","SPERA",1411130,3,13,400,413
"KHOST","SPERA",1411127,1,8,580,588
"KHOST","SPERA",1411129,2,4,571,575
"KHOST","SPERA",1411127,3,2,596,598
"KHOST","SPERA",1411173,2,10,579,589
"KHOST","SPERA",1411128,4,2,594,596
"KHOST","SPERA",1411127,2,3,589,592
"KHOST","SPERA",1411128,6,1,473,474
"KHOST","SPERA",1411127,4,3,592,595
"KHOST","SPERA",1411130,2,9,583,592
"KHOST","SPERA",1411128,5,3,595,598
"KHOST","SPERA",1411128,1,3,584,587
"KHOST","SPERA",1411130,1,12,578,590
"KHOST","SPERA",1411128,3,0,398,398
"KHOST","SPERA",1411128,2,2,592,594
"KHOST","SHAMUL",1412156,1,19,300,319
"KHOST","SHAMUL",1412156,4,23,173,196
"KHOST","SHAMUL",1412157,1,0,55,55
"KHOST","SHAMUL",1412160,1,4,172,176
"KHOST","SHAMUL",1412156,2,37,326,363
"KHOST","SHAMUL",1412157,2,1,62,63
"KHOST","SHAMUL",1412156,5,18,198,216
"KHOST","SHAMUL",1412155,1,0,566,566
"KHOST","SHAMUL",1412155,2,4,554,558
"KHOST","SHAMUL",1412155,3,6,563,569
"KHOST","SHAMUL",1412155,4,3,555,558
"KHOST","SHAMUL",1412155,5,2,575,577
"KHOST","SHAMUL",1412155,6,6,356,362
"KHOST","SHAMUL",1412160,2,2,130,132
"KHOST","SHAMUL",1412156,3,9,402,411
"KHOST","SHAMUL",1412159,1,3,593,596
"KHOST","SHAMUL",1412159,2,5,594,599
"KHOST","SHAMUL",1412158,1,13,389,402
"KHOST","SHAMUL",1412159,4,0,8,8
"KHOST","SHAMUL",1412159,3,0,7,7
"KHOST","JAJI MAIDAN",1413098,4,2,598,600
"KHOST","JAJI MAIDAN",1413098,5,10,590,600
"KHOST","JAJI MAIDAN",1413098,2,14,586,600
"KHOST","JAJI MAIDAN",1413185,2,94,498,592
"KHOST","JAJI MAIDAN",1413098,3,9,590,599
"KHOST","JAJI MAIDAN",1413104,3,15,582,597
"KHOST","JAJI MAIDAN",1413104,4,1,598,599
"KHOST","JAJI MAIDAN",1413099,2,106,487,593
"KHOST","JAJI MAIDAN",1413099,3,158,442,600
"KHOST","JAJI MAIDAN",1413099,4,59,528,587
"KHOST","JAJI MAIDAN",1413099,5,32,567,599
"KHOST","JAJI MAIDAN",1413098,1,21,577,598
"KHOST","JAJI MAIDAN",1413185,1,74,522,596
"KHOST","JAJI MAIDAN",1413102,1,68,519,587
"KHOST","JAJI MAIDAN",1413102,2,34,556,590
"KHOST","JAJI MAIDAN",1413102,3,31,567,598
"KHOST","JAJI MAIDAN",1413104,5,7,573,580
"KHOST","JAJI MAIDAN",1413186,1,41,556,597
"KHOST","JAJI MAIDAN",1413186,2,44,556,600
"KHOST","JAJI MAIDAN",1413186,3,128,471,599
"KHOST","JAJI MAIDAN",1413099,1,114,477,591
"KHOST","JAJI MAIDAN",1413097,5,143,457,600
"KHOST","JAJI MAIDAN",1413103,1,22,578,600
"KHOST","JAJI MAIDAN",1413103,2,95,505,600
"KHOST","JAJI MAIDAN",1413103,3,38,558,596
"KHOST","JAJI MAIDAN",1413101,5,51,547,598
"KHOST","JAJI MAIDAN",1413104,1,5,589,594
"KHOST","JAJI MAIDAN",1413104,2,16,584,600
"KHOST","JAJI MAIDAN",1413097,3,30,568,598
"KHOST","JAJI MAIDAN",1413185,3,21,577,598
"KHOST","JAJI MAIDAN",1413097,1,20,580,600
"KHOST","JAJI MAIDAN",1413097,2,23,576,599
"KHOST","JAJI MAIDAN",1413101,1,49,551,600
"KHOST","JAJI MAIDAN",1413097,4,69,513,582
"KHOST","JAJI MAIDAN",1413100,4,31,567,598
"KHOST","JAJI MAIDAN",1413100,5,40,559,599
"KHOST","JAJI MAIDAN",1413100,1,64,534,598
"KHOST","JAJI MAIDAN",1413101,2,144,452,596
"KHOST","JAJI MAIDAN",1413101,3,86,514,600
"KHOST","JAJI MAIDAN",1413101,4,87,512,599
"KHOST","JAJI MAIDAN",1413100,2,58,541,599
"KHOST","JAJI MAIDAN",1413100,3,166,429,595
"KHOST","JAJI MAIDAN",1413102,4,68,525,593
"KUNAR","ASAD ABAD",1501001,1,47,547,594
"KUNAR","ASAD ABAD",1501008,5,25,570,595
"KUNAR","ASAD ABAD",1501001,3,13,583,596
"KUNAR","ASAD ABAD",1501008,4,16,579,595
"KUNAR","ASAD ABAD",1501006,5,8,536,544
"KUNAR","ASAD ABAD",1501001,2,21,575,596
"KUNAR","ASAD ABAD",1501009,5,14,580,594
"KUNAR","ASAD ABAD",1501006,2,68,229,297
"KUNAR","ASAD ABAD",1501004,6,42,556,598
"KUNAR","ASAD ABAD",1501005,7,27,548,575
"KUNAR","ASAD ABAD",1501009,4,27,566,593
"KUNAR","ASAD ABAD",1501001,4,19,571,590
"KUNAR","ASAD ABAD",1501001,5,10,587,597
"KUNAR","ASAD ABAD",1501009,3,12,579,591
"KUNAR","ASAD ABAD",1501001,6,24,563,587
"KUNAR","ASAD ABAD",1501006,1,34,265,299
"KUNAR","ASAD ABAD",1501009,2,17,579,596
"KUNAR","ASAD ABAD",1501006,6,11,332,343
"KUNAR","ASAD ABAD",1501010,5,18,582,600
"KUNAR","ASAD ABAD",1501004,5,39,561,600
"KUNAR","ASAD ABAD",1501004,7,4,586,590
"KUNAR","ASAD ABAD",1501004,2,18,580,598
"KUNAR","ASAD ABAD",1501004,3,10,577,587
"KUNAR","ASAD ABAD",1501004,4,25,568,593
"KUNAR","ASAD ABAD",1501009,1,18,578,596
"KUNAR","ASAD ABAD",1501003,2,103,494,597
"KUNAR","ASAD ABAD",1501004,8,8,588,596
"KUNAR","ASAD ABAD",1501004,9,15,578,593
"KUNAR","ASAD ABAD",1501006,4,26,235,261
"KUNAR","ASAD ABAD",1501001,7,5,575,580
"KUNAR","ASAD ABAD",1501005,6,150,450,600
"KUNAR","ASAD ABAD",1501007,1,55,536,591
"KUNAR","ASAD ABAD",1501010,6,124,472,596
"KUNAR","ASAD ABAD",1501008,3,26,568,594
"KUNAR","ASAD ABAD",1501007,3,105,492,597
"KUNAR","ASAD ABAD",1501007,4,31,541,572
"KUNAR","ASAD ABAD",1501006,3,23,568,591
"KUNAR","ASAD ABAD",1501003,1,84,506,590
"KUNAR","ASAD ABAD",1501005,2,57,394,451
"KUNAR","ASAD ABAD",1501003,3,55,540,595
"KUNAR","ASAD ABAD",1501003,4,104,494,598
"KUNAR","ASAD ABAD",1501004,10,47,547,594
"KUNAR","ASAD ABAD",1501008,1,14,580,594
"KUNAR","ASAD ABAD",1501010,4,34,313,347
"KUNAR","ASAD ABAD",1501010,2,59,246,305
"KUNAR","ASAD ABAD",1501007,2,71,521,592
"KUNAR","ASAD ABAD",1501006,7,8,587,595
"KUNAR","ASAD ABAD",1501008,2,16,578,594
"KUNAR","ASAD ABAD",1501004,1,14,584,598
"KUNAR","ASAD ABAD",1501007,5,51,324,375
"KUNAR","ASAD ABAD",1501010,3,33,449,482
"KUNAR","ASAD ABAD",1501002,2,28,497,525
"KUNAR","ASAD ABAD",1501001,8,34,558,592
"KUNAR","ASAD ABAD",1501005,5,66,443,509
"KUNAR","ASAD ABAD",1501003,8,30,557,587
"KUNAR","ASAD ABAD",1501002,4,33,558,591
"KUNAR","ASAD ABAD",1501002,6,45,552,597
"KUNAR","ASAD ABAD",1501003,9,13,567,580
"KUNAR","ASAD ABAD",1501010,1,47,352,399
"KUNAR","ASAD ABAD",1501005,4,64,530,594
"KUNAR","ASAD ABAD",1501009,6,7,588,595
"KUNAR","ASAD ABAD",1501004,11,37,561,598
"KUNAR","ASAD ABAD",1501003,7,32,553,585
"KUNAR","ASAD ABAD",1501005,3,55,400,455
"KUNAR","ASAD ABAD",1501002,1,30,563,593
"KUNAR","ASAD ABAD",1501002,5,17,567,584
"KUNAR","ASAD ABAD",1501005,1,69,513,582
"KUNAR","ASAD ABAD",1501009,7,18,568,586
"KUNAR","ASAD ABAD",1501002,3,19,437,456
"KUNAR","ASAD ABAD",1501003,6,23,558,581
"KUNAR","ASAD ABAD",1501003,5,94,496,590
"KUNAR","MARA WARA",1502048,2,76,306,382
"KUNAR","MARA WARA",1502046,1,44,456,500
"KUNAR","MARA WARA",1502043,2,39,539,578
"KUNAR","MARA WARA",1502046,3,75,488,563
"KUNAR","MARA WARA",1502046,2,73,525,598
"KUNAR","MARA WARA",1502048,1,161,411,572
"KUNAR","MARA WARA",1502043,3,62,454,516
"KUNAR","MARA WARA",1502048,3,35,564,599
"KUNAR","MARA WARA",1502043,4,125,467,592
"KUNAR","MARA WARA",1502043,5,32,497,529
"KUNAR","MARA WARA",1502049,2,76,520,596
"KUNAR","MARA WARA",1502049,4,12,508,520
"KUNAR","MARA WARA",1502049,3,144,452,596
"KUNAR","MARA WARA",1502046,4,79,507,586
"KUNAR","MARA WARA",1502048,4,74,526,600
"KUNAR","MARA WARA",1502043,1,92,497,589
"KUNAR","MARA WARA",1502049,1,97,482,579
"KUNAR","WATAPOOR",1503012,4,34,365,399
"KUNAR","WATAPOOR",1503013,4,19,578,597
"KUNAR","WATAPOOR",1503012,3,34,537,571
"KUNAR","WATAPOOR",1503013,1,28,571,599
"KUNAR","WATAPOOR",1503012,2,19,372,391
"KUNAR","WATAPOOR",1503011,3,134,463,597
"KUNAR","WATAPOOR",1503013,2,6,587,593
"KUNAR","WATAPOOR",1503012,1,59,534,593
"KUNAR","WATAPOOR",1503011,5,62,522,584
"KUNAR","WATAPOOR",1503013,3,66,525,591
"KUNAR","WATAPOOR",1503016,1,41,553,594
"KUNAR","WATAPOOR",1503016,3,49,524,573
"KUNAR","WATAPOOR",1503016,4,48,494,542
"KUNAR","WATAPOOR",1503011,4,9,579,588
"KUNAR","WATAPOOR",1503011,2,142,456,598
"KUNAR","WATAPOOR",1503011,1,95,500,595
"KUNAR","WATAPOOR",1503016,2,128,468,596
"KUNAR","NARANG",1504032,2,153,443,596
"KUNAR","NARANG",1504031,5,77,478,555
"KUNAR","NARANG",1504032,1,64,531,595
"KUNAR","NARANG",1504031,2,53,535,588
"KUNAR","NARANG",1504031,3,32,565,597
"KUNAR","NARANG",1504033,3,7,592,599
"KUNAR","NARANG",1504037,4,129,469,598
"KUNAR","NARANG",1504031,1,8,588,596
"KUNAR","NARANG",1504035,4,13,587,600
"KUNAR","NARANG",1504033,1,53,541,594
"KUNAR","NARANG",1504037,3,50,427,477
"KUNAR","NARANG",1504037,2,35,490,525
"KUNAR","NARANG",1504037,1,44,555,599
"KUNAR","NARANG",1504036,3,10,578,588
"KUNAR","NARANG",1504031,4,21,531,552
"KUNAR","NARANG",1504035,1,35,562,597
"KUNAR","NARANG",1504032,3,100,479,579
"KUNAR","NARANG",1504034,3,15,558,573
"KUNAR","NARANG",1504035,2,43,545,588
"KUNAR","NARANG",1504033,2,22,573,595
"KUNAR","NARANG",1504035,3,34,566,600
"KUNAR","NARANG",1504036,4,22,570,592
"KUNAR","NARANG",1504034,1,15,577,592
"KUNAR","NARANG",1504036,1,30,558,588
"KUNAR","NARANG",1504036,2,3,590,593
"KUNAR","NARANG",1504034,2,43,539,582
"KUNAR","SAR KANI",1505040,3,65,425,490
"KUNAR","SAR KANI",1505038,2,68,262,330
"KUNAR","SAR KANI",1505038,1,13,487,500
"KUNAR","SAR KANI",1505041,4,7,589,596
"KUNAR","SAR KANI",1505038,3,49,377,426
"KUNAR","SAR KANI",1505040,1,81,497,578
"KUNAR","SAR KANI",1505041,3,6,590,596
"KUNAR","SAR KANI",1505038,7,2,572,574
"KUNAR","SAR KANI",1505040,2,83,515,598
"KUNAR","SAR KANI",1505038,4,57,353,410
"KUNAR","SAR KANI",1505039,3,112,397,509
"KUNAR","SAR KANI",1505040,4,32,344,376
"KUNAR","SAR KANI",1505039,4,30,544,574
"KUNAR","SAR KANI",1505039,2,74,484,558
"KUNAR","SAR KANI",1505038,6,30,275,305
"KUNAR","SAR KANI",1505039,1,96,308,404
"KUNAR","SAR KANI",1505041,2,20,575,595
"KUNAR","SAR KANI",1505038,5,95,488,583
"KUNAR","SAR KANI",1505038,8,8,202,210
"KUNAR","SAR KANI",1505041,1,63,420,483
"KUNAR","SHIGAL WA SHI",1506065,7,76,511,587
"KUNAR","SHIGAL WA SHI",1506067,3,89,503,592
"KUNAR","SHIGAL WA SHI",1506065,6,95,496,591
"KUNAR","SHIGAL WA SHI",1506067,4,74,521,595
"KUNAR","SHIGAL WA SHI",1506067,2,133,462,595
"KUNAR","SHIGAL WA SHI",1506064,5,157,442,599
"KUNAR","SHIGAL WA SHI",1506064,1,187,403,590
"KUNAR","SHIGAL WA SHI",1506067,1,120,479,599
"KUNAR","SHIGAL WA SHI",1506064,4,21,579,600
"KUNAR","SHIGAL WA SHI",1506066,1,31,562,593
"KUNAR","SHIGAL WA SHI",1506064,2,12,579,591
"KUNAR","SHIGAL WA SHI",1506063,4,29,571,600
"KUNAR","SHIGAL WA SHI",1506065,4,20,580,600
"KUNAR","SHIGAL WA SHI",1506065,5,25,574,599
"KUNAR","SHIGAL WA SHI",1506066,2,80,516,596
"KUNAR","SHIGAL WA SHI",1506120,1,79,513,592
"KUNAR","SHIGAL WA SHI",1506064,3,20,577,597
"KUNAR","SHIGAL WA SHI",1506120,3,129,469,598
"KUNAR","SHIGAL WA SHI",1506063,6,48,550,598
"KUNAR","SHIGAL WA SHI",1506065,1,40,553,593
"KUNAR","SHIGAL WA SHI",1506063,2,50,495,545
"KUNAR","SHIGAL WA SHI",1506063,5,6,594,600
"KUNAR","SHIGAL WA SHI",1506065,3,22,572,594
"KUNAR","SHIGAL WA SHI",1506067,5,12,584,596
"KUNAR","SHIGAL WA SHI",1506063,3,43,554,597
"KUNAR","SHIGAL WA SHI",1506120,2,98,500,598
"KUNAR","SHIGAL WA SHI",1506065,2,65,512,577
"KUNAR","SHIGAL WA SHI",1506066,3,48,549,597
"KUNAR","SHIGAL WA SHI",1506063,1,26,570,596
"KUNAR","SHIGAL WA SHI",1506066,5,199,399,598
"KUNAR","SHIGAL WA SHI",1506066,4,255,343,598
"KUNAR","DARA-E-PECH",1507021,3,33,559,592
"KUNAR","DARA-E-PECH",1507024,2,27,556,583
"KUNAR","DARA-E-PECH",1507021,1,65,363,428
"KUNAR","DARA-E-PECH",1507027,2,30,331,361
"KUNAR","DARA-E-PECH",1507027,3,61,275,336
"KUNAR","DARA-E-PECH",1507025,1,21,540,561
"KUNAR","DARA-E-PECH",1507024,1,31,555,586
"KUNAR","DARA-E-PECH",1507027,1,10,397,407
"KUNAR","DARA-E-PECH",1507019,1,44,542,586
"KUNAR","DARA-E-PECH",1507018,1,95,503,598
"KUNAR","DARA-E-PECH",1507021,2,94,453,547
"KUNAR","DARA-E-PECH",1507025,2,68,450,518
"KUNAR","DARA-E-PECH",1507028,3,216,383,599
"KUNAR","DARA-E-PECH",1507020,1,89,499,588
"KUNAR","DARA-E-PECH",1507029,3,11,587,598
"KUNAR","DARA-E-PECH",1507018,2,169,418,587
"KUNAR","DARA-E-PECH",1507020,3,76,519,595
"KUNAR","DARA-E-PECH",1507028,2,313,281,594
"KUNAR","DARA-E-PECH",1507019,3,89,505,594
"KUNAR","DARA-E-PECH",1507030,4,91,501,592
"KUNAR","DARA-E-PECH",1507020,2,94,405,499
"KUNAR","DARA-E-PECH",1507025,3,35,553,588
"KUNAR","DARA-E-PECH",1507029,2,61,539,600
"KUNAR","DARA-E-PECH",1507023,2,92,323,415
"KUNAR","DARA-E-PECH",1507023,3,60,250,310
"KUNAR","DARA-E-PECH",1507018,3,122,456,578
"KUNAR","DARA-E-PECH",1507022,2,48,551,599
"KUNAR","DARA-E-PECH",1507026,3,38,561,599
"KUNAR","DARA-E-PECH",1507023,1,49,205,254
"KUNAR","DARA-E-PECH",1507028,1,213,387,600
"KUNAR","DARA-E-PECH",1507030,1,41,268,309
"KUNAR","DARA-E-PECH",1507019,2,34,566,600
"KUNAR","DARA-E-PECH",1507024,3,164,427,591
"KUNAR","DARA-E-PECH",1507022,1,40,560,600
"KUNAR","DARA-E-PECH",1507022,3,117,395,512
"KUNAR","DARA-E-PECH",1507018,4,196,400,596
"KUNAR","DARA-E-PECH",1507029,1,167,428,595
"KUNAR","DARA-E-PECH",1507030,3,252,348,600
"KUNAR","DARA-E-PECH",1507026,1,51,547,598
"KUNAR","DARA-E-PECH",1507030,2,199,395,594
"KUNAR","DARA-E-PECH",1507026,2,78,522,600
"KUNAR","BAR KUNAR",1508060,3,26,145,171
"KUNAR","BAR KUNAR",1508060,1,15,561,576
"KUNAR","BAR KUNAR",1508059,1,86,501,587
"KUNAR","BAR KUNAR",1508060,2,24,336,360
"KUNAR","BAR KUNAR",1508057,2,8,58,66
"KUNAR","BAR KUNAR",1508056,4,106,293,399
"KUNAR","BAR KUNAR",1508056,3,54,529,583
"KUNAR","BAR KUNAR",1508056,2,143,452,595
"KUNAR","BAR KUNAR",1508057,1,15,104,119
"KUNAR","BAR KUNAR",1508061,3,4,7,11
"KUNAR","BAR KUNAR",1508058,2,90,242,332
"KUNAR","BAR KUNAR",1508056,1,160,425,585
"KUNAR","BAR KUNAR",1508061,2,118,331,449
"KUNAR","BAR KUNAR",1508062,4,46,65,111
"KUNAR","BAR KUNAR",1508058,1,93,312,405
"KUNAR","BAR KUNAR",1508061,1,69,332,401
"KUNAR","BAR KUNAR",1508059,3,97,100,197
"KUNAR","BAR KUNAR",1508058,3,93,159,252
"KUNAR","BAR KUNAR",1508062,2,49,286,335
"KUNAR","BAR KUNAR",1508062,1,162,326,488
"KUNAR","BAR KUNAR",1508059,2,103,488,591
"KUNAR","SAWKAI",1509092,5,1,591,592
"KUNAR","SAWKAI",1509090,3,19,253,272
"KUNAR","SAWKAI",1509089,4,91,507,598
"KUNAR","SAWKAI",1509092,3,93,349,442
"KUNAR","SAWKAI",1509092,7,0,440,440
"KUNAR","SAWKAI",1509089,3,92,505,597
"KUNAR","SAWKAI",1509089,2,150,447,597
"KUNAR","SAWKAI",1509092,6,6,309,315
"KUNAR","SAWKAI",1509092,2,43,297,340
"KUNAR","SAWKAI",1509094,1,53,430,483
"KUNAR","SAWKAI",1509092,4,23,577,600
"KUNAR","SAWKAI",1509092,1,34,299,333
"KUNAR","SAWKAI",1509090,1,81,334,415
"KUNAR","SAWKAI",1509095,4,43,260,303
"KUNAR","SAWKAI",1509093,1,47,137,184
"KUNAR","SAWKAI",1509089,1,113,483,596
"KUNAR","SAWKAI",1509095,5,106,389,495
"KUNAR","SAWKAI",1509090,2,53,252,305
"KUNAR","SAWKAI",1509095,2,47,530,577
"KUNAR","SAWKAI",1509094,2,101,491,592
"KUNAR","SAWKAI",1509094,6,14,560,574
"KUNAR","SAWKAI",1509091,5,19,570,589
"KUNAR","SAWKAI",1509091,3,16,579,595
"KUNAR","SAWKAI",1509095,3,42,195,237
"KUNAR","SAWKAI",1509094,3,46,512,558
"KUNAR","SAWKAI",1509094,4,25,574,599
"KUNAR","SAWKAI",1509091,4,37,559,596
"KUNAR","SAWKAI",1509091,2,37,558,595
"KUNAR","SAWKAI",1509095,1,56,535,591
"KUNAR","SAWKAI",1509091,1,47,530,577
"KUNAR","SAWKAI",1509094,7,4,584,588
"KUNAR","SAWKAI",1509093,4,25,73,98
"KUNAR","SAWKAI",1509093,3,89,223,312
"KUNAR","SAWKAI",1509094,5,4,593,597
"KUNAR","SAWKAI",1509093,2,38,128,166
"KUNAR","KHAS KUNAR",1510097,1,32,244,276
"KUNAR","KHAS KUNAR",1510098,3,12,584,596
"KUNAR","KHAS KUNAR",1510122,1,27,563,590
"KUNAR","KHAS KUNAR",1510100,1,73,525,598
"KUNAR","KHAS KUNAR",1510099,1,6,590,596
"KUNAR","KHAS KUNAR",1510122,3,110,368,478
"KUNAR","KHAS KUNAR",1510098,2,36,525,561
"KUNAR","KHAS KUNAR",1510099,3,17,579,596
"KUNAR","KHAS KUNAR",1510096,5,21,568,589
"KUNAR","KHAS KUNAR",1510099,2,7,592,599
"KUNAR","KHAS KUNAR",1510103,1,16,579,595
"KUNAR","KHAS KUNAR",1510098,1,45,546,591
"KUNAR","KHAS KUNAR",1510122,2,61,453,514
"KUNAR","KHAS KUNAR",1510096,6,1,593,594
"KUNAR","KHAS KUNAR",1510121,3,9,586,595
"KUNAR","KHAS KUNAR",1510101,2,48,364,412
"KUNAR","KHAS KUNAR",1510097,3,44,447,491
"KUNAR","KHAS KUNAR",1510100,3,7,565,572
"KUNAR","KHAS KUNAR",1510101,1,49,543,592
"KUNAR","KHAS KUNAR",1510096,2,47,547,594
"KUNAR","KHAS KUNAR",1510097,2,88,452,540
"KUNAR","KHAS KUNAR",1510121,2,43,550,593
"KUNAR","KHAS KUNAR",1510096,4,7,592,599
"KUNAR","KHAS KUNAR",1510102,1,51,539,590
"KUNAR","KHAS KUNAR",1510103,5,21,579,600
"KUNAR","KHAS KUNAR",1510100,2,37,553,590
"KUNAR","KHAS KUNAR",1510097,4,19,390,409
"KUNAR","KHAS KUNAR",1510096,3,33,560,593
"KUNAR","KHAS KUNAR",1510103,10,12,488,500
"KUNAR","KHAS KUNAR",1510103,9,31,565,596
"KUNAR","KHAS KUNAR",1510103,2,18,576,594
"KUNAR","KHAS KUNAR",1510121,1,23,577,600
"KUNAR","KHAS KUNAR",1510103,6,6,588,594
"KUNAR","KHAS KUNAR",1510096,1,30,561,591
"KUNAR","KHAS KUNAR",1510102,4,13,586,599
"KUNAR","KHAS KUNAR",1510102,3,13,587,600
"KUNAR","KHAS KUNAR",1510103,3,76,505,581
"KUNAR","KHAS KUNAR",1510102,2,63,531,594
"KUNAR","KHAS KUNAR",1510103,4,33,554,587
"KUNAR","KHAS KUNAR",1510103,7,13,301,314
"KUNAR","KHAS KUNAR",1510103,8,28,193,221
"KUNAR","GHAZI ABAD",1511118,5,107,103,210
"KUNAR","GHAZI ABAD",1511119,1,46,56,102
"KUNAR","GHAZI ABAD",1511118,4,3,202,205
"KUNAR","GHAZI ABAD",1511118,1,11,107,118
"KUNAR","GHAZI ABAD",1511118,3,28,110,138
"KUNAR","GHAZI ABAD",1511118,2,21,134,155
"KUNAR","GHAZI ABAD",1511117,3,67,271,338
"KUNAR","GHAZI ABAD",1511117,2,76,256,332
"KUNAR","GHAZI ABAD",1511117,1,119,204,323
"KUNAR","DANGAM",1512054,1,3,44,47
"KUNAR","DANGAM",1512054,4,0,352,352
"KUNAR","DANGAM",1512054,2,5,45,50
"KUNAR","DANGAM",1512054,3,11,585,596
"KUNAR","DANGAM",1512052,4,0,590,590
"KUNAR","DANGAM",1512050,5,0,587,587
"KUNAR","DANGAM",1512050,4,0,440,440
"KUNAR","DANGAM",1512052,1,65,532,597
"KUNAR","DANGAM",1512050,1,87,455,542
"KUNAR","DANGAM",1512052,3,18,569,587
"KUNAR","DANGAM",1512050,6,0,597,597
"KUNAR","DANGAM",1512050,2,56,443,499
"KUNAR","DANGAM",1512052,2,38,559,597
"KUNAR","DANGAM",1512050,3,96,504,600
"KUNAR","CHAPA DARA",1513073,3,48,547,595
"KUNAR","CHAPA DARA",1513071,2,62,535,597
"KUNAR","CHAPA DARA",1513082,2,27,125,152
"KUNAR","CHAPA DARA",1513073,4,26,572,598
"KUNAR","CHAPA DARA",1513073,2,39,553,592
"KUNAR","CHAPA DARA",1513082,4,10,588,598
"KUNAR","CHAPA DARA",1513071,1,115,477,592
"KUNAR","CHAPA DARA",1513082,3,5,313,318
"KUNAR","CHAPA DARA",1513071,5,106,484,590
"KUNAR","CHAPA DARA",1513070,5,94,484,578
"KUNAR","CHAPA DARA",1513070,1,26,570,596
"KUNAR","CHAPA DARA",1513082,1,4,593,597
"KUNAR","CHAPA DARA",1513070,4,18,582,600
"KUNAR","CHAPA DARA",1513071,3,145,449,594
"KUNAR","CHAPA DARA",1513073,1,11,586,597
"KUNAR","CHAPA DARA",1513070,2,21,576,597
"KUNAR","CHAPA DARA",1513070,3,22,575,597
"KUNAR","CHAPA DARA",1513071,4,39,556,595
"KUNAR","NOOR GAL",1514083,1,33,456,489
"KUNAR","NOOR GAL",1514085,5,73,419,492
"KUNAR","NOOR GAL",1514085,4,23,495,518
"KUNAR","NOOR GAL",1514086,2,42,444,486
"KUNAR","NOOR GAL",1514088,4,11,426,437
"KUNAR","NOOR GAL",1514086,3,62,256,318
"KUNAR","NOOR GAL",1514083,2,25,435,460
"KUNAR","NOOR GAL",1514085,1,20,88,108
"KUNAR","NOOR GAL",1514088,3,3,504,507
"KUNAR","NOOR GAL",1514088,2,84,463,547
"KUNAR","NOOR GAL",1514085,2,30,469,499
"KUNAR","NOOR GAL",1514087,5,3,580,583
"KUNAR","NOOR GAL",1514088,1,52,490,542
"KUNAR","NOOR GAL",1514084,5,34,167,201
"KUNAR","NOOR GAL",1514085,3,27,104,131
"KUNAR","NOOR GAL",1514083,3,14,353,367
"KUNAR","NOOR GAL",1514086,1,128,308,436
"KUNAR","NOOR GAL",1514083,4,22,235,257
"KUNAR","NOOR GAL",1514084,4,43,192,235
"KUNAR","NOOR GAL",1514087,1,36,180,216
"KUNAR","NOOR GAL",1514087,4,22,559,581
"KUNAR","NOOR GAL",1514084,3,35,101,136
"KUNAR","NOOR GAL",1514087,3,70,184,254
"KUNAR","NOOR GAL",1514087,2,69,147,216
"KUNAR","NOOR GAL",1514084,1,27,79,106
"KUNAR","NOOR GAL",1514084,2,38,172,210
"KUNAR","NOOR GAL",1514086,4,91,499,590
"KUNAR","NARI",1515105,3,82,516,598
"KUNAR","NARI",1515107,2,172,421,593
"KUNAR","NARI",1515107,3,252,334,586
"KUNAR","NARI",1515107,4,190,409,599
"KUNAR","NARI",1515105,4,511,89,600
"KUNAR","NARI",1515105,2,117,483,600
"KUNAR","NARI",1515104,4,196,395,591
"KUNAR","NARI",1515106,3,199,345,544
"KUNAR","NARI",1515106,2,112,486,598
"KUNAR","NARI",1515107,1,194,397,591
"KUNAR","NARI",1515110,2,48,52,100
"KUNAR","NARI",1515108,1,422,174,596
"KUNAR","NARI",1515105,1,118,481,599
"KUNAR","NARI",1515106,4,49,550,599
"KUNAR","NARI",1515104,5,34,566,600
"KUNAR","NARI",1515104,3,107,489,596
"KUNAR","NARI",1515104,2,250,332,582
"KUNAR","NARI",1515108,4,473,112,585
"KUNAR","NARI",1515106,1,90,506,596
"KUNAR","NARI",1515110,1,82,87,169
"KUNAR","NARI",1515110,4,154,114,268
"KUNAR","NARI",1515104,1,160,440,600
"KUNAR","NARI",1515108,2,394,193,587
"KUNAR","NARI",1515105,5,125,475,600
"KUNAR","NARI",1515110,3,42,18,60
"KUNAR","NARI",1515108,3,484,97,581
"NOORISTAN","PAROON",1601006,4,599,1,600
"NOORISTAN","PAROON",1601006,3,513,80,593
"NOORISTAN","PAROON",1601001,3,570,30,600
"NOORISTAN","PAROON",1601003,2,100,500,600
"NOORISTAN","PAROON",1601006,1,460,136,596
"NOORISTAN","PAROON",1601003,1,188,412,600
"NOORISTAN","PAROON",1601006,2,542,56,598
"NOORISTAN","PAROON",1601003,3,100,500,600
"NOORISTAN","PAROON",1601007,1,499,84,583
"NOORISTAN","PAROON",1601001,2,523,71,594
"NOORISTAN","PAROON",1601007,4,384,170,554
"NOORISTAN","PAROON",1601001,4,547,52,599
"NOORISTAN","PAROON",1601009,2,133,466,599
"NOORISTAN","PAROON",1601001,1,525,73,598
"NOORISTAN","PAROON",1601007,5,351,248,599
"NOORISTAN","PAROON",1601007,3,448,150,598
"NOORISTAN","PAROON",1601009,1,250,350,600
"NOORISTAN","PAROON",1601009,3,59,539,598
"NOORISTAN","PAROON",1601005,3,437,163,600
"NOORISTAN","PAROON",1601007,2,484,114,598
"NOORISTAN","PAROON",1601010,2,555,45,600
"NOORISTAN","PAROON",1601005,2,519,79,598
"NOORISTAN","PAROON",1601010,3,553,47,600
"NOORISTAN","PAROON",1601010,1,543,57,600
"NOORISTAN","PAROON",1601005,1,516,83,599
"NOORISTAN","PAROON",1601005,4,454,137,591
"NOORISTAN","WAYGAL",1602032,2,300,293,593
"NOORISTAN","WAYGAL",1602032,1,316,284,600
"NOORISTAN","WAYGAL",1602031,7,349,243,592
"NOORISTAN","WAYGAL",1602076,1,264,336,600
"NOORISTAN","WAYGAL",1602031,6,433,166,599
"NOORISTAN","WAYGAL",1602031,3,551,48,599
"NOORISTAN","WAYGAL",1602031,2,373,226,599
"NOORISTAN","WAYGAL",1602032,4,111,489,600
"NOORISTAN","WAYGAL",1602031,5,427,171,598
"NOORISTAN","WAYGAL",1602031,4,450,149,599
"NOORISTAN","WAYGAL",1602032,3,102,497,599
"NOORISTAN","WAYGAL",1602076,2,304,296,600
"NOORISTAN","WAYGAL",1602032,5,178,422,600
"NOORISTAN","WAYGAL",1602031,1,454,137,591
"NOORISTAN","WAYGAL",1602077,2,321,230,551
"NOORISTAN","WAYGAL",1602077,1,248,246,494
"NOORISTAN","WAYGAL",1602076,3,41,558,599
"NOORISTAN","WAMA",1603041,1,472,128,600
"NOORISTAN","WAMA",1603041,6,473,127,600
"NOORISTAN","WAMA",1603041,2,97,457,554
"NOORISTAN","WAMA",1603045,3,313,284,597
"NOORISTAN","WAMA",1603045,2,518,81,599
"NOORISTAN","WAMA",1603043,2,360,237,597
"NOORISTAN","WAMA",1603043,3,100,500,600
"NOORISTAN","WAMA",1603041,4,400,200,600
"NOORISTAN","WAMA",1603042,3,446,154,600
"NOORISTAN","WAMA",1603045,1,506,94,600
"NOORISTAN","WAMA",1603042,1,526,74,600
"NOORISTAN","WAMA",1603042,2,384,216,600
"NOORISTAN","WAMA",1603040,4,572,25,597
"NOORISTAN","WAMA",1603041,3,482,117,599
"NOORISTAN","WAMA",1603075,2,597,3,600
"NOORISTAN","WAMA",1603075,3,600,0,600
"NOORISTAN","WAMA",1603040,2,354,245,599
"NOORISTAN","WAMA",1603040,5,520,77,597
"NOORISTAN","WAMA",1603043,1,365,235,600
"NOORISTAN","WAMA",1603040,1,499,100,599
"NOORISTAN","WAMA",1603045,5,282,317,599
"NOORISTAN","WAMA",1603044,3,421,175,596
"NOORISTAN","WAMA",1603043,4,293,294,587
"NOORISTAN","WAMA",1603075,1,584,16,600
"NOORISTAN","WAMA",1603044,1,447,153,600
"NOORISTAN","WAMA",1603045,6,538,62,600
"NOORISTAN","WAMA",1603041,7,466,130,596
"NOORISTAN","WAMA",1603045,4,546,54,600
"NOORISTAN","WAMA",1603044,4,566,24,590
"NOORISTAN","WAMA",1603044,2,511,89,600
"NOORISTAN","WAMA",1603040,3,567,33,600
"NOORISTAN","NOOR GRAM",1604013,5,157,204,361
"NOORISTAN","NOOR GRAM",1604012,1,530,70,600
"NOORISTAN","NOOR GRAM",1604011,1,96,167,263
"NOORISTAN","NOOR GRAM",1604013,4,202,212,414
"NOORISTAN","NOOR GRAM",1604017,2,373,227,600
"NOORISTAN","NOOR GRAM",1604011,3,154,147,301
"NOORISTAN","NOOR GRAM",1604018,3,569,30,599
"NOORISTAN","NOOR GRAM",1604018,2,400,200,600
"NOORISTAN","NOOR GRAM",1604013,1,123,138,261
"NOORISTAN","NOOR GRAM",1604016,2,581,19,600
"NOORISTAN","NOOR GRAM",1604016,1,584,16,600
"NOORISTAN","NOOR GRAM",1604011,2,28,89,117
"NOORISTAN","NOOR GRAM",1604017,3,499,100,599
"NOORISTAN","NOOR GRAM",1604017,1,400,200,600
"NOORISTAN","NOOR GRAM",1604018,1,306,293,599
"NOORISTAN","NOOR GRAM",1604016,3,578,22,600
"NOORISTAN","NOOR GRAM",1604012,2,492,107,599
"NOORISTAN","NOOR GRAM",1604012,3,434,166,600
"NOORISTAN","NOOR GRAM",1604013,2,117,138,255
"NOORISTAN","NOOR GRAM",1604013,3,33,185,218
"NOORISTAN","DUAB",1605025,2,350,250,600
"NOORISTAN","DUAB",1605025,1,305,295,600
"NOORISTAN","DUAB",1605020,3,301,299,600
"NOORISTAN","DUAB",1605020,1,300,300,600
"NOORISTAN","DUAB",1605020,2,300,294,594
"NOORISTAN","KAMDESH",1606055,1,456,141,597
"NOORISTAN","KAMDESH",1606074,4,335,264,599
"NOORISTAN","KAMDESH",1606074,5,479,119,598
"NOORISTAN","KAMDESH",1606055,2,282,17,299
"NOORISTAN","KAMDESH",1606074,6,498,100,598
"NOORISTAN","KAMDESH",1606074,2,550,49,599
"NOORISTAN","KAMDESH",1606074,3,444,156,600
"NOORISTAN","KAMDESH",1606073,2,301,246,547
"NOORISTAN","KAMDESH",1606073,3,370,230,600
"NOORISTAN","KAMDESH",1606073,4,19,0,19
"NOORISTAN","KAMDESH",1606074,1,565,32,597
"NOORISTAN","KAMDESH",1606073,1,419,178,597
"NOORISTAN","KAMDESH",1606055,3,466,134,600
"NOORISTAN","KAMDESH",1606055,4,336,264,600
"NOORISTAN","BARG-E-MATAL",1608072,4,500,100,600
"NOORISTAN","BARG-E-MATAL",1608066,2,239,361,600
"NOORISTAN","BARG-E-MATAL",1608066,6,437,163,600
"NOORISTAN","BARG-E-MATAL",1608072,3,499,100,599
"NOORISTAN","BARG-E-MATAL",1608066,1,353,246,599
"NOORISTAN","BARG-E-MATAL",1608070,1,500,100,600
"NOORISTAN","BARG-E-MATAL",1608070,2,500,100,600
"NOORISTAN","BARG-E-MATAL",1608072,2,499,100,599
"NOORISTAN","BARG-E-MATAL",1608072,1,500,100,600
"NOORISTAN","BARG-E-MATAL",1608066,5,398,201,599
"NOORISTAN","BARG-E-MATAL",1608065,3,563,33,596
"NOORISTAN","BARG-E-MATAL",1608070,3,536,50,586
"NOORISTAN","BARG-E-MATAL",1608066,3,293,306,599
"NOORISTAN","BARG-E-MATAL",1608065,6,475,125,600
"NOORISTAN","BARG-E-MATAL",1608071,2,543,57,600
"NOORISTAN","BARG-E-MATAL",1608071,3,337,262,599
"NOORISTAN","BARG-E-MATAL",1608065,5,538,61,599
"NOORISTAN","BARG-E-MATAL",1608071,1,559,41,600
"NOORISTAN","BARG-E-MATAL",1608068,3,500,100,600
"NOORISTAN","BARG-E-MATAL",1608069,2,568,32,600
"NOORISTAN","BARG-E-MATAL",1608065,4,570,25,595
"NOORISTAN","BARG-E-MATAL",1608068,5,500,100,600
"NOORISTAN","BARG-E-MATAL",1608069,1,528,72,600
"NOORISTAN","BARG-E-MATAL",1608068,4,500,100,600
"NOORISTAN","BARG-E-MATAL",1608068,1,500,100,600
"NOORISTAN","BARG-E-MATAL",1608065,1,263,39,302
"NOORISTAN","BARG-E-MATAL",1608065,2,569,30,599
"NOORISTAN","BARG-E-MATAL",1608066,7,315,285,600
"NOORISTAN","BARG-E-MATAL",1608068,2,500,100,600
"BADAKHSHAN","FAIZ ABAD",1701002,1,387,11,398
"BADAKHSHAN","FAIZ ABAD",1701020,1,198,29,227
"BADAKHSHAN","FAIZ ABAD",1701014,3,188,48,236
"BADAKHSHAN","FAIZ ABAD",1701002,2,392,4,396
"BADAKHSHAN","FAIZ ABAD",1701285,1,101,30,131
"BADAKHSHAN","FAIZ ABAD",1701285,3,139,53,192
"BADAKHSHAN","FAIZ ABAD",1701285,2,96,26,122
"BADAKHSHAN","FAIZ ABAD",1701023,2,54,0,54
"BADAKHSHAN","FAIZ ABAD",1701004,2,398,3,401
"BADAKHSHAN","FAIZ ABAD",1701014,1,82,23,105
"BADAKHSHAN","FAIZ ABAD",1701014,2,158,56,214
"BADAKHSHAN","FAIZ ABAD",1701015,4,335,112,447
"BADAKHSHAN","FAIZ ABAD",1701002,3,228,16,244
"BADAKHSHAN","FAIZ ABAD",1701004,3,309,6,315
"BADAKHSHAN","FAIZ ABAD",1701023,1,121,2,123
"BADAKHSHAN","FAIZ ABAD",1701022,2,460,10,470
"BADAKHSHAN","FAIZ ABAD",1701012,4,247,127,374
"BADAKHSHAN","FAIZ ABAD",1701283,2,136,7,143
"BADAKHSHAN","FAIZ ABAD",1701015,3,119,21,140
"BADAKHSHAN","FAIZ ABAD",1701012,2,181,47,228
"BADAKHSHAN","FAIZ ABAD",1701006,1,159,9,168
"BADAKHSHAN","FAIZ ABAD",1701006,2,148,11,159
"BADAKHSHAN","FAIZ ABAD",1701283,3,322,29,351
"BADAKHSHAN","FAIZ ABAD",1701013,2,379,206,585
"BADAKHSHAN","FAIZ ABAD",1701012,3,260,86,346
"BADAKHSHAN","FAIZ ABAD",1701004,1,242,9,251
"BADAKHSHAN","FAIZ ABAD",1701002,4,188,34,222
"BADAKHSHAN","FAIZ ABAD",1701006,3,192,23,215
"BADAKHSHAN","FAIZ ABAD",1701020,2,204,12,216
"BADAKHSHAN","FAIZ ABAD",1701019,1,153,79,232
"BADAKHSHAN","FAIZ ABAD",1701008,4,342,99,441
"BADAKHSHAN","FAIZ ABAD",1701015,2,158,52,210
"BADAKHSHAN","FAIZ ABAD",1701016,5,138,184,322
"BADAKHSHAN","FAIZ ABAD",1701011,5,274,109,383
"BADAKHSHAN","FAIZ ABAD",1701019,2,160,67,227
"BADAKHSHAN","FAIZ ABAD",1701007,1,183,15,198
"BADAKHSHAN","FAIZ ABAD",1701007,2,196,16,212
"BADAKHSHAN","FAIZ ABAD",1701007,3,178,4,182
"BADAKHSHAN","FAIZ ABAD",1701283,1,104,6,110
"BADAKHSHAN","FAIZ ABAD",1701013,4,262,142,404
"BADAKHSHAN","FAIZ ABAD",1701013,5,402,178,580
"BADAKHSHAN","FAIZ ABAD",1701021,1,226,6,232
"BADAKHSHAN","FAIZ ABAD",1701007,4,99,2,101
"BADAKHSHAN","FAIZ ABAD",1701013,1,386,207,593
"BADAKHSHAN","FAIZ ABAD",1701017,2,557,3,560
"BADAKHSHAN","FAIZ ABAD",1701017,3,361,3,364
"BADAKHSHAN","FAIZ ABAD",1701015,1,274,85,359
"BADAKHSHAN","FAIZ ABAD",1701008,3,249,59,308
"BADAKHSHAN","FAIZ ABAD",1701010,4,278,23,301
"BADAKHSHAN","FAIZ ABAD",1701003,1,53,4,57
"BADAKHSHAN","FAIZ ABAD",1701008,5,209,93,302
"BADAKHSHAN","FAIZ ABAD",1701022,1,577,12,589
"BADAKHSHAN","FAIZ ABAD",1701016,1,241,50,291
"BADAKHSHAN","FAIZ ABAD",1701009,1,101,32,133
"BADAKHSHAN","FAIZ ABAD",1701019,3,114,48,162
"BADAKHSHAN","FAIZ ABAD",1701021,2,110,0,110
"BADAKHSHAN","FAIZ ABAD",1701010,5,491,98,589
"BADAKHSHAN","FAIZ ABAD",1701011,6,237,93,330
"BADAKHSHAN","FAIZ ABAD",1701009,2,81,28,109
"BADAKHSHAN","FAIZ ABAD",1701012,1,203,74,277
"BADAKHSHAN","FAIZ ABAD",1701013,3,371,220,591
"BADAKHSHAN","FAIZ ABAD",1701019,5,148,77,225
"BADAKHSHAN","FAIZ ABAD",1701003,4,123,0,123
"BADAKHSHAN","FAIZ ABAD",1701003,2,124,7,131
"BADAKHSHAN","FAIZ ABAD",1701019,4,123,47,170
"BADAKHSHAN","FAIZ ABAD",1701009,4,238,45,283
"BADAKHSHAN","FAIZ ABAD",1701017,1,451,2,453
"BADAKHSHAN","FAIZ ABAD",1701008,6,162,55,217
"BADAKHSHAN","FAIZ ABAD",1701009,3,111,34,145
"BADAKHSHAN","FAIZ ABAD",1701003,3,64,5,69
"BADAKHSHAN","FAIZ ABAD",1701011,3,192,57,249
"BADAKHSHAN","FAIZ ABAD",1701284,3,435,39,474
"BADAKHSHAN","FAIZ ABAD",1701005,3,589,2,591
"BADAKHSHAN","FAIZ ABAD",1701001,1,563,12,575
"BADAKHSHAN","FAIZ ABAD",1701013,6,207,109,316
"BADAKHSHAN","FAIZ ABAD",1701011,4,261,90,351
"BADAKHSHAN","FAIZ ABAD",1701016,2,116,210,326
"BADAKHSHAN","FAIZ ABAD",1701008,1,359,60,419
"BADAKHSHAN","FAIZ ABAD",1701008,2,338,128,466
"BADAKHSHAN","FAIZ ABAD",1701014,4,248,44,292
"BADAKHSHAN","FAIZ ABAD",1701010,2,252,53,305
"BADAKHSHAN","FAIZ ABAD",1701010,3,93,21,114
"BADAKHSHAN","FAIZ ABAD",1701005,2,307,18,325
"BADAKHSHAN","FAIZ ABAD",1701010,1,277,38,315
"BADAKHSHAN","FAIZ ABAD",1701013,7,116,81,197
"BADAKHSHAN","FAIZ ABAD",1701014,5,179,41,220
"BADAKHSHAN","FAIZ ABAD",1701016,3,32,81,113
"BADAKHSHAN","FAIZ ABAD",1701016,4,64,94,158
"BADAKHSHAN","FAIZ ABAD",1701011,2,230,82,312
"BADAKHSHAN","FAIZ ABAD",1701001,2,568,9,577
"BADAKHSHAN","FAIZ ABAD",1701005,1,517,9,526
"BADAKHSHAN","FAIZ ABAD",1701284,2,388,60,448
"BADAKHSHAN","FAIZ ABAD",1701284,1,525,67,592
"BADAKHSHAN","FAIZ ABAD",1701001,4,460,8,468
"BADAKHSHAN","FAIZ ABAD",1701011,1,351,136,487
"BADAKHSHAN","FAIZ ABAD",1701001,3,547,3,550
"BADAKHSHAN","ARGO",1702042,1,151,206,357
"BADAKHSHAN","ARGO",1702044,1,236,59,295
"BADAKHSHAN","ARGO",1702044,4,234,78,312
"BADAKHSHAN","ARGO",1702039,3,110,45,155
"BADAKHSHAN","ARGO",1702288,2,92,23,115
"BADAKHSHAN","ARGO",1702044,2,197,71,268
"BADAKHSHAN","ARGO",1702043,3,36,2,38
"BADAKHSHAN","ARGO",1702057,3,132,121,253
"BADAKHSHAN","ARGO",1702043,1,47,60,107
"BADAKHSHAN","ARGO",1702042,2,146,180,326
"BADAKHSHAN","ARGO",1702039,1,51,70,121
"BADAKHSHAN","ARGO",1702039,2,76,53,129
"BADAKHSHAN","ARGO",1702288,1,93,11,104
"BADAKHSHAN","ARGO",1702043,2,103,102,205
"BADAKHSHAN","ARGO",1702051,2,46,112,158
"BADAKHSHAN","ARGO",1702044,3,180,47,227
"BADAKHSHAN","ARGO",1702040,1,208,385,593
"BADAKHSHAN","ARGO",1702043,4,8,54,62
"BADAKHSHAN","ARGO",1702040,3,361,162,523
"BADAKHSHAN","ARGO",1702051,3,146,169,315
"BADAKHSHAN","ARGO",1702050,3,71,89,160
"BADAKHSHAN","ARGO",1702051,1,121,166,287
"BADAKHSHAN","ARGO",1702059,5,115,25,140
"BADAKHSHAN","ARGO",1702050,2,92,207,299
"BADAKHSHAN","ARGO",1702059,7,508,80,588
"BADAKHSHAN","ARGO",1702040,2,246,347,593
"BADAKHSHAN","ARGO",1702059,9,189,405,594
"BADAKHSHAN","ARGO",1702059,6,115,78,193
"BADAKHSHAN","ARGO",1702060,2,65,444,509
"BADAKHSHAN","ARGO",1702059,8,513,63,576
"BADAKHSHAN","ARGO",1702042,3,94,135,229
"BADAKHSHAN","ARGO",1702050,1,95,146,241
"BADAKHSHAN","ARGO",1702038,1,342,245,587
"BADAKHSHAN","ARGO",1702060,3,155,341,496
"BADAKHSHAN","ARGO",1702057,2,105,188,293
"BADAKHSHAN","ARGO",1702056,3,118,84,202
"BADAKHSHAN","ARGO",1702287,3,68,33,101
"BADAKHSHAN","ARGO",1702289,1,76,246,322
"BADAKHSHAN","ARGO",1702289,2,63,186,249
"BADAKHSHAN","ARGO",1702289,3,77,294,371
"BADAKHSHAN","ARGO",1702060,1,77,253,330
"BADAKHSHAN","ARGO",1702045,2,132,107,239
"BADAKHSHAN","ARGO",1702045,3,129,103,232
"BADAKHSHAN","ARGO",1702061,1,27,193,220
"BADAKHSHAN","ARGO",1702042,4,140,117,257
"BADAKHSHAN","ARGO",1702041,1,98,278,376
"BADAKHSHAN","ARGO",1702038,2,228,358,586
"BADAKHSHAN","ARGO",1702038,4,96,115,211
"BADAKHSHAN","ARGO",1702057,1,137,49,186
"BADAKHSHAN","ARGO",1702049,3,158,56,214
"BADAKHSHAN","ARGO",1702286,3,73,327,400
"BADAKHSHAN","ARGO",1702287,1,25,59,84
"BADAKHSHAN","ARGO",1702056,4,231,343,574
"BADAKHSHAN","ARGO",1702045,1,149,74,223
"BADAKHSHAN","ARGO",1702055,3,528,56,584
"BADAKHSHAN","ARGO",1702048,1,304,131,435
"BADAKHSHAN","ARGO",1702047,1,384,214,598
"BADAKHSHAN","ARGO",1702290,1,403,145,548
"BADAKHSHAN","ARGO",1702288,3,441,24,465
"BADAKHSHAN","ARGO",1702059,1,183,82,265
"BADAKHSHAN","ARGO",1702038,3,154,186,340
"BADAKHSHAN","ARGO",1702059,3,349,34,383
"BADAKHSHAN","ARGO",1702059,4,242,28,270
"BADAKHSHAN","ARGO",1702046,2,165,16,181
"BADAKHSHAN","ARGO",1702046,3,78,22,100
"BADAKHSHAN","ARGO",1702055,1,581,14,595
"BADAKHSHAN","ARGO",1702287,2,17,30,47
"BADAKHSHAN","ARGO",1702055,2,546,49,595
"BADAKHSHAN","ARGO",1702056,1,124,169,293
"BADAKHSHAN","ARGO",1702048,2,109,98,207
"BADAKHSHAN","ARGO",1702052,1,256,29,285
"BADAKHSHAN","ARGO",1702039,4,192,185,377
"BADAKHSHAN","ARGO",1702049,2,137,34,171
"BADAKHSHAN","ARGO",1702059,2,469,39,508
"BADAKHSHAN","ARGO",1702056,2,100,150,250
"BADAKHSHAN","ARGO",1702286,2,148,413,561
"BADAKHSHAN","ARGO",1702047,2,383,216,599
"BADAKHSHAN","ARGO",1702290,3,454,111,565
"BADAKHSHAN","ARGO",1702046,1,150,36,186
"BADAKHSHAN","ARGO",1702048,3,236,71,307
"BADAKHSHAN","ARGO",1702041,5,94,172,266
"BADAKHSHAN","ARGO",1702047,3,280,57,337
"BADAKHSHAN","ARGO",1702041,2,68,246,314
"BADAKHSHAN","ARGO",1702041,4,117,261,378
"BADAKHSHAN","ARGO",1702061,3,11,66,77
"BADAKHSHAN","ARGO",1702290,2,394,185,579
"BADAKHSHAN","ARGO",1702052,2,149,5,154
"BADAKHSHAN","ARGO",1702061,2,34,106,140
"BADAKHSHAN","ARGO",1702052,3,499,19,518
"BADAKHSHAN","ARGO",1702286,1,113,278,391
"BADAKHSHAN","ARGO",1702041,3,60,174,234
"BADAKHSHAN","ARGO",1702049,1,116,23,139
"BADAKHSHAN","ARGHANJ KHWA",1703223,1,191,0,191
"BADAKHSHAN","ARGHANJ KHWA",1703223,3,129,4,133
"BADAKHSHAN","ARGHANJ KHWA",1703225,2,39,6,45
"BADAKHSHAN","ARGHANJ KHWA",1703223,2,108,2,110
"BADAKHSHAN","ARGHANJ KHWA",1703225,1,138,26,164
"BADAKHSHAN","ARGHANJ KHWA",1703224,4,275,0,275
"BADAKHSHAN","ARGHANJ KHWA",1703222,2,226,4,230
"BADAKHSHAN","ARGHANJ KHWA",1703226,1,149,78,227
"BADAKHSHAN","ARGHANJ KHWA",1703224,3,263,0,263
"BADAKHSHAN","ARGHANJ KHWA",1703222,3,208,0,208
"BADAKHSHAN","ARGHANJ KHWA",1703224,2,452,11,463
"BADAKHSHAN","ARGHANJ KHWA",1703222,1,427,1,428
"BADAKHSHAN","ARGHANJ KHWA",1703226,2,49,4,53
"BADAKHSHAN","ARGHANJ KHWA",1703224,1,479,11,490
"BADAKHSHAN","YAFTAL-E-SUFLA",1704025,3,232,18,250
"BADAKHSHAN","YAFTAL-E-SUFLA",1704024,3,514,16,530
"BADAKHSHAN","YAFTAL-E-SUFLA",1704025,2,263,7,270
"BADAKHSHAN","YAFTAL-E-SUFLA",1704036,3,517,77,594
"BADAKHSHAN","YAFTAL-E-SUFLA",1704025,1,360,14,374
"BADAKHSHAN","YAFTAL-E-SUFLA",1704026,2,177,296,473
"BADAKHSHAN","YAFTAL-E-SUFLA",1704024,4,372,127,499
"BADAKHSHAN","YAFTAL-E-SUFLA",1704032,2,69,48,117
"BADAKHSHAN","YAFTAL-E-SUFLA",1704025,4,430,8,438
"BADAKHSHAN","YAFTAL-E-SUFLA",1704024,1,490,94,584
"BADAKHSHAN","YAFTAL-E-SUFLA",1704026,3,91,120,211
"BADAKHSHAN","YAFTAL-E-SUFLA",1704037,3,498,1,499
"BADAKHSHAN","YAFTAL-E-SUFLA",1704035,1,482,68,550
"BADAKHSHAN","YAFTAL-E-SUFLA",1704032,3,150,98,248
"BADAKHSHAN","YAFTAL-E-SUFLA",1704024,2,561,39,600
"BADAKHSHAN","YAFTAL-E-SUFLA",1704035,3,346,126,472
"BADAKHSHAN","YAFTAL-E-SUFLA",1704032,1,111,48,159
"BADAKHSHAN","YAFTAL-E-SUFLA",1704028,3,537,57,594
"BADAKHSHAN","YAFTAL-E-SUFLA",1704037,2,408,16,424
"BADAKHSHAN","YAFTAL-E-SUFLA",1704292,1,560,31,591
"BADAKHSHAN","YAFTAL-E-SUFLA",1704027,2,118,205,323
"BADAKHSHAN","YAFTAL-E-SUFLA",1704027,3,242,353,595
"BADAKHSHAN","YAFTAL-E-SUFLA",1704035,2,391,89,480
"BADAKHSHAN","YAFTAL-E-SUFLA",1704026,1,115,223,338
"BADAKHSHAN","YAFTAL-E-SUFLA",1704034,3,589,6,595
"BADAKHSHAN","YAFTAL-E-SUFLA",1704026,4,166,283,449
"BADAKHSHAN","YAFTAL-E-SUFLA",1704293,1,572,20,592
"BADAKHSHAN","YAFTAL-E-SUFLA",1704036,2,512,82,594
"BADAKHSHAN","YAFTAL-E-SUFLA",1704031,3,113,0,113
"BADAKHSHAN","YAFTAL-E-SUFLA",1704033,1,546,4,550
"BADAKHSHAN","YAFTAL-E-SUFLA",1704028,2,533,52,585
"BADAKHSHAN","YAFTAL-E-SUFLA",1704292,3,463,113,576
"BADAKHSHAN","YAFTAL-E-SUFLA",1704293,2,572,26,598
"BADAKHSHAN","YAFTAL-E-SUFLA",1704291,3,598,0,598
"BADAKHSHAN","YAFTAL-E-SUFLA",1704292,2,519,78,597
"BADAKHSHAN","YAFTAL-E-SUFLA",1704029,3,598,1,599
"BADAKHSHAN","YAFTAL-E-SUFLA",1704037,1,474,11,485
"BADAKHSHAN","YAFTAL-E-SUFLA",1704031,2,134,2,136
"BADAKHSHAN","YAFTAL-E-SUFLA",1704031,1,429,3,432
"BADAKHSHAN","YAFTAL-E-SUFLA",1704024,5,235,76,311
"BADAKHSHAN","YAFTAL-E-SUFLA",1704036,1,464,131,595
"BADAKHSHAN","YAFTAL-E-SUFLA",1704034,1,593,4,597
"BADAKHSHAN","YAFTAL-E-SUFLA",1704034,2,579,16,595
"BADAKHSHAN","YAFTAL-E-SUFLA",1704291,2,586,10,596
"BADAKHSHAN","YAFTAL-E-SUFLA",1704027,1,170,231,401
"BADAKHSHAN","YAFTAL-E-SUFLA",1704028,1,517,78,595
"BADAKHSHAN","YAFTAL-E-SUFLA",1704291,1,579,15,594
"BADAKHSHAN","YAFTAL-E-SUFLA",1704030,2,598,1,599
"BADAKHSHAN","YAFTAL-E-SUFLA",1704029,1,483,62,545
"BADAKHSHAN","YAFTAL-E-SUFLA",1704033,3,505,4,509
"BADAKHSHAN","YAFTAL-E-SUFLA",1704029,2,592,7,599
"BADAKHSHAN","YAFTAL-E-SUFLA",1704033,2,580,15,595
"BADAKHSHAN","YAFTAL-E-SUFLA",1704293,3,547,34,581
"BADAKHSHAN","YAFTAL-E-SUFLA",1704030,1,499,24,523
"BADAKHSHAN","YAFTAL-E-SUFLA",1704033,4,596,4,600
"BADAKHSHAN","KHASH",1705077,4,184,16,200
"BADAKHSHAN","KHASH",1705074,2,395,44,439
"BADAKHSHAN","KHASH",1705077,3,177,26,203
"BADAKHSHAN","KHASH",1705073,4,90,64,154
"BADAKHSHAN","KHASH",1705074,1,397,40,437
"BADAKHSHAN","KHASH",1705073,3,140,65,205
"BADAKHSHAN","KHASH",1705075,4,506,81,587
"BADAKHSHAN","KHASH",1705073,2,102,45,147
"BADAKHSHAN","KHASH",1705075,2,542,50,592
"BADAKHSHAN","KHASH",1705076,4,109,56,165
"BADAKHSHAN","KHASH",1705076,5,126,31,157
"BADAKHSHAN","KHASH",1705073,1,103,35,138
"BADAKHSHAN","KHASH",1705078,2,110,29,139
"BADAKHSHAN","KHASH",1705078,3,46,23,69
"BADAKHSHAN","KHASH",1705074,3,248,49,297
"BADAKHSHAN","KHASH",1705077,1,249,62,311
"BADAKHSHAN","KHASH",1705078,1,103,20,123
"BADAKHSHAN","KHASH",1705077,2,188,30,218
"BADAKHSHAN","KHASH",1705075,1,571,27,598
"BADAKHSHAN","KHASH",1705078,4,47,28,75
"BADAKHSHAN","KHASH",1705075,3,421,151,572
"BADAKHSHAN","KHASH",1705076,1,101,41,142
"BADAKHSHAN","KHASH",1705076,3,36,25,61
"BADAKHSHAN","KHASH",1705076,2,138,64,202
"BADAKHSHAN","KHASH",1705074,4,438,71,509
"BADAKHSHAN","BAHARAK",1706103,1,226,17,243
"BADAKHSHAN","BAHARAK",1706105,1,331,69,400
"BADAKHSHAN","BAHARAK",1706110,2,454,137,591
"BADAKHSHAN","BAHARAK",1706108,2,188,9,197
"BADAKHSHAN","BAHARAK",1706102,1,367,43,410
"BADAKHSHAN","BAHARAK",1706105,2,290,41,331
"BADAKHSHAN","BAHARAK",1706103,2,272,16,288
"BADAKHSHAN","BAHARAK",1706111,2,201,41,242
"BADAKHSHAN","BAHARAK",1706108,1,277,25,302
"BADAKHSHAN","BAHARAK",1706107,1,273,211,484
"BADAKHSHAN","BAHARAK",1706107,2,136,129,265
"BADAKHSHAN","BAHARAK",1706102,4,504,32,536
"BADAKHSHAN","BAHARAK",1706106,1,299,59,358
"BADAKHSHAN","BAHARAK",1706111,1,354,90,444
"BADAKHSHAN","BAHARAK",1706102,2,228,32,260
"BADAKHSHAN","BAHARAK",1706103,3,343,12,355
"BADAKHSHAN","BAHARAK",1706106,2,173,28,201
"BADAKHSHAN","BAHARAK",1706110,1,530,67,597
"BADAKHSHAN","BAHARAK",1706104,2,240,93,333
"BADAKHSHAN","BAHARAK",1706102,3,210,33,243
"BADAKHSHAN","BAHARAK",1706109,1,272,13,285
"BADAKHSHAN","BAHARAK",1706104,1,390,167,557
"BADAKHSHAN","BAHARAK",1706109,2,103,31,134
"BADAKHSHAN","DARAYIM",1707295,3,179,119,298
"BADAKHSHAN","DARAYIM",1707066,1,586,7,593
"BADAKHSHAN","DARAYIM",1707295,2,51,48,99
"BADAKHSHAN","DARAYIM",1707063,2,400,50,450
"BADAKHSHAN","DARAYIM",1707294,1,584,13,597
"BADAKHSHAN","DARAYIM",1707067,2,566,4,570
"BADAKHSHAN","DARAYIM",1707065,1,85,248,333
"BADAKHSHAN","DARAYIM",1707065,2,110,233,343
"BADAKHSHAN","DARAYIM",1707065,3,154,352,506
"BADAKHSHAN","DARAYIM",1707066,2,596,4,600
"BADAKHSHAN","DARAYIM",1707070,2,580,12,592
"BADAKHSHAN","DARAYIM",1707070,3,579,18,597
"BADAKHSHAN","DARAYIM",1707063,1,283,20,303
"BADAKHSHAN","DARAYIM",1707072,3,469,128,597
"BADAKHSHAN","DARAYIM",1707295,1,63,114,177
"BADAKHSHAN","DARAYIM",1707063,3,184,23,207
"BADAKHSHAN","DARAYIM",1707070,4,575,14,589
"BADAKHSHAN","DARAYIM",1707063,4,574,24,598
"BADAKHSHAN","DARAYIM",1707072,2,443,140,583
"BADAKHSHAN","DARAYIM",1707067,1,480,88,568
"BADAKHSHAN","DARAYIM",1707069,1,524,74,598
"BADAKHSHAN","DARAYIM",1707064,5,322,160,482
"BADAKHSHAN","DARAYIM",1707068,1,594,5,599
"BADAKHSHAN","DARAYIM",1707068,3,599,1,600
"BADAKHSHAN","DARAYIM",1707070,1,581,18,599
"BADAKHSHAN","DARAYIM",1707064,4,307,200,507
"BADAKHSHAN","DARAYIM",1707069,3,541,9,550
"BADAKHSHAN","DARAYIM",1707071,1,587,8,595
"BADAKHSHAN","DARAYIM",1707064,3,254,156,410
"BADAKHSHAN","DARAYIM",1707069,2,493,94,587
"BADAKHSHAN","DARAYIM",1707062,3,581,17,598
"BADAKHSHAN","DARAYIM",1707068,2,596,4,600
"BADAKHSHAN","DARAYIM",1707072,1,374,222,596
"BADAKHSHAN","DARAYIM",1707062,2,573,20,593
"BADAKHSHAN","DARAYIM",1707294,2,593,4,597
"BADAKHSHAN","DARAYIM",1707069,4,574,20,594
"BADAKHSHAN","DARAYIM",1707064,1,150,162,312
"BADAKHSHAN","DARAYIM",1707064,2,174,219,393
"BADAKHSHAN","DARAYIM",1707294,3,599,1,600
"BADAKHSHAN","DARAYIM",1707062,4,595,3,598
"BADAKHSHAN","DARAYIM",1707071,2,590,7,597
"BADAKHSHAN","DARAYIM",1707071,3,596,2,598
"BADAKHSHAN","DARAYIM",1707062,1,565,32,597
"BADAKHSHAN","KOHISTAN",1708120,2,507,36,543
"BADAKHSHAN","KOHISTAN",1708296,1,279,19,298
"BADAKHSHAN","KOHISTAN",1708122,2,486,96,582
"BADAKHSHAN","KOHISTAN",1708125,2,144,8,152
"BADAKHSHAN","KOHISTAN",1708120,3,546,52,598
"BADAKHSHAN","KOHISTAN",1708123,2,589,8,597
"BADAKHSHAN","KOHISTAN",1708126,1,465,135,600
"BADAKHSHAN","KOHISTAN",1708296,2,534,51,585
"BADAKHSHAN","KOHISTAN",1708125,1,146,48,194
"BADAKHSHAN","KOHISTAN",1708122,1,517,76,593
"BADAKHSHAN","KOHISTAN",1708126,2,373,223,596
"BADAKHSHAN","KOHISTAN",1708120,1,377,50,427
"BADAKHSHAN","KOHISTAN",1708123,1,581,16,597
"BADAKHSHAN","KOHISTAN",1708296,3,567,9,576
"BADAKHSHAN","KOHISTAN",1708121,2,519,76,595
"BADAKHSHAN","KOHISTAN",1708121,1,535,59,594
"BADAKHSHAN","YAWAN",1709128,2,550,50,600
"BADAKHSHAN","YAWAN",1709297,3,111,255,366
"BADAKHSHAN","YAWAN",1709298,1,178,63,241
"BADAKHSHAN","YAWAN",1709297,2,75,333,408
"BADAKHSHAN","YAWAN",1709128,1,546,43,589
"BADAKHSHAN","YAWAN",1709134,3,558,28,586
"BADAKHSHAN","YAWAN",1709297,1,270,119,389
"BADAKHSHAN","YAWAN",1709130,1,527,70,597
"BADAKHSHAN","YAWAN",1709130,2,566,30,596
"BADAKHSHAN","YAWAN",1709129,3,407,6,413
"BADAKHSHAN","YAWAN",1709299,1,535,62,597
"BADAKHSHAN","YAWAN",1709129,1,384,20,404
"BADAKHSHAN","YAWAN",1709129,2,372,43,415
"BADAKHSHAN","YAWAN",1709130,3,592,3,595
"BADAKHSHAN","YAWAN",1709127,1,466,64,530
"BADAKHSHAN","YAWAN",1709134,2,537,51,588
"BADAKHSHAN","YAWAN",1709299,2,465,129,594
"BADAKHSHAN","YAWAN",1709133,2,73,65,138
"BADAKHSHAN","YAWAN",1709298,2,150,97,247
"BADAKHSHAN","YAWAN",1709136,2,559,40,599
"BADAKHSHAN","YAWAN",1709136,1,550,48,598
"BADAKHSHAN","YAWAN",1709127,2,473,49,522
"BADAKHSHAN","YAWAN",1709299,3,575,25,600
"BADAKHSHAN","YAWAN",1709133,1,205,58,263
"BADAKHSHAN","YAWAN",1709132,2,589,8,597
"BADAKHSHAN","YAWAN",1709131,2,179,103,282
"BADAKHSHAN","YAWAN",1709135,1,475,119,594
"BADAKHSHAN","YAWAN",1709132,1,590,6,596
"BADAKHSHAN","YAWAN",1709131,1,485,33,518
"BADAKHSHAN","YAWAN",1709134,1,384,113,497
"BADAKHSHAN","YAWAN",1709298,3,212,171,383
"BADAKHSHAN","YAWAN",1709135,2,408,40,448
"BADAKHSHAN","JURM",1710079,2,190,75,265
"BADAKHSHAN","JURM",1710089,1,86,12,98
"BADAKHSHAN","JURM",1710089,2,115,2,117
"BADAKHSHAN","JURM",1710084,3,43,3,46
"BADAKHSHAN","JURM",1710088,1,149,44,193
"BADAKHSHAN","JURM",1710084,4,20,16,36
"BADAKHSHAN","JURM",1710082,1,71,133,204
"BADAKHSHAN","JURM",1710084,1,59,7,66
"BADAKHSHAN","JURM",1710088,2,165,49,214
"BADAKHSHAN","JURM",1710079,4,188,53,241
"BADAKHSHAN","JURM",1710079,1,203,78,281
"BADAKHSHAN","JURM",1710082,2,62,152,214
"BADAKHSHAN","JURM",1710082,3,68,171,239
"BADAKHSHAN","JURM",1710084,2,80,10,90
"BADAKHSHAN","JURM",1710079,3,255,51,306
"BADAKHSHAN","TASHKAN",1711184,1,562,34,596
"BADAKHSHAN","TASHKAN",1711178,1,511,89,600
"BADAKHSHAN","TASHKAN",1711181,1,572,27,599
"BADAKHSHAN","TASHKAN",1711181,2,532,41,573
"BADAKHSHAN","TASHKAN",1711179,2,578,19,597
"BADAKHSHAN","TASHKAN",1711179,1,587,10,597
"BADAKHSHAN","TASHKAN",1711187,2,344,256,600
"BADAKHSHAN","TASHKAN",1711180,2,600,0,600
"BADAKHSHAN","TASHKAN",1711178,2,563,37,600
"BADAKHSHAN","TASHKAN",1711184,2,534,61,595
"BADAKHSHAN","TASHKAN",1711186,1,574,21,595
"BADAKHSHAN","TASHKAN",1711304,3,365,2,367
"BADAKHSHAN","TASHKAN",1711187,1,458,140,598
"BADAKHSHAN","TASHKAN",1711186,2,550,49,599
"BADAKHSHAN","TASHKAN",1711182,1,581,17,598
"BADAKHSHAN","TASHKAN",1711182,2,573,21,594
"BADAKHSHAN","TASHKAN",1711304,2,233,10,243
"BADAKHSHAN","TASHKAN",1711178,3,483,117,600
"BADAKHSHAN","TASHKAN",1711185,1,164,56,220
"BADAKHSHAN","TASHKAN",1711185,2,341,111,452
"BADAKHSHAN","TASHKAN",1711303,3,121,389,510
"BADAKHSHAN","TASHKAN",1711180,1,570,22,592
"BADAKHSHAN","TASHKAN",1711303,2,90,404,494
"BADAKHSHAN","TASHKAN",1711183,2,556,39,595
"BADAKHSHAN","TASHKAN",1711183,1,572,27,599
"BADAKHSHAN","TASHKAN",1711304,1,458,42,500
"BADAKHSHAN","TASHKAN",1711303,1,241,268,509
"BADAKHSHAN","SHUHADA",1712114,3,479,84,563
"BADAKHSHAN","SHUHADA",1712118,2,458,35,493
"BADAKHSHAN","SHUHADA",1712114,2,339,66,405
"BADAKHSHAN","SHUHADA",1712119,2,240,24,264
"BADAKHSHAN","SHUHADA",1712115,2,402,17,419
"BADAKHSHAN","SHUHADA",1712118,1,522,69,591
"BADAKHSHAN","SHUHADA",1712114,1,324,54,378
"BADAKHSHAN","SHUHADA",1712305,1,316,31,347
"BADAKHSHAN","SHUHADA",1712113,2,259,16,275
"BADAKHSHAN","SHUHADA",1712115,1,481,38,519
"BADAKHSHAN","SHUHADA",1712305,3,443,22,465
"BADAKHSHAN","SHUHADA",1712113,4,421,31,452
"BADAKHSHAN","SHUHADA",1712116,1,567,19,586
"BADAKHSHAN","SHUHADA",1712113,1,75,18,93
"BADAKHSHAN","SHUHADA",1712305,2,396,31,427
"BADAKHSHAN","SHUHADA",1712116,2,573,7,580
"BADAKHSHAN","SHUHADA",1712113,3,201,12,213
"BADAKHSHAN","SHUHADA",1712119,1,349,137,486
"BADAKHSHAN","SHUHADA",1712117,1,564,32,596
"BADAKHSHAN","SHUHADA",1712117,2,534,55,589
"BADAKHSHAN","SHAHR-E-BUZURG",1713307,1,114,16,130
"BADAKHSHAN","SHAHR-E-BUZURG",1713149,2,412,16,428
"BADAKHSHAN","SHAHR-E-BUZURG",1713139,1,547,45,592
"BADAKHSHAN","SHAHR-E-BUZURG",1713144,3,521,78,599
"BADAKHSHAN","SHAHR-E-BUZURG",1713140,1,288,110,398
"BADAKHSHAN","SHAHR-E-BUZURG",1713140,2,216,90,306
"BADAKHSHAN","SHAHR-E-BUZURG",1713139,2,548,46,594
"BADAKHSHAN","SHAHR-E-BUZURG",1713149,1,284,6,290
"BADAKHSHAN","SHAHR-E-BUZURG",1713307,2,146,16,162
"BADAKHSHAN","SHAHR-E-BUZURG",1713148,1,122,72,194
"BADAKHSHAN","SHAHR-E-BUZURG",1713144,2,577,23,600
"BADAKHSHAN","SHAHR-E-BUZURG",1713142,3,565,34,599
"BADAKHSHAN","SHAHR-E-BUZURG",1713145,1,267,0,267
"BADAKHSHAN","SHAHR-E-BUZURG",1713141,2,398,8,406
"BADAKHSHAN","SHAHR-E-BUZURG",1713148,2,203,75,278
"BADAKHSHAN","SHAHR-E-BUZURG",1713141,1,263,16,279
"BADAKHSHAN","SHAHR-E-BUZURG",1713308,3,505,95,600
"BADAKHSHAN","SHAHR-E-BUZURG",1713138,3,591,6,597
"BADAKHSHAN","SHAHR-E-BUZURG",1713145,2,410,0,410
"BADAKHSHAN","SHAHR-E-BUZURG",1713144,1,583,13,596
"BADAKHSHAN","SHAHR-E-BUZURG",1713308,2,528,72,600
"BADAKHSHAN","SHAHR-E-BUZURG",1713142,2,452,52,504
"BADAKHSHAN","SHAHR-E-BUZURG",1713138,2,552,47,599
"BADAKHSHAN","SHAHR-E-BUZURG",1713143,1,244,18,262
"BADAKHSHAN","SHAHR-E-BUZURG",1713146,1,550,48,598
"BADAKHSHAN","SHAHR-E-BUZURG",1713306,3,168,0,168
"BADAKHSHAN","SHAHR-E-BUZURG",1713307,3,182,20,202
"BADAKHSHAN","SHAHR-E-BUZURG",1713146,2,586,14,600
"BADAKHSHAN","SHAHR-E-BUZURG",1713138,1,505,60,565
"BADAKHSHAN","SHAHR-E-BUZURG",1713147,2,267,119,386
"BADAKHSHAN","SHAHR-E-BUZURG",1713142,1,530,68,598
"BADAKHSHAN","SHAHR-E-BUZURG",1713137,4,263,179,442
"BADAKHSHAN","SHAHR-E-BUZURG",1713306,1,232,2,234
"BADAKHSHAN","SHAHR-E-BUZURG",1713308,1,553,46,599
"BADAKHSHAN","SHAHR-E-BUZURG",1713306,2,137,4,141
"BADAKHSHAN","SHAHR-E-BUZURG",1713139,3,584,16,600
"BADAKHSHAN","SHAHR-E-BUZURG",1713143,2,318,13,331
"BADAKHSHAN","SHAHR-E-BUZURG",1713147,1,235,32,267
"BADAKHSHAN","SHAHR-E-BUZURG",1713137,3,319,143,462
"BADAKHSHAN","SHAHR-E-BUZURG",1713137,1,360,121,481
"BADAKHSHAN","SHAHR-E-BUZURG",1713137,2,215,99,314
"BADAKHSHAN","RAGISTAN",1714234,2,552,46,598
"BADAKHSHAN","RAGISTAN",1714230,3,426,66,492
"BADAKHSHAN","RAGISTAN",1714237,2,329,57,386
"BADAKHSHAN","RAGISTAN",1714233,3,430,38,468
"BADAKHSHAN","RAGISTAN",1714234,1,566,31,597
"BADAKHSHAN","RAGISTAN",1714233,1,516,12,528
"BADAKHSHAN","RAGISTAN",1714237,3,489,26,515
"BADAKHSHAN","RAGISTAN",1714237,1,386,48,434
"BADAKHSHAN","RAGISTAN",1714233,4,560,33,593
"BADAKHSHAN","RAGISTAN",1714230,4,548,27,575
"BADAKHSHAN","RAGISTAN",1714233,2,447,52,499
"BADAKHSHAN","RAGISTAN",1714234,3,547,50,597
"BADAKHSHAN","RAGISTAN",1714230,2,463,38,501
"BADAKHSHAN","RAGISTAN",1714229,4,418,123,541
"BADAKHSHAN","RAGISTAN",1714232,2,467,2,469
"BADAKHSHAN","RAGISTAN",1714230,1,550,44,594
"BADAKHSHAN","RAGISTAN",1714231,4,508,16,524
"BADAKHSHAN","RAGISTAN",1714236,3,416,183,599
"BADAKHSHAN","RAGISTAN",1714229,2,302,71,373
"BADAKHSHAN","RAGISTAN",1714229,1,356,42,398
"BADAKHSHAN","RAGISTAN",1714231,2,559,39,598
"BADAKHSHAN","RAGISTAN",1714235,1,443,37,480
"BADAKHSHAN","RAGISTAN",1714231,1,579,19,598
"BADAKHSHAN","RAGISTAN",1714234,4,541,59,600
"BADAKHSHAN","RAGISTAN",1714229,3,431,61,492
"BADAKHSHAN","RAGISTAN",1714235,4,397,15,412
"BADAKHSHAN","RAGISTAN",1714236,1,2,0,2
"BADAKHSHAN","RAGISTAN",1714232,1,375,1,376
"BADAKHSHAN","RAGISTAN",1714236,2,459,139,598
"BADAKHSHAN","RAGISTAN",1714235,3,389,46,435
"BADAKHSHAN","RAGISTAN",1714231,3,491,38,529
"BADAKHSHAN","RAGISTAN",1714236,4,524,74,598
"BADAKHSHAN","RAGISTAN",1714235,2,261,38,299
"BADAKHSHAN","KISHM",1715150,7,138,30,168
"BADAKHSHAN","KISHM",1715150,8,198,36,234
"BADAKHSHAN","KISHM",1715151,1,311,184,495
"BADAKHSHAN","KISHM",1715157,3,470,51,521
"BADAKHSHAN","KISHM",1715153,3,318,22,340
"BADAKHSHAN","KISHM",1715157,2,461,51,512
"BADAKHSHAN","KISHM",1715164,1,175,31,206
"BADAKHSHAN","KISHM",1715158,1,296,78,374
"BADAKHSHAN","KISHM",1715153,4,297,25,322
"BADAKHSHAN","KISHM",1715165,3,15,51,66
"BADAKHSHAN","KISHM",1715153,1,187,43,230
"BADAKHSHAN","KISHM",1715153,2,165,42,207
"BADAKHSHAN","KISHM",1715309,1,217,358,575
"BADAKHSHAN","KISHM",1715159,2,323,123,446
"BADAKHSHAN","KISHM",1715154,2,150,445,595
"BADAKHSHAN","KISHM",1715151,5,217,22,239
"BADAKHSHAN","KISHM",1715158,2,251,57,308
"BADAKHSHAN","KISHM",1715154,1,192,396,588
"BADAKHSHAN","KISHM",1715150,2,486,108,594
"BADAKHSHAN","KISHM",1715150,3,488,100,588
"BADAKHSHAN","KISHM",1715309,3,142,257,399
"BADAKHSHAN","KISHM",1715165,2,206,381,587
"BADAKHSHAN","KISHM",1715161,1,156,148,304
"BADAKHSHAN","KISHM",1715150,6,484,97,581
"BADAKHSHAN","KISHM",1715157,1,257,38,295
"BADAKHSHAN","KISHM",1715160,3,30,7,37
"BADAKHSHAN","KISHM",1715310,1,230,25,255
"BADAKHSHAN","KISHM",1715310,2,314,23,337
"BADAKHSHAN","KISHM",1715151,4,217,5,222
"BADAKHSHAN","KISHM",1715150,4,486,104,590
"BADAKHSHAN","KISHM",1715151,6,234,69,303
"BADAKHSHAN","KISHM",1715165,1,136,455,591
"BADAKHSHAN","KISHM",1715155,2,142,110,252
"BADAKHSHAN","KISHM",1715309,2,184,285,469
"BADAKHSHAN","KISHM",1715150,5,503,75,578
"BADAKHSHAN","KISHM",1715156,4,110,46,156
"BADAKHSHAN","KISHM",1715161,2,91,95,186
"BADAKHSHAN","KISHM",1715154,3,158,440,598
"BADAKHSHAN","KISHM",1715151,3,215,6,221
"BADAKHSHAN","KISHM",1715161,3,205,248,453
"BADAKHSHAN","KISHM",1715161,4,298,80,378
"BADAKHSHAN","KISHM",1715150,1,509,80,589
"BADAKHSHAN","KISHM",1715155,3,151,250,401
"BADAKHSHAN","KISHM",1715158,4,47,8,55
"BADAKHSHAN","KISHM",1715152,4,186,31,217
"BADAKHSHAN","KISHM",1715159,1,254,124,378
"BADAKHSHAN","KISHM",1715162,1,262,317,579
"BADAKHSHAN","KISHM",1715164,2,39,4,43
"BADAKHSHAN","KISHM",1715156,3,420,169,589
"BADAKHSHAN","KISHM",1715160,4,100,13,113
"BADAKHSHAN","KISHM",1715155,1,88,82,170
"BADAKHSHAN","KISHM",1715151,2,426,89,515
"BADAKHSHAN","KISHM",1715154,4,161,405,566
"BADAKHSHAN","KISHM",1715156,2,283,223,506
"BADAKHSHAN","KISHM",1715154,5,192,389,581
"BADAKHSHAN","KISHM",1715152,3,287,61,348
"BADAKHSHAN","KISHM",1715166,1,40,146,186
"BADAKHSHAN","KISHM",1715158,3,492,77,569
"BADAKHSHAN","KISHM",1715166,2,46,103,149
"BADAKHSHAN","KISHM",1715152,1,353,65,418
"BADAKHSHAN","KISHM",1715310,3,534,26,560
"BADAKHSHAN","KISHM",1715160,2,218,18,236
"BADAKHSHAN","KISHM",1715163,1,450,76,526
"BADAKHSHAN","KISHM",1715156,1,359,230,589
"BADAKHSHAN","KISHM",1715152,2,362,32,394
"BADAKHSHAN","KISHM",1715163,2,234,204,438
"BADAKHSHAN","KISHM",1715162,2,304,279,583
"BADAKHSHAN","KISHM",1715160,1,270,20,290
"BADAKHSHAN","WARDOOJ",1716094,4,124,17,141
"BADAKHSHAN","WARDOOJ",1716100,1,141,106,247
"BADAKHSHAN","WARDOOJ",1716095,1,475,18,493
"BADAKHSHAN","WARDOOJ",1716097,3,16,0,16
"BADAKHSHAN","WARDOOJ",1716094,3,122,4,126
"BADAKHSHAN","WARDOOJ",1716097,1,102,9,111
"BADAKHSHAN","WARDOOJ",1716096,2,31,4,35
"BADAKHSHAN","WARDOOJ",1716095,2,326,12,338
"BADAKHSHAN","WARDOOJ",1716097,2,154,9,163
"BADAKHSHAN","WARDOOJ",1716094,2,78,10,88
"BADAKHSHAN","WARDOOJ",1716101,2,29,1,30
"BADAKHSHAN","WARDOOJ",1716311,3,60,5,65
"BADAKHSHAN","WARDOOJ",1716311,2,41,4,45
"BADAKHSHAN","WARDOOJ",1716094,1,115,9,124
"BADAKHSHAN","WARDOOJ",1716096,4,9,0,9
"BADAKHSHAN","WARDOOJ",1716101,1,290,16,306
"BADAKHSHAN","WARDOOJ",1716100,2,196,77,273
"BADAKHSHAN","WARDOOJ",1716095,3,394,3,397
"BADAKHSHAN","WARDOOJ",1716311,1,101,9,110
"BADAKHSHAN","TAGAB",1717168,1,570,21,591
"BADAKHSHAN","TAGAB",1717167,3,243,0,243
"BADAKHSHAN","TAGAB",1717168,2,497,55,552
"BADAKHSHAN","TAGAB",1717167,2,412,13,425
"BADAKHSHAN","TAGAB",1717167,1,323,20,343
"BADAKHSHAN","YAMGAN",1718259,4,403,80,483
"BADAKHSHAN","YAMGAN",1718254,4,162,116,278
"BADAKHSHAN","YAMGAN",1718255,1,574,26,600
"BADAKHSHAN","YAMGAN",1718254,3,210,44,254
"BADAKHSHAN","YAMGAN",1718254,1,412,28,440
"BADAKHSHAN","YAMGAN",1718259,3,277,65,342
"BADAKHSHAN","YAMGAN",1718255,2,550,6,556
"BADAKHSHAN","YAMGAN",1718258,1,576,22,598
"BADAKHSHAN","YAMGAN",1718259,1,479,116,595
"BADAKHSHAN","YAMGAN",1718257,3,565,32,597
"BADAKHSHAN","YAMGAN",1718254,2,267,54,321
"BADAKHSHAN","YAMGAN",1718259,2,564,26,590
"BADAKHSHAN","YAMGAN",1718258,2,454,61,515
"BADAKHSHAN","YAMGAN",1718258,3,508,0,508
"BADAKHSHAN","YAMGAN",1718257,2,564,35,599
"BADAKHSHAN","YAMGAN",1718257,1,548,49,597
"BADAKHSHAN","SHIGHNAN",1719214,4,109,473,582
"BADAKHSHAN","SHIGHNAN",1719214,2,92,307,399
"BADAKHSHAN","SHIGHNAN",1719219,2,71,162,233
"BADAKHSHAN","SHIGHNAN",1719214,1,95,276,371
"BADAKHSHAN","SHIGHNAN",1719215,1,211,110,321
"BADAKHSHAN","SHIGHNAN",1719218,4,83,196,279
"BADAKHSHAN","SHIGHNAN",1719219,1,120,152,272
"BADAKHSHAN","SHIGHNAN",1719219,3,115,231,346
"BADAKHSHAN","SHIGHNAN",1719214,3,106,189,295
"BADAKHSHAN","SHIGHNAN",1719215,2,144,91,235
"BADAKHSHAN","SHIGHNAN",1719216,1,85,65,150
"BADAKHSHAN","SHIGHNAN",1719217,3,64,109,173
"BADAKHSHAN","SHIGHNAN",1719218,3,89,180,269
"BADAKHSHAN","SHIGHNAN",1719216,3,118,187,305
"BADAKHSHAN","SHIGHNAN",1719217,1,79,50,129
"BADAKHSHAN","SHIGHNAN",1719220,1,44,136,180
"BADAKHSHAN","SHIGHNAN",1719218,2,104,162,266
"BADAKHSHAN","SHIGHNAN",1719217,2,56,58,114
"BADAKHSHAN","SHIGHNAN",1719220,2,45,111,156
"BADAKHSHAN","SHIGHNAN",1719213,1,202,248,450
"BADAKHSHAN","SHIGHNAN",1719218,1,71,153,224
"BADAKHSHAN","SHIGHNAN",1719215,3,381,211,592
"BADAKHSHAN","SHIGHNAN",1719221,2,50,173,223
"BADAKHSHAN","SHIGHNAN",1719216,2,86,83,169
"BADAKHSHAN","SHIGHNAN",1719220,3,66,156,222
"BADAKHSHAN","SHIGHNAN",1719213,4,273,308,581
"BADAKHSHAN","SHIGHNAN",1719213,3,174,210,384
"BADAKHSHAN","SHIGHNAN",1719221,1,71,139,210
"BADAKHSHAN","SHIGHNAN",1719213,2,149,162,311
"BADAKHSHAN","KHWAHAN",1720242,4,165,37,202
"BADAKHSHAN","KHWAHAN",1720244,1,88,6,94
"BADAKHSHAN","KHWAHAN",1720242,2,307,17,324
"BADAKHSHAN","KHWAHAN",1720240,2,71,92,163
"BADAKHSHAN","KHWAHAN",1720242,3,207,12,219
"BADAKHSHAN","KHWAHAN",1720244,2,60,0,60
"BADAKHSHAN","KHWAHAN",1720240,1,99,85,184
"BADAKHSHAN","KHWAHAN",1720239,2,131,37,168
"BADAKHSHAN","KHWAHAN",1720242,1,320,21,341
"BADAKHSHAN","KHWAHAN",1720241,3,32,0,32
"BADAKHSHAN","KHWAHAN",1720241,2,47,5,52
"BADAKHSHAN","KHWAHAN",1720245,1,552,45,597
"BADAKHSHAN","KHWAHAN",1720238,3,277,103,380
"BADAKHSHAN","KHWAHAN",1720243,2,164,4,168
"BADAKHSHAN","KHWAHAN",1720243,3,162,13,175
"BADAKHSHAN","KHWAHAN",1720239,1,149,48,197
"BADAKHSHAN","KHWAHAN",1720238,2,186,54,240
"BADAKHSHAN","KHWAHAN",1720241,1,63,9,72
"BADAKHSHAN","KHWAHAN",1720239,3,291,106,397
"BADAKHSHAN","KHWAHAN",1720243,1,118,12,130
"BADAKHSHAN","KHWAHAN",1720238,1,145,37,182
"BADAKHSHAN","KUFAB",1721250,1,391,7,398
"BADAKHSHAN","KUFAB",1721246,5,133,22,155
"BADAKHSHAN","KUFAB",1721246,3,128,23,151
"BADAKHSHAN","KUFAB",1721246,4,125,12,137
"BADAKHSHAN","KUFAB",1721250,2,390,5,395
"BADAKHSHAN","KUFAB",1721250,3,586,14,600
"BADAKHSHAN","KUFAB",1721246,1,116,22,138
"BADAKHSHAN","KUFAB",1721246,2,222,52,274
"BADAKHSHAN","KUFAB",1721249,3,587,9,596
"BADAKHSHAN","KUFAB",1721249,1,571,26,597
"BADAKHSHAN","KUFAB",1721252,1,339,10,349
"BADAKHSHAN","KUFAB",1721252,2,251,15,266
"BADAKHSHAN","KUFAB",1721247,3,353,46,399
"BADAKHSHAN","KUFAB",1721248,1,180,2,182
"BADAKHSHAN","KUFAB",1721251,3,547,50,597
"BADAKHSHAN","KUFAB",1721247,4,362,31,393
"BADAKHSHAN","KUFAB",1721247,2,272,66,338
"BADAKHSHAN","KUFAB",1721247,1,273,68,341
"BADAKHSHAN","KUFAB",1721251,1,528,39,567
"BADAKHSHAN","KUFAB",1721249,2,532,58,590
"BADAKHSHAN","KUFAB",1721248,2,323,14,337
"BADAKHSHAN","KUFAB",1721248,3,397,9,406
"BADAKHSHAN","KUFAB",1721251,2,542,48,590
"BADAKHSHAN","DARWAZ-E-PAY",1722262,1,593,4,597
"BADAKHSHAN","DARWAZ-E-PAY",1722265,2,138,22,160
"BADAKHSHAN","DARWAZ-E-PAY",1722263,3,595,2,597
"BADAKHSHAN","DARWAZ-E-PAY",1722262,2,594,6,600
"BADAKHSHAN","DARWAZ-E-PAY",1722266,1,137,98,235
"BADAKHSHAN","DARWAZ-E-PAY",1722267,2,3,3,6
"BADAKHSHAN","DARWAZ-E-PAY",1722263,1,590,8,598
"BADAKHSHAN","DARWAZ-E-PAY",1722263,2,594,4,598
"BADAKHSHAN","DARWAZ-E-PAY",1722261,2,557,37,594
"BADAKHSHAN","DARWAZ-E-PAY",1722264,2,177,338,515
"BADAKHSHAN","DARWAZ-E-PAY",1722261,3,532,68,600
"BADAKHSHAN","DARWAZ-E-PAY",1722261,4,550,50,600
"BADAKHSHAN","DARWAZ-E-PAY",1722266,2,5,19,24
"BADAKHSHAN","DARWAZ-E-PAY",1722267,1,8,18,26
"BADAKHSHAN","DARWAZ-E-PAY",1722265,1,217,36,253
"BADAKHSHAN","DARWAZ-E-PAY",1722261,1,541,59,600
"BADAKHSHAN","DARWAZ-E-PAY",1722264,1,208,286,494
"BADAKHSHAN","DARWAZ-E-PAY",1722262,3,597,2,599
"BADAKHSHAN","ESHKASHIM",1723315,1,55,52,107
"BADAKHSHAN","ESHKASHIM",1723315,3,78,91,169
"BADAKHSHAN","ESHKASHIM",1723197,1,189,286,475
"BADAKHSHAN","ESHKASHIM",1723197,2,124,182,306
"BADAKHSHAN","ESHKASHIM",1723200,2,37,44,81
"BADAKHSHAN","ESHKASHIM",1723315,2,40,42,82
"BADAKHSHAN","ESHKASHIM",1723196,3,103,109,212
"BADAKHSHAN","ESHKASHIM",1723196,2,137,53,190
"BADAKHSHAN","ESHKASHIM",1723197,3,163,322,485
"BADAKHSHAN","ESHKASHIM",1723199,2,72,174,246
"BADAKHSHAN","ESHKASHIM",1723199,1,158,261,419
"BADAKHSHAN","ESHKASHIM",1723202,2,123,122,245
"BADAKHSHAN","ESHKASHIM",1723202,1,147,114,261
"BADAKHSHAN","ESHKASHIM",1723200,1,64,72,136
"BADAKHSHAN","ESHKASHIM",1723198,2,132,180,312
"BADAKHSHAN","ESHKASHIM",1723201,2,30,83,113
"BADAKHSHAN","ESHKASHIM",1723196,1,78,49,127
"BADAKHSHAN","ESHKASHIM",1723198,1,123,163,286
"BADAKHSHAN","ESHKASHIM",1723201,1,60,108,168
"BADAKHSHAN","ESHKASHIM",1723198,3,246,341,587
"BADAKHSHAN","SHIKI",1724280,2,258,5,263
"BADAKHSHAN","SHIKI",1724282,2,302,2,304
"BADAKHSHAN","SHIKI",1724277,3,475,17,492
"BADAKHSHAN","SHIKI",1724278,3,395,37,432
"BADAKHSHAN","SHIKI",1724280,1,559,18,577
"BADAKHSHAN","SHIKI",1724281,1,65,135,200
"BADAKHSHAN","SHIKI",1724282,1,395,7,402
"BADAKHSHAN","SHIKI",1724279,1,506,27,533
"BADAKHSHAN","SHIKI",1724279,2,582,16,598
"BADAKHSHAN","SHIKI",1724277,1,518,45,563
"BADAKHSHAN","SHIKI",1724278,2,524,25,549
"BADAKHSHAN","SHIKI",1724277,2,486,47,533
"BADAKHSHAN","SHIKI",1724276,3,68,35,103
"BADAKHSHAN","SHIKI",1724278,1,404,55,459
"BADAKHSHAN","SHIKI",1724276,2,146,27,173
"BADAKHSHAN","SHIKI",1724276,4,190,155,345
"BADAKHSHAN","SHIKI",1724276,1,153,65,218
"BADAKHSHAN","SHIKI",1724281,2,51,170,221
"BADAKHSHAN","ZEBAK",1725192,1,145,95,240
"BADAKHSHAN","ZEBAK",1725194,2,215,165,380
"BADAKHSHAN","ZEBAK",1725195,2,68,87,155
"BADAKHSHAN","ZEBAK",1725192,2,123,118,241
"BADAKHSHAN","ZEBAK",1725195,1,173,113,286
"BADAKHSHAN","ZEBAK",1725193,1,159,127,286
"BADAKHSHAN","ZEBAK",1725194,1,203,198,401
"BADAKHSHAN","ZEBAK",1725193,2,111,107,218
"BADAKHSHAN","ZEBAK",1725192,3,178,182,360
"BADAKHSHAN","KIRAN WA MENJAN",1726188,1,185,22,207
"BADAKHSHAN","KIRAN WA MENJAN",1726188,2,335,54,389
"BADAKHSHAN","KIRAN WA MENJAN",1726316,2,146,6,152
"BADAKHSHAN","KIRAN WA MENJAN",1726191,2,139,125,264
"BADAKHSHAN","KIRAN WA MENJAN",1726188,4,153,29,182
"BADAKHSHAN","KIRAN WA MENJAN",1726189,1,481,91,572
"BADAKHSHAN","KIRAN WA MENJAN",1726189,2,539,55,594
"BADAKHSHAN","KIRAN WA MENJAN",1726188,3,230,14,244
"BADAKHSHAN","KIRAN WA MENJAN",1726191,1,330,118,448
"BADAKHSHAN","KIRAN WA MENJAN",1726190,2,279,61,340
"BADAKHSHAN","KIRAN WA MENJAN",1726316,3,51,0,51
"BADAKHSHAN","KIRAN WA MENJAN",1726190,1,267,63,330
"BADAKHSHAN","KIRAN WA MENJAN",1726316,1,266,13,279
"BADAKHSHAN","DARWAZ-E-BAL",1727268,2,569,30,599
"BADAKHSHAN","DARWAZ-E-BAL",1727272,1,264,43,307
"BADAKHSHAN","DARWAZ-E-BAL",1727268,1,558,41,599
"BADAKHSHAN","DARWAZ-E-BAL",1727271,3,481,44,525
"BADAKHSHAN","DARWAZ-E-BAL",1727272,2,263,26,289
"BADAKHSHAN","DARWAZ-E-BAL",1727272,3,575,21,596
"BADAKHSHAN","DARWAZ-E-BAL",1727269,4,462,0,462
"BADAKHSHAN","DARWAZ-E-BAL",1727268,3,583,17,600
"BADAKHSHAN","DARWAZ-E-BAL",1727271,1,190,39,229
"BADAKHSHAN","DARWAZ-E-BAL",1727273,3,281,131,412
"BADAKHSHAN","DARWAZ-E-BAL",1727273,2,248,103,351
"BADAKHSHAN","DARWAZ-E-BAL",1727270,1,408,47,455
"BADAKHSHAN","DARWAZ-E-BAL",1727270,3,579,19,598
"BADAKHSHAN","DARWAZ-E-BAL",1727271,2,220,44,264
"BADAKHSHAN","DARWAZ-E-BAL",1727275,1,513,11,524
"BADAKHSHAN","DARWAZ-E-BAL",1727269,3,497,6,503
"BADAKHSHAN","DARWAZ-E-BAL",1727274,2,515,56,571
"BADAKHSHAN","DARWAZ-E-BAL",1727268,4,585,11,596
"BADAKHSHAN","DARWAZ-E-BAL",1727270,2,354,11,365
"BADAKHSHAN","DARWAZ-E-BAL",1727269,1,466,5,471
"BADAKHSHAN","DARWAZ-E-BAL",1727269,2,416,2,418
"BADAKHSHAN","DARWAZ-E-BAL",1727275,2,557,3,560
"BADAKHSHAN","DARWAZ-E-BAL",1727273,1,288,98,386
"BADAKHSHAN","DARWAZ-E-BAL",1727274,1,563,28,591
"BADAKHSHAN","DARWAZ-E-BAL",1727275,3,575,0,575
"BADAKHSHAN","WAKHAN",1728206,2,73,170,243
"BADAKHSHAN","WAKHAN",1728210,1,128,228,356
"BADAKHSHAN","WAKHAN",1728212,2,105,235,340
"BADAKHSHAN","WAKHAN",1728208,2,147,39,186
"BADAKHSHAN","WAKHAN",1728211,2,36,137,173
"BADAKHSHAN","WAKHAN",1728212,1,172,257,429
"BADAKHSHAN","WAKHAN",1728206,1,116,137,253
"BADAKHSHAN","WAKHAN",1728205,1,103,158,261
"BADAKHSHAN","WAKHAN",1728207,1,146,194,340
"BADAKHSHAN","WAKHAN",1728203,1,178,149,327
"BADAKHSHAN","WAKHAN",1728210,2,76,169,245
"BADAKHSHAN","WAKHAN",1728208,1,190,48,238
"BADAKHSHAN","WAKHAN",1728207,2,42,164,206
"BADAKHSHAN","WAKHAN",1728211,1,65,165,230
"BADAKHSHAN","WAKHAN",1728205,2,131,151,282
"BADAKHSHAN","WAKHAN",1728203,2,94,190,284
"BADAKHSHAN","WAKHAN",1728209,2,206,6,212
"BADAKHSHAN","WAKHAN",1728204,1,65,114,179
"BADAKHSHAN","WAKHAN",1728204,2,41,90,131
"BADAKHSHAN","WAKHAN",1728209,1,255,26,281
"BADAKHSHAN","WAKHAN",1728205,3,168,302,470
"TAKHAR","TALUQAN",1801017,5,93,226,319
"TAKHAR","TALUQAN",1801008,1,187,208,395
"TAKHAR","TALUQAN",1801013,1,206,110,316
"TAKHAR","TALUQAN",1801017,3,50,155,205
"TAKHAR","TALUQAN",1801018,1,136,47,183
"TAKHAR","TALUQAN",1801010,5,367,132,499
"TAKHAR","TALUQAN",1801010,6,453,129,582
"TAKHAR","TALUQAN",1801017,4,122,310,432
"TAKHAR","TALUQAN",1801013,3,137,85,222
"TAKHAR","TALUQAN",1801009,6,48,308,356
"TAKHAR","TALUQAN",1801003,7,182,389,571
"TAKHAR","TALUQAN",1801013,2,185,100,285
"TAKHAR","TALUQAN",1801014,7,316,49,365
"TAKHAR","TALUQAN",1801013,4,187,167,354
"TAKHAR","TALUQAN",1801013,5,248,118,366
"TAKHAR","TALUQAN",1801019,6,275,49,324
"TAKHAR","TALUQAN",1801022,1,32,182,214
"TAKHAR","TALUQAN",1801017,2,103,218,321
"TAKHAR","TALUQAN",1801003,6,186,380,566
"TAKHAR","TALUQAN",1801005,3,60,125,185
"TAKHAR","TALUQAN",1801018,2,258,63,321
"TAKHAR","TALUQAN",1801008,2,128,177,305
"TAKHAR","TALUQAN",1801008,3,163,180,343
"TAKHAR","TALUQAN",1801016,5,149,227,376
"TAKHAR","TALUQAN",1801010,1,394,163,557
"TAKHAR","TALUQAN",1801010,2,286,78,364
"TAKHAR","TALUQAN",1801017,1,64,249,313
"TAKHAR","TALUQAN",1801014,6,274,30,304
"TAKHAR","TALUQAN",1801010,4,203,74,277
"TAKHAR","TALUQAN",1801029,1,11,230,241
"TAKHAR","TALUQAN",1801029,2,17,341,358
"TAKHAR","TALUQAN",1801010,7,453,131,584
"TAKHAR","TALUQAN",1801004,1,143,250,393
"TAKHAR","TALUQAN",1801004,2,119,183,302
"TAKHAR","TALUQAN",1801016,1,252,72,324
"TAKHAR","TALUQAN",1801016,2,136,61,197
"TAKHAR","TALUQAN",1801014,2,139,27,166
"TAKHAR","TALUQAN",1801014,3,186,65,251
"TAKHAR","TALUQAN",1801014,4,264,72,336
"TAKHAR","TALUQAN",1801014,5,280,72,352
"TAKHAR","TALUQAN",1801010,3,191,92,283
"TAKHAR","TALUQAN",1801024,6,346,65,411
"TAKHAR","TALUQAN",1801024,7,391,103,494
"TAKHAR","TALUQAN",1801003,8,113,124,237
"TAKHAR","TALUQAN",1801030,2,20,517,537
"TAKHAR","TALUQAN",1801030,3,29,553,582
"TAKHAR","TALUQAN",1801030,4,11,146,157
"TAKHAR","TALUQAN",1801013,6,272,130,402
"TAKHAR","TALUQAN",1801013,7,166,69,235
"TAKHAR","TALUQAN",1801016,3,125,51,176
"TAKHAR","TALUQAN",1801016,4,171,32,203
"TAKHAR","TALUQAN",1801002,6,285,181,466
"TAKHAR","TALUQAN",1801018,3,231,79,310
"TAKHAR","TALUQAN",1801009,4,18,210,228
"TAKHAR","TALUQAN",1801009,5,49,308,357
"TAKHAR","TALUQAN",1801006,2,208,147,355
"TAKHAR","TALUQAN",1801006,3,218,120,338
"TAKHAR","TALUQAN",1801005,1,70,120,190
"TAKHAR","TALUQAN",1801005,2,62,148,210
"TAKHAR","TALUQAN",1801006,6,291,157,448
"TAKHAR","TALUQAN",1801008,4,348,240,588
"TAKHAR","TALUQAN",1801008,5,84,49,133
"TAKHAR","TALUQAN",1801014,1,148,48,196
"TAKHAR","TALUQAN",1801027,1,155,166,321
"TAKHAR","TALUQAN",1801027,2,143,159,302
"TAKHAR","TALUQAN",1801021,6,309,89,398
"TAKHAR","TALUQAN",1801031,3,56,150,206
"TAKHAR","TALUQAN",1801032,1,72,520,592
"TAKHAR","TALUQAN",1801018,4,377,109,486
"TAKHAR","TALUQAN",1801018,5,391,124,515
"TAKHAR","TALUQAN",1801018,6,517,74,591
"TAKHAR","TALUQAN",1801018,7,475,109,584
"TAKHAR","TALUQAN",1801018,8,155,65,220
"TAKHAR","TALUQAN",1801186,1,203,248,451
"TAKHAR","TALUQAN",1801004,3,72,206,278
"TAKHAR","TALUQAN",1801002,1,237,163,400
"TAKHAR","TALUQAN",1801002,4,81,113,194
"TAKHAR","TALUQAN",1801002,5,231,303,534
"TAKHAR","TALUQAN",1801026,2,94,325,419
"TAKHAR","TALUQAN",1801183,3,496,85,581
"TAKHAR","TALUQAN",1801003,3,135,389,524
"TAKHAR","TALUQAN",1801003,4,64,179,243
"TAKHAR","TALUQAN",1801003,5,80,234,314
"TAKHAR","TALUQAN",1801030,1,33,538,571
"TAKHAR","TALUQAN",1801020,1,175,118,293
"TAKHAR","TALUQAN",1801020,2,142,118,260
"TAKHAR","TALUQAN",1801020,3,78,41,119
"TAKHAR","TALUQAN",1801020,4,305,138,443
"TAKHAR","TALUQAN",1801021,1,171,75,246
"TAKHAR","TALUQAN",1801021,2,186,100,286
"TAKHAR","TALUQAN",1801021,3,116,62,178
"TAKHAR","TALUQAN",1801021,4,131,69,200
"TAKHAR","TALUQAN",1801021,5,386,72,458
"TAKHAR","TALUQAN",1801009,3,33,411,444
"TAKHAR","TALUQAN",1801006,1,150,170,320
"TAKHAR","TALUQAN",1801019,3,402,107,509
"TAKHAR","TALUQAN",1801019,4,208,46,254
"TAKHAR","TALUQAN",1801006,4,231,170,401
"TAKHAR","TALUQAN",1801006,5,174,128,302
"TAKHAR","TALUQAN",1801023,2,282,284,566
"TAKHAR","TALUQAN",1801006,7,343,183,526
"TAKHAR","TALUQAN",1801005,4,192,367,559
"TAKHAR","TALUQAN",1801022,4,45,248,293
"TAKHAR","TALUQAN",1801002,2,180,157,337
"TAKHAR","TALUQAN",1801002,3,160,138,298
"TAKHAR","TALUQAN",1801022,7,58,165,223
"TAKHAR","TALUQAN",1801031,1,58,130,188
"TAKHAR","TALUQAN",1801031,2,41,66,107
"TAKHAR","TALUQAN",1801032,2,84,463,547
"TAKHAR","TALUQAN",1801032,3,75,396,471
"TAKHAR","TALUQAN",1801032,4,57,394,451
"TAKHAR","TALUQAN",1801023,1,286,269,555
"TAKHAR","TALUQAN",1801025,2,49,249,298
"TAKHAR","TALUQAN",1801023,3,217,255,472
"TAKHAR","TALUQAN",1801023,4,351,147,498
"TAKHAR","TALUQAN",1801004,4,237,336,573
"TAKHAR","TALUQAN",1801003,1,113,232,345
"TAKHAR","TALUQAN",1801003,2,131,237,368
"TAKHAR","TALUQAN",1801183,2,491,97,588
"TAKHAR","TALUQAN",1801024,1,208,64,272
"TAKHAR","TALUQAN",1801183,4,483,95,578
"TAKHAR","TALUQAN",1801183,5,179,53,232
"TAKHAR","TALUQAN",1801183,6,158,36,194
"TAKHAR","TALUQAN",1801012,11,222,44,266
"TAKHAR","TALUQAN",1801025,1,73,279,352
"TAKHAR","TALUQAN",1801011,5,137,31,168
"TAKHAR","TALUQAN",1801025,3,69,291,360
"TAKHAR","TALUQAN",1801034,1,16,274,290
"TAKHAR","TALUQAN",1801184,1,209,367,576
"TAKHAR","TALUQAN",1801184,2,207,374,581
"TAKHAR","TALUQAN",1801001,1,83,157,240
"TAKHAR","TALUQAN",1801001,2,82,163,245
"TAKHAR","TALUQAN",1801001,3,56,132,188
"TAKHAR","TALUQAN",1801001,4,144,289,433
"TAKHAR","TALUQAN",1801019,2,307,93,400
"TAKHAR","TALUQAN",1801011,2,258,54,312
"TAKHAR","TALUQAN",1801011,3,256,68,324
"TAKHAR","TALUQAN",1801019,5,239,52,291
"TAKHAR","TALUQAN",1801012,10,325,37,362
"TAKHAR","TALUQAN",1801011,6,136,53,189
"TAKHAR","TALUQAN",1801022,2,53,253,306
"TAKHAR","TALUQAN",1801022,3,30,298,328
"TAKHAR","TALUQAN",1801011,9,103,36,139
"TAKHAR","TALUQAN",1801022,5,35,196,231
"TAKHAR","TALUQAN",1801022,6,47,244,291
"TAKHAR","TALUQAN",1801007,2,87,287,374
"TAKHAR","TALUQAN",1801022,8,54,126,180
"TAKHAR","TALUQAN",1801026,1,133,308,441
"TAKHAR","TALUQAN",1801024,3,160,43,203
"TAKHAR","TALUQAN",1801024,5,452,74,526
"TAKHAR","TALUQAN",1801011,4,283,63,346
"TAKHAR","TALUQAN",1801012,9,473,76,549
"TAKHAR","TALUQAN",1801012,12,287,35,322
"TAKHAR","TALUQAN",1801011,7,211,50,261
"TAKHAR","TALUQAN",1801011,8,258,39,297
"TAKHAR","TALUQAN",1801015,2,183,63,246
"TAKHAR","TALUQAN",1801186,2,189,261,450
"TAKHAR","TALUQAN",1801186,3,252,324,576
"TAKHAR","TALUQAN",1801186,4,93,59,152
"TAKHAR","TALUQAN",1801183,1,489,102,591
"TAKHAR","TALUQAN",1801024,2,243,61,304
"TAKHAR","TALUQAN",1801007,4,243,314,557
"TAKHAR","TALUQAN",1801011,1,155,30,185
"TAKHAR","TALUQAN",1801033,3,65,514,579
"TAKHAR","TALUQAN",1801028,3,10,23,33
"TAKHAR","TALUQAN",1801012,6,390,97,487
"TAKHAR","TALUQAN",1801012,13,340,67,407
"TAKHAR","TALUQAN",1801015,1,381,158,539
"TAKHAR","TALUQAN",1801009,1,34,548,582
"TAKHAR","TALUQAN",1801015,3,218,82,300
"TAKHAR","TALUQAN",1801015,4,142,13,155
"TAKHAR","TALUQAN",1801015,5,183,21,204
"TAKHAR","TALUQAN",1801033,2,35,433,468
"TAKHAR","TALUQAN",1801009,2,49,515,564
"TAKHAR","TALUQAN",1801028,4,15,24,39
"TAKHAR","TALUQAN",1801033,1,33,284,317
"TAKHAR","TALUQAN",1801007,1,111,315,426
"TAKHAR","TALUQAN",1801012,4,308,181,489
"TAKHAR","TALUQAN",1801012,5,261,84,345
"TAKHAR","TALUQAN",1801012,1,435,152,587
"TAKHAR","TALUQAN",1801012,7,261,54,315
"TAKHAR","TALUQAN",1801012,3,483,107,590
"TAKHAR","TALUQAN",1801007,3,65,175,240
"TAKHAR","TALUQAN",1801019,1,352,113,465
"TAKHAR","TALUQAN",1801034,2,113,92,205
"TAKHAR","TALUQAN",1801007,5,197,327,524
"TAKHAR","TALUQAN",1801184,3,248,320,568
"TAKHAR","TALUQAN",1801023,5,285,169,454
"TAKHAR","TALUQAN",1801028,1,23,90,113
"TAKHAR","TALUQAN",1801012,2,463,122,585
"TAKHAR","TALUQAN",1801012,8,257,70,327
"TAKHAR","TALUQAN",1801028,2,22,120,142
"TAKHAR","TALUQAN",1801184,4,106,95,201
"TAKHAR","TALUQAN",1801185,2,57,80,137
"TAKHAR","TALUQAN",1801185,1,85,149,234
"TAKHAR","TALUQAN",1801029,3,30,260,290
"TAKHAR","HAZAR SUMUC",1802036,3,9,227,236
"TAKHAR","HAZAR SUMUC",1802037,2,25,445,470
"TAKHAR","HAZAR SUMUC",1802036,1,15,190,205
"TAKHAR","HAZAR SUMUC",1802035,2,8,274,282
"TAKHAR","HAZAR SUMUC",1802037,1,13,490,503
"TAKHAR","HAZAR SUMUC",1802187,2,18,259,277
"TAKHAR","HAZAR SUMUC",1802036,2,7,268,275
"TAKHAR","HAZAR SUMUC",1802187,1,24,356,380
"TAKHAR","HAZAR SUMUC",1802039,2,12,220,232
"TAKHAR","HAZAR SUMUC",1802038,2,4,306,310
"TAKHAR","HAZAR SUMUC",1802035,1,7,264,271
"TAKHAR","HAZAR SUMUC",1802035,3,8,186,194
"TAKHAR","HAZAR SUMUC",1802039,1,23,283,306
"TAKHAR","HAZAR SUMUC",1802038,1,15,508,523
"TAKHAR","HAZAR SUMUC",1802035,4,13,272,285
"TAKHAR","BAHARAK",1803204,1,44,129,173
"TAKHAR","BAHARAK",1803043,4,56,80,136
"TAKHAR","BAHARAK",1803041,7,104,293,397
"TAKHAR","BAHARAK",1803041,6,92,318,410
"TAKHAR","BAHARAK",1803188,2,58,135,193
"TAKHAR","BAHARAK",1803041,4,48,250,298
"TAKHAR","BAHARAK",1803044,1,43,549,592
"TAKHAR","BAHARAK",1803044,2,44,550,594
"TAKHAR","BAHARAK",1803043,3,50,86,136
"TAKHAR","BAHARAK",1803040,2,59,205,264
"TAKHAR","BAHARAK",1803041,5,58,315,373
"TAKHAR","BAHARAK",1803045,2,14,348,362
"TAKHAR","BAHARAK",1803189,2,13,18,31
"TAKHAR","BAHARAK",1803040,6,72,192,264
"TAKHAR","BAHARAK",1803040,3,86,186,272
"TAKHAR","BAHARAK",1803040,4,116,207,323
"TAKHAR","BAHARAK",1803188,1,100,196,296
"TAKHAR","BAHARAK",1803042,5,81,428,509
"TAKHAR","BAHARAK",1803043,1,46,182,228
"TAKHAR","BAHARAK",1803043,2,40,175,215
"TAKHAR","BAHARAK",1803040,5,187,307,494
"TAKHAR","BAHARAK",1803045,1,33,305,338
"TAKHAR","BAHARAK",1803041,2,68,241,309
"TAKHAR","BAHARAK",1803041,3,87,391,478
"TAKHAR","BAHARAK",1803189,3,22,18,40
"TAKHAR","BAHARAK",1803204,3,57,204,261
"TAKHAR","BAHARAK",1803041,1,53,174,227
"TAKHAR","BAHARAK",1803044,4,46,523,569
"TAKHAR","BAHARAK",1803044,3,24,566,590
"TAKHAR","BAHARAK",1803189,1,9,18,27
"TAKHAR","BAHARAK",1803044,7,23,210,233
"TAKHAR","BAHARAK",1803042,4,56,490,546
"TAKHAR","BAHARAK",1803042,3,37,487,524
"TAKHAR","BAHARAK",1803042,2,36,358,394
"TAKHAR","BAHARAK",1803044,5,30,446,476
"TAKHAR","BAHARAK",1803040,1,75,290,365
"TAKHAR","BAHARAK",1803040,7,75,208,283
"TAKHAR","BAHARAK",1803042,1,50,418,468
"TAKHAR","BAHARAK",1803204,2,52,205,257
"TAKHAR","BAHARAK",1803044,6,30,538,568
"TAKHAR","BANGI",1804062,7,58,400,458
"TAKHAR","BANGI",1804061,1,37,262,299
"TAKHAR","BANGI",1804059,2,110,271,381
"TAKHAR","BANGI",1804062,8,22,284,306
"TAKHAR","BANGI",1804062,3,51,543,594
"TAKHAR","BANGI",1804059,1,137,285,422
"TAKHAR","BANGI",1804059,7,44,237,281
"TAKHAR","BANGI",1804063,3,27,116,143
"TAKHAR","BANGI",1804062,6,80,405,485
"TAKHAR","BANGI",1804059,6,69,280,349
"TAKHAR","BANGI",1804062,2,72,506,578
"TAKHAR","BANGI",1804061,3,4,379,383
"TAKHAR","BANGI",1804060,3,85,290,375
"TAKHAR","BANGI",1804062,5,43,538,581
"TAKHAR","BANGI",1804061,2,20,252,272
"TAKHAR","BANGI",1804059,4,73,203,276
"TAKHAR","BANGI",1804063,1,36,133,169
"TAKHAR","BANGI",1804059,5,51,239,290
"TAKHAR","BANGI",1804062,1,62,536,598
"TAKHAR","BANGI",1804063,2,35,180,215
"TAKHAR","BANGI",1804059,3,152,218,370
"TAKHAR","BANGI",1804062,4,42,556,598
"TAKHAR","BANGI",1804063,4,28,168,196
"TAKHAR","BANGI",1804060,1,62,449,511
"TAKHAR","BANGI",1804060,4,47,279,326
"TAKHAR","BANGI",1804061,4,9,319,328
"TAKHAR","BANGI",1804060,2,473,39,512
"TAKHAR","BANGI",1804060,5,58,286,344
"TAKHAR","CHAL",1805076,4,89,10,99
"TAKHAR","CHAL",1805079,3,295,117,412
"TAKHAR","CHAL",1805079,2,349,59,408
"TAKHAR","CHAL",1805080,1,506,83,589
"TAKHAR","CHAL",1805080,2,477,121,598
"TAKHAR","CHAL",1805077,4,85,349,434
"TAKHAR","CHAL",1805076,1,343,54,397
"TAKHAR","CHAL",1805079,1,248,133,381
"TAKHAR","CHAL",1805077,6,54,306,360
"TAKHAR","CHAL",1805079,4,365,45,410
"TAKHAR","CHAL",1805077,3,88,366,454
"TAKHAR","CHAL",1805193,1,471,56,527
"TAKHAR","CHAL",1805077,5,55,375,430
"TAKHAR","CHAL",1805078,4,226,16,242
"TAKHAR","CHAL",1805078,1,345,95,440
"TAKHAR","CHAL",1805077,1,61,312,373
"TAKHAR","CHAL",1805078,2,342,81,423
"TAKHAR","CHAL",1805078,3,190,7,197
"TAKHAR","CHAL",1805076,5,199,66,265
"TAKHAR","CHAL",1805077,2,55,288,343
"TAKHAR","CHAL",1805193,2,465,100,565
"TAKHAR","CHAL",1805076,3,70,8,78
"TAKHAR","CHAL",1805076,2,220,21,241
"TAKHAR","NAMAK AB",1806082,2,124,50,174
"TAKHAR","NAMAK AB",1806081,1,104,37,141
"TAKHAR","NAMAK AB",1806083,1,165,23,188
"TAKHAR","NAMAK AB",1806194,2,293,77,370
"TAKHAR","NAMAK AB",1806082,1,148,48,196
"TAKHAR","NAMAK AB",1806205,1,89,7,96
"TAKHAR","NAMAK AB",1806194,1,134,37,171
"TAKHAR","NAMAK AB",1806205,3,75,9,84
"TAKHAR","NAMAK AB",1806081,2,96,60,156
"TAKHAR","NAMAK AB",1806083,3,145,25,170
"TAKHAR","NAMAK AB",1806082,3,62,82,144
"TAKHAR","NAMAK AB",1806081,3,90,33,123
"TAKHAR","NAMAK AB",1806205,2,92,12,104
"TAKHAR","NAMAK AB",1806083,4,94,19,113
"TAKHAR","NAMAK AB",1806081,4,112,75,187
"TAKHAR","NAMAK AB",1806083,5,78,21,99
"TAKHAR","NAMAK AB",1806083,2,170,20,190
"TAKHAR","NAMAK AB",1806081,5,221,23,244
"TAKHAR","KALAFGAN",1807096,1,111,373,484
"TAKHAR","KALAFGAN",1807096,4,75,494,569
"TAKHAR","KALAFGAN",1807100,4,145,452,597
"TAKHAR","KALAFGAN",1807195,1,59,151,210
"TAKHAR","KALAFGAN",1807100,1,71,314,385
"TAKHAR","KALAFGAN",1807100,2,79,350,429
"TAKHAR","KALAFGAN",1807100,3,68,523,591
"TAKHAR","KALAFGAN",1807099,4,179,221,400
"TAKHAR","KALAFGAN",1807097,1,73,521,594
"TAKHAR","KALAFGAN",1807195,2,39,240,279
"TAKHAR","KALAFGAN",1807095,4,136,289,425
"TAKHAR","KALAFGAN",1807099,3,151,192,343
"TAKHAR","KALAFGAN",1807094,4,6,334,340
"TAKHAR","KALAFGAN",1807095,3,125,316,441
"TAKHAR","KALAFGAN",1807097,2,75,511,586
"TAKHAR","KALAFGAN",1807096,5,72,516,588
"TAKHAR","KALAFGAN",1807096,2,87,289,376
"TAKHAR","KALAFGAN",1807207,3,205,226,431
"TAKHAR","KALAFGAN",1807099,1,144,192,336
"TAKHAR","KALAFGAN",1807099,2,177,272,449
"TAKHAR","KALAFGAN",1807206,1,17,484,501
"TAKHAR","KALAFGAN",1807096,3,45,272,317
"TAKHAR","KALAFGAN",1807094,1,17,296,313
"TAKHAR","KALAFGAN",1807206,3,2,598,600
"TAKHAR","KALAFGAN",1807094,5,13,179,192
"TAKHAR","KALAFGAN",1807097,5,39,538,577
"TAKHAR","KALAFGAN",1807095,1,142,345,487
"TAKHAR","KALAFGAN",1807097,4,33,548,581
"TAKHAR","KALAFGAN",1807206,2,50,474,524
"TAKHAR","KALAFGAN",1807098,3,74,433,507
"TAKHAR","KALAFGAN",1807097,3,75,509,584
"TAKHAR","KALAFGAN",1807207,2,110,128,238
"TAKHAR","KALAFGAN",1807098,4,61,510,571
"TAKHAR","KALAFGAN",1807098,2,70,426,496
"TAKHAR","KALAFGAN",1807207,1,208,257,465
"TAKHAR","KALAFGAN",1807095,2,151,351,502
"TAKHAR","KALAFGAN",1807094,3,5,314,319
"TAKHAR","KALAFGAN",1807098,1,47,539,586
"TAKHAR","KALAFGAN",1807094,2,11,312,323
"TAKHAR","FARKHAR",1808089,1,263,14,277
"TAKHAR","FARKHAR",1808087,3,592,5,597
"TAKHAR","FARKHAR",1808092,1,221,89,310
"TAKHAR","FARKHAR",1808086,2,529,34,563
"TAKHAR","FARKHAR",1808089,2,555,4,559
"TAKHAR","FARKHAR",1808087,2,294,6,300
"TAKHAR","FARKHAR",1808085,1,333,4,337
"TAKHAR","FARKHAR",1808208,1,168,32,200
"TAKHAR","FARKHAR",1808208,2,148,23,171
"TAKHAR","FARKHAR",1808208,3,265,23,288
"TAKHAR","FARKHAR",1808086,1,436,32,468
"TAKHAR","FARKHAR",1808085,2,372,12,384
"TAKHAR","FARKHAR",1808085,3,372,3,375
"TAKHAR","FARKHAR",1808085,4,402,3,405
"TAKHAR","FARKHAR",1808084,1,577,9,586
"TAKHAR","FARKHAR",1808089,3,422,1,423
"TAKHAR","FARKHAR",1808088,2,588,11,599
"TAKHAR","FARKHAR",1808092,2,292,132,424
"TAKHAR","FARKHAR",1808091,1,193,26,219
"TAKHAR","FARKHAR",1808087,1,341,15,356
"TAKHAR","FARKHAR",1808084,2,420,14,434
"TAKHAR","FARKHAR",1808091,2,164,28,192
"TAKHAR","FARKHAR",1808091,3,388,51,439
"TAKHAR","FARKHAR",1808092,3,473,100,573
"TAKHAR","FARKHAR",1808088,3,591,5,596
"TAKHAR","FARKHAR",1808086,5,449,42,491
"TAKHAR","FARKHAR",1808086,3,326,30,356
"TAKHAR","FARKHAR",1808084,5,337,9,346
"TAKHAR","FARKHAR",1808086,4,190,15,205
"TAKHAR","FARKHAR",1808093,2,183,11,194
"TAKHAR","FARKHAR",1808084,3,530,12,542
"TAKHAR","FARKHAR",1808090,1,55,45,100
"TAKHAR","FARKHAR",1808084,4,350,2,352
"TAKHAR","FARKHAR",1808088,1,595,0,595
"TAKHAR","FARKHAR",1808086,8,547,15,562
"TAKHAR","FARKHAR",1808086,7,500,18,518
"TAKHAR","FARKHAR",1808090,2,235,62,297
"TAKHAR","FARKHAR",1808086,6,575,17,592
"TAKHAR","FARKHAR",1808093,1,292,41,333
"TAKHAR","KHWAJA GHAR",1809048,2,36,225,261
"TAKHAR","KHWAJA GHAR",1809047,2,206,225,431
"TAKHAR","KHWAJA GHAR",1809047,3,138,261,399
"TAKHAR","KHWAJA GHAR",1809047,4,153,266,419
"TAKHAR","KHWAJA GHAR",1809047,1,139,301,440
"TAKHAR","KHWAJA GHAR",1809048,4,87,495,582
"TAKHAR","KHWAJA GHAR",1809048,1,31,247,278
"TAKHAR","KHWAJA GHAR",1809056,4,21,548,569
"TAKHAR","KHWAJA GHAR",1809050,1,32,331,363
"TAKHAR","KHWAJA GHAR",1809046,4,242,332,574
"TAKHAR","KHWAJA GHAR",1809049,3,48,374,422
"TAKHAR","KHWAJA GHAR",1809050,2,25,332,357
"TAKHAR","KHWAJA GHAR",1809048,3,28,194,222
"TAKHAR","KHWAJA GHAR",1809046,3,127,222,349
"TAKHAR","KHWAJA GHAR",1809054,3,49,360,409
"TAKHAR","KHWAJA GHAR",1809056,3,30,506,536
"TAKHAR","KHWAJA GHAR",1809190,4,56,518,574
"TAKHAR","KHWAJA GHAR",1809049,2,20,167,187
"TAKHAR","KHWAJA GHAR",1809051,1,47,266,313
"TAKHAR","KHWAJA GHAR",1809056,2,16,582,598
"TAKHAR","KHWAJA GHAR",1809047,5,251,320,571
"TAKHAR","KHWAJA GHAR",1809049,1,28,222,250
"TAKHAR","KHWAJA GHAR",1809053,4,125,457,582
"TAKHAR","KHWAJA GHAR",1809050,3,12,258,270
"TAKHAR","KHWAJA GHAR",1809056,1,27,562,589
"TAKHAR","KHWAJA GHAR",1809058,1,66,376,442
"TAKHAR","KHWAJA GHAR",1809046,5,179,373,552
"TAKHAR","KHWAJA GHAR",1809053,2,87,508,595
"TAKHAR","KHWAJA GHAR",1809053,1,93,498,591
"TAKHAR","KHWAJA GHAR",1809051,2,35,203,238
"TAKHAR","KHWAJA GHAR",1809051,3,31,221,252
"TAKHAR","KHWAJA GHAR",1809052,1,35,450,485
"TAKHAR","KHWAJA GHAR",1809046,2,97,315,412
"TAKHAR","KHWAJA GHAR",1809054,1,24,188,212
"TAKHAR","KHWAJA GHAR",1809054,2,7,243,250
"TAKHAR","KHWAJA GHAR",1809190,1,89,411,500
"TAKHAR","KHWAJA GHAR",1809052,2,36,461,497
"TAKHAR","KHWAJA GHAR",1809058,2,220,276,496
"TAKHAR","KHWAJA GHAR",1809057,2,5,41,46
"TAKHAR","KHWAJA GHAR",1809055,1,113,476,589
"TAKHAR","KHWAJA GHAR",1809051,6,73,302,375
"TAKHAR","KHWAJA GHAR",1809047,6,185,390,575
"TAKHAR","KHWAJA GHAR",1809050,4,37,298,335
"TAKHAR","KHWAJA GHAR",1809046,1,112,191,303
"TAKHAR","KHWAJA GHAR",1809051,5,65,310,375
"TAKHAR","KHWAJA GHAR",1809053,3,83,501,584
"TAKHAR","KHWAJA GHAR",1809190,3,100,412,512
"TAKHAR","KHWAJA GHAR",1809055,4,58,519,577
"TAKHAR","KHWAJA GHAR",1809051,4,48,194,242
"TAKHAR","KHWAJA GHAR",1809055,2,70,521,591
"TAKHAR","KHWAJA GHAR",1809190,2,49,356,405
"TAKHAR","KHWAJA GHAR",1809055,3,47,538,585
"TAKHAR","KHWAJA GHAR",1809052,4,45,325,370
"TAKHAR","KHWAJA GHAR",1809057,1,12,174,186
"TAKHAR","KHWAJA GHAR",1809052,3,50,364,414
"TAKHAR","RUSTAQ",1810101,2,346,146,492
"TAKHAR","RUSTAQ",1810109,3,243,53,296
"TAKHAR","RUSTAQ",1810109,4,480,78,558
"TAKHAR","RUSTAQ",1810209,3,36,9,45
"TAKHAR","RUSTAQ",1810110,2,108,94,202
"TAKHAR","RUSTAQ",1810104,5,414,151,565
"TAKHAR","RUSTAQ",1810104,6,367,201,568
"TAKHAR","RUSTAQ",1810101,1,454,140,594
"TAKHAR","RUSTAQ",1810109,2,170,45,215
"TAKHAR","RUSTAQ",1810104,4,318,167,485
"TAKHAR","RUSTAQ",1810209,1,31,43,74
"TAKHAR","RUSTAQ",1810112,1,345,27,372
"TAKHAR","RUSTAQ",1810109,1,171,30,201
"TAKHAR","RUSTAQ",1810110,3,114,77,191
"TAKHAR","RUSTAQ",1810131,1,267,18,285
"TAKHAR","RUSTAQ",1810209,2,44,56,100
"TAKHAR","RUSTAQ",1810103,4,229,144,373
"TAKHAR","RUSTAQ",1810211,3,149,11,160
"TAKHAR","RUSTAQ",1810118,1,88,319,407
"TAKHAR","RUSTAQ",1810101,3,417,139,556
"TAKHAR","RUSTAQ",1810106,2,133,241,374
"TAKHAR","RUSTAQ",1810106,3,155,153,308
"TAKHAR","RUSTAQ",1810106,4,97,247,344
"TAKHAR","RUSTAQ",1810106,1,174,268,442
"TAKHAR","RUSTAQ",1810114,2,91,114,205
"TAKHAR","RUSTAQ",1810101,4,443,146,589
"TAKHAR","RUSTAQ",1810121,4,273,11,284
"TAKHAR","RUSTAQ",1810114,1,72,112,184
"TAKHAR","RUSTAQ",1810125,2,330,16,346
"TAKHAR","RUSTAQ",1810125,3,401,30,431
"TAKHAR","RUSTAQ",1810116,1,13,576,589
"TAKHAR","RUSTAQ",1810101,7,385,174,559
"TAKHAR","RUSTAQ",1810196,1,73,25,98
"TAKHAR","RUSTAQ",1810196,2,122,21,143
"TAKHAR","RUSTAQ",1810210,1,197,5,202
"TAKHAR","RUSTAQ",1810116,2,16,579,595
"TAKHAR","RUSTAQ",1810101,5,435,149,584
"TAKHAR","RUSTAQ",1810211,1,199,10,209
"TAKHAR","RUSTAQ",1810211,2,170,7,177
"TAKHAR","RUSTAQ",1810120,3,87,242,329
"TAKHAR","RUSTAQ",1810104,3,356,147,503
"TAKHAR","RUSTAQ",1810124,4,37,147,184
"TAKHAR","RUSTAQ",1810118,2,42,89,131
"TAKHAR","RUSTAQ",1810110,1,122,68,190
"TAKHAR","RUSTAQ",1810103,3,238,125,363
"TAKHAR","RUSTAQ",1810115,3,531,36,567
"TAKHAR","RUSTAQ",1810103,5,396,193,589
"TAKHAR","RUSTAQ",1810131,2,217,25,242
"TAKHAR","RUSTAQ",1810129,2,158,20,178
"TAKHAR","RUSTAQ",1810129,3,158,27,185
"TAKHAR","RUSTAQ",1810127,4,228,164,392
"TAKHAR","RUSTAQ",1810120,4,69,251,320
"TAKHAR","RUSTAQ",1810120,1,91,272,363
"TAKHAR","RUSTAQ",1810120,2,88,266,354
"TAKHAR","RUSTAQ",1810122,1,488,11,499
"TAKHAR","RUSTAQ",1810122,2,269,1,270
"TAKHAR","RUSTAQ",1810115,1,293,17,310
"TAKHAR","RUSTAQ",1810115,2,425,21,446
"TAKHAR","RUSTAQ",1810119,3,46,447,493
"TAKHAR","RUSTAQ",1810128,1,87,10,97
"TAKHAR","RUSTAQ",1810106,5,229,336,565
"TAKHAR","RUSTAQ",1810114,3,82,137,219
"TAKHAR","RUSTAQ",1810114,4,124,337,461
"TAKHAR","RUSTAQ",1810114,5,157,230,387
"TAKHAR","RUSTAQ",1810121,1,380,15,395
"TAKHAR","RUSTAQ",1810121,2,309,11,320
"TAKHAR","RUSTAQ",1810121,3,329,8,337
"TAKHAR","RUSTAQ",1810125,1,235,13,248
"TAKHAR","RUSTAQ",1810130,4,95,258,353
"TAKHAR","RUSTAQ",1810119,1,41,495,536
"TAKHAR","RUSTAQ",1810119,2,38,556,594
"TAKHAR","RUSTAQ",1810123,4,118,177,295
"TAKHAR","RUSTAQ",1810117,1,25,336,361
"TAKHAR","RUSTAQ",1810116,3,16,562,578
"TAKHAR","RUSTAQ",1810116,4,33,231,264
"TAKHAR","RUSTAQ",1810210,2,165,2,167
"TAKHAR","RUSTAQ",1810210,3,229,3,232
"TAKHAR","RUSTAQ",1810197,1,360,8,368
"TAKHAR","RUSTAQ",1810197,2,294,4,298
"TAKHAR","RUSTAQ",1810112,4,274,23,297
"TAKHAR","RUSTAQ",1810112,5,466,38,504
"TAKHAR","RUSTAQ",1810112,6,545,27,572
"TAKHAR","RUSTAQ",1810103,1,240,105,345
"TAKHAR","RUSTAQ",1810103,2,139,135,274
"TAKHAR","RUSTAQ",1810129,1,140,22,162
"TAKHAR","RUSTAQ",1810105,1,351,15,366
"TAKHAR","RUSTAQ",1810105,2,334,21,355
"TAKHAR","RUSTAQ",1810110,4,196,114,310
"TAKHAR","RUSTAQ",1810111,2,22,183,205
"TAKHAR","RUSTAQ",1810127,1,173,68,241
"TAKHAR","RUSTAQ",1810129,4,253,33,286
"TAKHAR","RUSTAQ",1810127,3,76,63,139
"TAKHAR","RUSTAQ",1810123,3,56,130,186
"TAKHAR","RUSTAQ",1810101,6,250,101,351
"TAKHAR","RUSTAQ",1810123,1,51,174,225
"TAKHAR","RUSTAQ",1810123,2,27,152,179
"TAKHAR","RUSTAQ",1810128,2,88,14,102
"TAKHAR","RUSTAQ",1810128,3,146,13,159
"TAKHAR","RUSTAQ",1810102,1,550,25,575
"TAKHAR","RUSTAQ",1810102,2,556,30,586
"TAKHAR","RUSTAQ",1810102,3,548,33,581
"TAKHAR","RUSTAQ",1810104,1,207,161,368
"TAKHAR","RUSTAQ",1810104,2,179,159,338
"TAKHAR","RUSTAQ",1810130,3,87,167,254
"TAKHAR","RUSTAQ",1810113,3,134,14,148
"TAKHAR","RUSTAQ",1810113,4,111,17,128
"TAKHAR","RUSTAQ",1810117,2,5,592,597
"TAKHAR","RUSTAQ",1810108,1,179,7,186
"TAKHAR","RUSTAQ",1810108,2,174,9,183
"TAKHAR","RUSTAQ",1810112,2,428,30,458
"TAKHAR","RUSTAQ",1810112,3,216,24,240
"TAKHAR","RUSTAQ",1810124,1,87,296,383
"TAKHAR","RUSTAQ",1810124,2,64,298,362
"TAKHAR","RUSTAQ",1810124,3,27,95,122
"TAKHAR","RUSTAQ",1810127,2,129,93,222
"TAKHAR","RUSTAQ",1810103,6,417,148,565
"TAKHAR","RUSTAQ",1810126,1,32,147,179
"TAKHAR","RUSTAQ",1810126,2,46,93,139
"TAKHAR","RUSTAQ",1810111,4,48,252,300
"TAKHAR","RUSTAQ",1810111,1,34,211,245
"TAKHAR","RUSTAQ",1810102,4,578,16,594
"TAKHAR","RUSTAQ",1810111,3,31,256,287
"TAKHAR","RUSTAQ",1810128,4,133,23,156
"TAKHAR","RUSTAQ",1810130,1,98,306,404
"TAKHAR","RUSTAQ",1810105,3,309,27,336
"TAKHAR","RUSTAQ",1810105,4,500,11,511
"TAKHAR","RUSTAQ",1810113,2,185,21,206
"TAKHAR","RUSTAQ",1810113,1,194,22,216
"TAKHAR","RUSTAQ",1810130,2,104,371,475
"TAKHAR","RUSTAQ",1810108,4,149,3,152
"TAKHAR","RUSTAQ",1810107,2,273,2,275
"TAKHAR","RUSTAQ",1810105,5,377,15,392
"TAKHAR","RUSTAQ",1810108,3,87,5,92
"TAKHAR","RUSTAQ",1810107,1,438,6,444
"TAKHAR","ESHKAMESH",1811073,1,580,15,595
"TAKHAR","ESHKAMESH",1811073,2,595,3,598
"TAKHAR","ESHKAMESH",1811075,2,72,113,185
"TAKHAR","ESHKAMESH",1811075,3,193,41,234
"TAKHAR","ESHKAMESH",1811064,7,265,137,402
"TAKHAR","ESHKAMESH",1811064,9,339,92,431
"TAKHAR","ESHKAMESH",1811074,2,252,17,269
"TAKHAR","ESHKAMESH",1811074,3,550,29,579
"TAKHAR","ESHKAMESH",1811064,8,436,149,585
"TAKHAR","ESHKAMESH",1811067,4,74,413,487
"TAKHAR","ESHKAMESH",1811073,3,588,6,594
"TAKHAR","ESHKAMESH",1811066,1,534,46,580
"TAKHAR","ESHKAMESH",1811064,6,115,37,152
"TAKHAR","ESHKAMESH",1811191,2,286,110,396
"TAKHAR","ESHKAMESH",1811066,3,519,57,576
"TAKHAR","ESHKAMESH",1811064,4,80,76,156
"TAKHAR","ESHKAMESH",1811064,5,110,63,173
"TAKHAR","ESHKAMESH",1811067,3,69,491,560
"TAKHAR","ESHKAMESH",1811065,4,264,68,332
"TAKHAR","ESHKAMESH",1811069,1,402,75,477
"TAKHAR","ESHKAMESH",1811069,2,491,87,578
"TAKHAR","ESHKAMESH",1811066,2,395,69,464
"TAKHAR","ESHKAMESH",1811070,4,365,210,575
"TAKHAR","ESHKAMESH",1811075,1,101,106,207
"TAKHAR","ESHKAMESH",1811074,1,472,25,497
"TAKHAR","ESHKAMESH",1811191,1,321,21,342
"TAKHAR","ESHKAMESH",1811065,3,440,99,539
"TAKHAR","ESHKAMESH",1811068,1,94,210,304
"TAKHAR","ESHKAMESH",1811068,3,93,21,114
"TAKHAR","ESHKAMESH",1811067,2,75,501,576
"TAKHAR","ESHKAMESH",1811071,1,228,203,431
"TAKHAR","ESHKAMESH",1811064,2,117,126,243
"TAKHAR","ESHKAMESH",1811067,1,54,543,597
"TAKHAR","ESHKAMESH",1811071,2,332,61,393
"TAKHAR","ESHKAMESH",1811066,4,525,49,574
"TAKHAR","ESHKAMESH",1811192,2,184,88,272
"TAKHAR","ESHKAMESH",1811069,3,351,141,492
"TAKHAR","ESHKAMESH",1811069,4,491,89,580
"TAKHAR","ESHKAMESH",1811072,1,172,413,585
"TAKHAR","ESHKAMESH",1811072,2,118,298,416
"TAKHAR","ESHKAMESH",1811065,2,176,133,309
"TAKHAR","ESHKAMESH",1811064,3,189,122,311
"TAKHAR","ESHKAMESH",1811065,1,87,110,197
"TAKHAR","ESHKAMESH",1811068,2,142,178,320
"TAKHAR","ESHKAMESH",1811192,1,229,197,426
"TAKHAR","ESHKAMESH",1811064,1,216,155,371
"TAKHAR","ESHKAMESH",1811070,2,215,200,415
"TAKHAR","ESHKAMESH",1811070,3,272,282,554
"TAKHAR","ESHKAMESH",1811068,4,70,29,99
"TAKHAR","ESHKAMESH",1811070,1,306,290,596
"TAKHAR","ESHKAMESH",1811069,5,381,120,501
"TAKHAR","DASHT-E-QALA",1812212,3,99,347,446
"TAKHAR","DASHT-E-QALA",1812212,2,53,239,292
"TAKHAR","DASHT-E-QALA",1812170,2,148,439,587
"TAKHAR","DASHT-E-QALA",1812169,6,107,413,520
"TAKHAR","DASHT-E-QALA",1812170,1,214,332,546
"TAKHAR","DASHT-E-QALA",1812212,1,96,309,405
"TAKHAR","DASHT-E-QALA",1812169,5,147,436,583
"TAKHAR","DASHT-E-QALA",1812174,2,199,341,540
"TAKHAR","DASHT-E-QALA",1812174,3,125,286,411
"TAKHAR","DASHT-E-QALA",1812172,5,23,209,232
"TAKHAR","DASHT-E-QALA",1812174,4,189,289,478
"TAKHAR","DASHT-E-QALA",1812174,1,157,338,495
"TAKHAR","DASHT-E-QALA",1812201,2,232,17,249
"TAKHAR","DASHT-E-QALA",1812169,3,108,479,587
"TAKHAR","DASHT-E-QALA",1812170,3,177,302,479
"TAKHAR","DASHT-E-QALA",1812170,4,129,296,425
"TAKHAR","DASHT-E-QALA",1812171,2,44,231,275
"TAKHAR","DASHT-E-QALA",1812171,3,65,367,432
"TAKHAR","DASHT-E-QALA",1812171,1,41,236,277
"TAKHAR","DASHT-E-QALA",1812173,1,42,328,370
"TAKHAR","DASHT-E-QALA",1812169,4,108,483,591
"TAKHAR","DASHT-E-QALA",1812173,3,76,488,564
"TAKHAR","DASHT-E-QALA",1812169,2,123,470,593
"TAKHAR","DASHT-E-QALA",1812172,4,25,227,252
"TAKHAR","DASHT-E-QALA",1812173,2,55,338,393
"TAKHAR","DASHT-E-QALA",1812200,2,48,390,438
"TAKHAR","DASHT-E-QALA",1812169,1,164,432,596
"TAKHAR","DASHT-E-QALA",1812172,1,14,216,230
"TAKHAR","DASHT-E-QALA",1812172,3,18,286,304
"TAKHAR","DASHT-E-QALA",1812201,1,237,29,266
"TAKHAR","DASHT-E-QALA",1812175,2,23,82,105
"TAKHAR","DASHT-E-QALA",1812200,1,53,539,592
"TAKHAR","DASHT-E-QALA",1812172,2,11,317,328
"TAKHAR","DASHT-E-QALA",1812175,1,11,178,189
"TAKHAR","DASHT-E-QALA",1812175,3,10,41,51
"TAKHAR","WARSAJ",1813181,3,516,22,538
"TAKHAR","WARSAJ",1813176,5,231,143,374
"TAKHAR","WARSAJ",1813176,2,147,47,194
"TAKHAR","WARSAJ",1813181,2,445,28,473
"TAKHAR","WARSAJ",1813176,4,182,66,248
"TAKHAR","WARSAJ",1813181,4,560,19,579
"TAKHAR","WARSAJ",1813203,1,301,29,330
"TAKHAR","WARSAJ",1813179,1,338,48,386
"TAKHAR","WARSAJ",1813176,3,107,79,186
"TAKHAR","WARSAJ",1813176,1,121,70,191
"TAKHAR","WARSAJ",1813181,1,393,27,420
"TAKHAR","WARSAJ",1813178,2,343,37,380
"TAKHAR","WARSAJ",1813178,4,470,17,487
"TAKHAR","WARSAJ",1813176,6,207,101,308
"TAKHAR","WARSAJ",1813178,6,394,29,423
"TAKHAR","WARSAJ",1813213,1,64,80,144
"TAKHAR","WARSAJ",1813178,3,338,24,362
"TAKHAR","WARSAJ",1813176,7,196,126,322
"TAKHAR","WARSAJ",1813180,3,450,82,532
"TAKHAR","WARSAJ",1813178,1,497,27,524
"TAKHAR","WARSAJ",1813180,2,124,21,145
"TAKHAR","WARSAJ",1813180,1,185,52,237
"TAKHAR","WARSAJ",1813178,5,426,21,447
"TAKHAR","WARSAJ",1813179,2,437,63,500
"TAKHAR","WARSAJ",1813179,3,460,67,527
"TAKHAR","WARSAJ",1813177,2,182,31,213
"TAKHAR","WARSAJ",1813203,2,206,40,246
"TAKHAR","WARSAJ",1813182,3,360,13,373
"TAKHAR","WARSAJ",1813182,2,255,31,286
"TAKHAR","WARSAJ",1813213,3,161,175,336
"TAKHAR","WARSAJ",1813179,4,470,41,511
"TAKHAR","WARSAJ",1813177,1,222,22,244
"TAKHAR","WARSAJ",1813177,3,493,41,534
"TAKHAR","WARSAJ",1813182,1,222,41,263
"TAKHAR","WARSAJ",1813202,2,290,4,294
"TAKHAR","WARSAJ",1813213,2,107,103,210
"TAKHAR","WARSAJ",1813202,1,275,17,292
"TAKHAR","KHWAJA BAHA",1814160,3,78,222,300
"TAKHAR","KHWAJA BAHA",1814158,3,230,61,291
"TAKHAR","KHWAJA BAHA",1814160,2,52,95,147
"TAKHAR","KHWAJA BAHA",1814155,2,297,291,588
"TAKHAR","KHWAJA BAHA",1814156,1,242,350,592
"TAKHAR","KHWAJA BAHA",1814155,3,239,247,486
"TAKHAR","KHWAJA BAHA",1814159,1,209,203,412
"TAKHAR","KHWAJA BAHA",1814155,4,255,238,493
"TAKHAR","KHWAJA BAHA",1814160,1,65,107,172
"TAKHAR","KHWAJA BAHA",1814159,2,210,192,402
"TAKHAR","KHWAJA BAHA",1814156,2,177,402,579
"TAKHAR","KHWAJA BAHA",1814156,3,223,342,565
"TAKHAR","KHWAJA BAHA",1814157,3,123,459,582
"TAKHAR","KHWAJA BAHA",1814155,1,290,292,582
"TAKHAR","KHWAJA BAHA",1814158,2,119,70,189
"TAKHAR","KHWAJA BAHA",1814158,1,199,62,261
"TAKHAR","KHWAJA BAHA",1814199,2,79,118,197
"TAKHAR","KHWAJA BAHA",1814157,1,117,409,526
"TAKHAR","KHWAJA BAHA",1814159,3,308,265,573
"TAKHAR","KHWAJA BAHA",1814199,1,75,211,286
"TAKHAR","KHWAJA BAHA",1814157,2,88,340,428
"TAKHAR","DARQAD",1815162,2,98,172,270
"TAKHAR","DARQAD",1815164,2,13,396,409
"TAKHAR","DARQAD",1815164,1,12,355,367
"TAKHAR","DARQAD",1815163,1,61,66,127
"TAKHAR","DARQAD",1815161,4,123,342,465
"TAKHAR","DARQAD",1815161,1,78,241,319
"TAKHAR","DARQAD",1815168,1,11,164,175
"TAKHAR","DARQAD",1815161,3,44,158,202
"TAKHAR","DARQAD",1815164,3,29,83,112
"TAKHAR","DARQAD",1815162,3,104,369,473
"TAKHAR","DARQAD",1815161,2,31,168,199
"TAKHAR","DARQAD",1815214,1,112,9,121
"TAKHAR","DARQAD",1815165,2,58,43,101
"TAKHAR","DARQAD",1815167,2,151,34,185
"TAKHAR","DARQAD",1815214,3,84,2,86
"TAKHAR","DARQAD",1815165,3,58,37,95
"TAKHAR","DARQAD",1815163,2,116,27,143
"TAKHAR","DARQAD",1815162,1,153,253,406
"TAKHAR","DARQAD",1815167,1,134,80,214
"TAKHAR","DARQAD",1815168,2,10,40,50
"TAKHAR","DARQAD",1815163,3,85,22,107
"TAKHAR","DARQAD",1815165,1,38,111,149
"TAKHAR","DARQAD",1815214,2,93,16,109
"TAKHAR","DARQAD",1815166,1,56,52,108
"TAKHAR","DARQAD",1815166,2,45,32,77
"TAKHAR","DARQAD",1815166,3,13,25,38
"TAKHAR","DARQAD",1815168,3,11,48,59
"TAKHAR","CHAH AB",1816140,1,246,3,249
"TAKHAR","CHAH AB",1816140,3,352,4,356
"TAKHAR","CHAH AB",1816138,4,328,9,337
"TAKHAR","CHAH AB",1816139,3,178,3,181
"TAKHAR","CHAH AB",1816139,4,154,3,157
"TAKHAR","CHAH AB",1816136,3,141,2,143
"TAKHAR","CHAH AB",1816139,2,177,7,184
"TAKHAR","CHAH AB",1816136,1,157,1,158
"TAKHAR","CHAH AB",1816215,1,146,3,149
"TAKHAR","CHAH AB",1816137,2,357,68,425
"TAKHAR","CHAH AB",1816137,3,291,44,335
"TAKHAR","CHAH AB",1816134,3,392,8,400
"TAKHAR","CHAH AB",1816136,2,103,9,112
"TAKHAR","CHAH AB",1816141,1,348,14,362
"TAKHAR","CHAH AB",1816132,6,573,18,591
"TAKHAR","CHAH AB",1816140,2,201,5,206
"TAKHAR","CHAH AB",1816137,1,346,70,416
"TAKHAR","CHAH AB",1816134,2,518,20,538
"TAKHAR","CHAH AB",1816215,3,234,2,236
"TAKHAR","CHAH AB",1816134,4,588,7,595
"TAKHAR","CHAH AB",1816140,4,328,4,332
"TAKHAR","CHAH AB",1816215,2,102,2,104
"TAKHAR","CHAH AB",1816138,1,333,22,355
"TAKHAR","CHAH AB",1816141,3,243,4,247
"TAKHAR","CHAH AB",1816138,3,377,10,387
"TAKHAR","CHAH AB",1816135,4,492,12,504
"TAKHAR","CHAH AB",1816142,4,432,21,453
"TAKHAR","CHAH AB",1816133,1,555,37,592
"TAKHAR","CHAH AB",1816137,4,272,43,315
"TAKHAR","CHAH AB",1816139,1,234,7,241
"TAKHAR","CHAH AB",1816136,4,91,2,93
"TAKHAR","CHAH AB",1816135,1,520,22,542
"TAKHAR","CHAH AB",1816133,2,577,16,593
"TAKHAR","CHAH AB",1816134,5,575,20,595
"TAKHAR","CHAH AB",1816135,3,507,7,514
"TAKHAR","CHAH AB",1816134,1,476,20,496
"TAKHAR","CHAH AB",1816132,1,556,29,585
"TAKHAR","CHAH AB",1816144,1,157,4,161
"TAKHAR","CHAH AB",1816134,6,587,6,593
"TAKHAR","CHAH AB",1816141,4,284,1,285
"TAKHAR","CHAH AB",1816135,2,520,19,539
"TAKHAR","CHAH AB",1816132,2,572,17,589
"TAKHAR","CHAH AB",1816141,2,208,9,217
"TAKHAR","CHAH AB",1816145,1,206,10,216
"TAKHAR","CHAH AB",1816132,5,590,6,596
"TAKHAR","CHAH AB",1816144,2,133,1,134
"TAKHAR","CHAH AB",1816138,2,391,13,404
"TAKHAR","CHAH AB",1816198,1,228,7,235
"TAKHAR","CHAH AB",1816198,2,230,4,234
"TAKHAR","CHAH AB",1816142,1,506,4,510
"TAKHAR","CHAH AB",1816133,6,574,15,589
"TAKHAR","CHAH AB",1816145,2,120,8,128
"TAKHAR","CHAH AB",1816142,3,433,4,437
"TAKHAR","CHAH AB",1816133,3,575,15,590
"TAKHAR","CHAH AB",1816133,4,561,22,583
"TAKHAR","CHAH AB",1816133,5,561,23,584
"TAKHAR","CHAH AB",1816142,2,403,9,412
"TAKHAR","CHAH AB",1816143,2,489,4,493
"TAKHAR","CHAH AB",1816132,3,564,19,583
"TAKHAR","CHAH AB",1816132,4,588,7,595
"TAKHAR","CHAH AB",1816143,1,574,16,590
"TAKHAR","YANGI QALA",1817147,4,28,30,58
"TAKHAR","YANGI QALA",1817151,1,324,202,526
"TAKHAR","YANGI QALA",1817151,2,245,155,400
"TAKHAR","YANGI QALA",1817147,3,43,31,74
"TAKHAR","YANGI QALA",1817154,1,217,125,342
"TAKHAR","YANGI QALA",1817148,3,112,175,287
"TAKHAR","YANGI QALA",1817148,4,99,188,287
"TAKHAR","YANGI QALA",1817150,2,46,153,199
"TAKHAR","YANGI QALA",1817148,2,92,232,324
"TAKHAR","YANGI QALA",1817153,1,192,96,288
"TAKHAR","YANGI QALA",1817147,2,48,85,133
"TAKHAR","YANGI QALA",1817153,2,128,66,194
"TAKHAR","YANGI QALA",1817148,1,144,294,438
"TAKHAR","YANGI QALA",1817150,4,45,107,152
"TAKHAR","YANGI QALA",1817154,2,86,49,135
"TAKHAR","YANGI QALA",1817152,2,324,150,474
"TAKHAR","YANGI QALA",1817146,1,66,117,183
"TAKHAR","YANGI QALA",1817146,2,53,252,305
"TAKHAR","YANGI QALA",1817147,1,72,95,167
"TAKHAR","YANGI QALA",1817151,4,210,160,370
"TAKHAR","YANGI QALA",1817152,1,378,204,582
"TAKHAR","YANGI QALA",1817150,3,48,252,300
"TAKHAR","YANGI QALA",1817151,3,314,171,485
"TAKHAR","YANGI QALA",1817146,6,117,183,300
"TAKHAR","YANGI QALA",1817149,3,259,333,592
"TAKHAR","YANGI QALA",1817149,4,322,268,590
"TAKHAR","YANGI QALA",1817149,1,158,140,298
"TAKHAR","YANGI QALA",1817146,7,100,164,264
"TAKHAR","YANGI QALA",1817153,3,273,116,389
"TAKHAR","YANGI QALA",1817146,3,70,228,298
"TAKHAR","YANGI QALA",1817146,4,102,141,243
"TAKHAR","YANGI QALA",1817149,2,186,136,322
"TAKHAR","YANGI QALA",1817150,1,73,143,216
"TAKHAR","YANGI QALA",1817146,5,70,306,376
"KUNDUZ","KUNDUZ",1901046,2,155,74,229
"KUNDUZ","KUNDUZ",1901046,3,182,61,243
"KUNDUZ","KUNDUZ",1901017,4,283,112,395
"KUNDUZ","KUNDUZ",1901017,5,342,247,589
"KUNDUZ","KUNDUZ",1901034,2,135,194,329
"KUNDUZ","KUNDUZ",1901046,1,190,77,267
"KUNDUZ","KUNDUZ",1901053,4,37,44,81
"KUNDUZ","KUNDUZ",1901034,1,144,284,428
"KUNDUZ","KUNDUZ",1901017,3,256,149,405
"KUNDUZ","KUNDUZ",1901017,6,360,179,539
"KUNDUZ","KUNDUZ",1901017,1,263,212,475
"KUNDUZ","KUNDUZ",1901017,2,308,177,485
"KUNDUZ","KUNDUZ",1901053,3,11,66,77
"KUNDUZ","KUNDUZ",1901006,1,263,267,530
"KUNDUZ","KUNDUZ",1901006,2,273,253,526
"KUNDUZ","KUNDUZ",1901006,3,234,237,471
"KUNDUZ","KUNDUZ",1901003,10,185,281,466
"KUNDUZ","KUNDUZ",1901003,7,68,91,159
"KUNDUZ","KUNDUZ",1901033,5,273,20,293
"KUNDUZ","KUNDUZ",1901053,2,98,111,209
"KUNDUZ","KUNDUZ",1901198,3,15,311,326
"KUNDUZ","KUNDUZ",1901199,1,5,399,404
"KUNDUZ","KUNDUZ",1901003,8,256,224,480
"KUNDUZ","KUNDUZ",1901003,9,216,203,419
"KUNDUZ","KUNDUZ",1901012,4,95,25,120
"KUNDUZ","KUNDUZ",1901012,5,110,43,153
"KUNDUZ","KUNDUZ",1901199,2,10,405,415
"KUNDUZ","KUNDUZ",1901053,1,74,65,139
"KUNDUZ","KUNDUZ",1901042,1,28,562,590
"KUNDUZ","KUNDUZ",1901003,4,150,207,357
"KUNDUZ","KUNDUZ",1901017,7,282,165,447
"KUNDUZ","KUNDUZ",1901199,3,0,400,400
"KUNDUZ","KUNDUZ",1901043,1,16,571,587
"KUNDUZ","KUNDUZ",1901043,2,19,570,589
"KUNDUZ","KUNDUZ",1901003,5,53,91,144
"KUNDUZ","KUNDUZ",1901003,6,57,82,139
"KUNDUZ","KUNDUZ",1901006,4,235,209,444
"KUNDUZ","KUNDUZ",1901017,8,176,165,341
"KUNDUZ","KUNDUZ",1901043,3,9,571,580
"KUNDUZ","KUNDUZ",1901012,6,106,22,128
"KUNDUZ","KUNDUZ",1901052,4,31,88,119
"KUNDUZ","KUNDUZ",1901003,3,132,148,280
"KUNDUZ","KUNDUZ",1901010,5,107,140,247
"KUNDUZ","KUNDUZ",1901042,2,71,505,576
"KUNDUZ","KUNDUZ",1901042,3,23,134,157
"KUNDUZ","KUNDUZ",1901044,1,53,146,199
"KUNDUZ","KUNDUZ",1901044,2,9,107,116
"KUNDUZ","KUNDUZ",1901045,1,192,66,258
"KUNDUZ","KUNDUZ",1901032,4,17,54,71
"KUNDUZ","KUNDUZ",1901003,11,138,94,232
"KUNDUZ","KUNDUZ",1901010,1,312,261,573
"KUNDUZ","KUNDUZ",1901052,1,67,147,214
"KUNDUZ","KUNDUZ",1901032,3,33,100,133
"KUNDUZ","KUNDUZ",1901052,3,35,84,119
"KUNDUZ","KUNDUZ",1901039,3,189,30,219
"KUNDUZ","KUNDUZ",1901033,4,81,40,121
"KUNDUZ","KUNDUZ",1901047,3,10,34,44
"KUNDUZ","KUNDUZ",1901012,1,241,152,393
"KUNDUZ","KUNDUZ",1901012,2,217,177,394
"KUNDUZ","KUNDUZ",1901012,3,154,108,262
"KUNDUZ","KUNDUZ",1901028,7,20,309,329
"KUNDUZ","KUNDUZ",1901028,8,16,275,291
"KUNDUZ","KUNDUZ",1901026,1,55,62,117
"KUNDUZ","KUNDUZ",1901012,7,36,17,53
"KUNDUZ","KUNDUZ",1901006,5,353,225,578
"KUNDUZ","KUNDUZ",1901052,2,69,169,238
"KUNDUZ","KUNDUZ",1901010,3,128,140,268
"KUNDUZ","KUNDUZ",1901003,2,252,243,495
"KUNDUZ","KUNDUZ",1901021,5,11,566,577
"KUNDUZ","KUNDUZ",1901021,6,7,140,147
"KUNDUZ","KUNDUZ",1901032,1,61,120,181
"KUNDUZ","KUNDUZ",1901032,2,39,168,207
"KUNDUZ","KUNDUZ",1901005,4,162,113,275
"KUNDUZ","KUNDUZ",1901005,5,187,136,323
"KUNDUZ","KUNDUZ",1901008,1,116,35,151
"KUNDUZ","KUNDUZ",1901043,4,43,550,593
"KUNDUZ","KUNDUZ",1901032,5,7,56,63
"KUNDUZ","KUNDUZ",1901043,6,34,553,587
"KUNDUZ","KUNDUZ",1901006,6,105,76,181
"KUNDUZ","KUNDUZ",1901003,1,195,206,401
"KUNDUZ","KUNDUZ",1901039,1,78,31,109
"KUNDUZ","KUNDUZ",1901010,4,167,187,354
"KUNDUZ","KUNDUZ",1901014,2,343,175,518
"KUNDUZ","KUNDUZ",1901014,3,388,198,586
"KUNDUZ","KUNDUZ",1901014,4,282,107,389
"KUNDUZ","KUNDUZ",1901014,5,177,58,235
"KUNDUZ","KUNDUZ",1901014,6,121,41,162
"KUNDUZ","KUNDUZ",1901014,7,233,96,329
"KUNDUZ","KUNDUZ",1901045,2,114,56,170
"KUNDUZ","KUNDUZ",1901045,3,156,27,183
"KUNDUZ","KUNDUZ",1901045,4,88,43,131
"KUNDUZ","KUNDUZ",1901010,2,251,290,541
"KUNDUZ","KUNDUZ",1901034,3,11,67,78
"KUNDUZ","KUNDUZ",1901197,4,134,23,157
"KUNDUZ","KUNDUZ",1901033,3,110,23,133
"KUNDUZ","KUNDUZ",1901198,2,50,251,301
"KUNDUZ","KUNDUZ",1901033,1,263,167,430
"KUNDUZ","KUNDUZ",1901033,2,157,39,196
"KUNDUZ","KUNDUZ",1901007,5,99,64,163
"KUNDUZ","KUNDUZ",1901007,6,69,43,112
"KUNDUZ","KUNDUZ",1901007,7,134,76,210
"KUNDUZ","KUNDUZ",1901007,8,152,52,204
"KUNDUZ","KUNDUZ",1901011,1,155,94,249
"KUNDUZ","KUNDUZ",1901011,2,128,49,177
"KUNDUZ","KUNDUZ",1901021,1,10,276,286
"KUNDUZ","KUNDUZ",1901021,2,15,318,333
"KUNDUZ","KUNDUZ",1901021,3,7,280,287
"KUNDUZ","KUNDUZ",1901021,4,2,198,200
"KUNDUZ","KUNDUZ",1901038,3,5,136,141
"KUNDUZ","KUNDUZ",1901041,1,218,24,242
"KUNDUZ","KUNDUZ",1901041,2,105,17,122
"KUNDUZ","KUNDUZ",1901041,3,154,12,166
"KUNDUZ","KUNDUZ",1901050,3,7,299,306
"KUNDUZ","KUNDUZ",1901050,4,7,303,310
"KUNDUZ","KUNDUZ",1901023,1,69,53,122
"KUNDUZ","KUNDUZ",1901008,2,68,30,98
"KUNDUZ","KUNDUZ",1901043,5,4,48,52
"KUNDUZ","KUNDUZ",1901023,4,50,80,130
"KUNDUZ","KUNDUZ",1901023,5,24,28,52
"KUNDUZ","KUNDUZ",1901040,3,247,36,283
"KUNDUZ","KUNDUZ",1901056,2,79,194,273
"KUNDUZ","KUNDUZ",1901039,2,93,54,147
"KUNDUZ","KUNDUZ",1901034,4,42,88,130
"KUNDUZ","KUNDUZ",1901027,1,49,119,168
"KUNDUZ","KUNDUZ",1901010,6,275,235,510
"KUNDUZ","KUNDUZ",1901010,7,254,218,472
"KUNDUZ","KUNDUZ",1901010,8,240,271,511
"KUNDUZ","KUNDUZ",1901004,1,233,152,385
"KUNDUZ","KUNDUZ",1901014,8,192,83,275
"KUNDUZ","KUNDUZ",1901013,1,224,236,460
"KUNDUZ","KUNDUZ",1901013,2,210,221,431
"KUNDUZ","KUNDUZ",1901197,1,367,92,459
"KUNDUZ","KUNDUZ",1901197,2,388,81,469
"KUNDUZ","KUNDUZ",1901197,3,432,69,501
"KUNDUZ","KUNDUZ",1901198,1,33,236,269
"KUNDUZ","KUNDUZ",1901047,2,4,49,53
"KUNDUZ","KUNDUZ",1901030,4,40,64,104
"KUNDUZ","KUNDUZ",1901007,4,124,94,218
"KUNDUZ","KUNDUZ",1901001,5,39,14,53
"KUNDUZ","KUNDUZ",1901001,7,28,8,36
"KUNDUZ","KUNDUZ",1901028,6,18,103,121
"KUNDUZ","KUNDUZ",1901048,1,130,305,435
"KUNDUZ","KUNDUZ",1901048,2,102,201,303
"KUNDUZ","KUNDUZ",1901048,3,37,241,278
"KUNDUZ","KUNDUZ",1901026,2,80,125,205
"KUNDUZ","KUNDUZ",1901026,3,84,87,171
"KUNDUZ","KUNDUZ",1901026,4,60,92,152
"KUNDUZ","KUNDUZ",1901026,5,77,116,193
"KUNDUZ","KUNDUZ",1901038,1,16,277,293
"KUNDUZ","KUNDUZ",1901038,2,17,194,211
"KUNDUZ","KUNDUZ",1901050,1,4,333,337
"KUNDUZ","KUNDUZ",1901050,2,7,332,339
"KUNDUZ","KUNDUZ",1901005,3,236,142,378
"KUNDUZ","KUNDUZ",1901018,5,42,262,304
"KUNDUZ","KUNDUZ",1901018,6,47,175,222
"KUNDUZ","KUNDUZ",1901023,2,50,15,65
"KUNDUZ","KUNDUZ",1901023,3,58,37,95
"KUNDUZ","KUNDUZ",1901008,3,85,41,126
"KUNDUZ","KUNDUZ",1901008,4,116,46,162
"KUNDUZ","KUNDUZ",1901040,1,341,20,361
"KUNDUZ","KUNDUZ",1901040,2,354,16,370
"KUNDUZ","KUNDUZ",1901056,3,78,137,215
"KUNDUZ","KUNDUZ",1901056,4,54,106,160
"KUNDUZ","KUNDUZ",1901014,1,350,175,525
"KUNDUZ","KUNDUZ",1901049,2,184,215,399
"KUNDUZ","KUNDUZ",1901049,3,227,352,579
"KUNDUZ","KUNDUZ",1901049,4,19,12,31
"KUNDUZ","KUNDUZ",1901016,1,259,111,370
"KUNDUZ","KUNDUZ",1901016,2,339,123,462
"KUNDUZ","KUNDUZ",1901016,3,371,164,535
"KUNDUZ","KUNDUZ",1901016,4,383,189,572
"KUNDUZ","KUNDUZ",1901013,3,176,211,387
"KUNDUZ","KUNDUZ",1901013,4,113,130,243
"KUNDUZ","KUNDUZ",1901013,5,188,124,312
"KUNDUZ","KUNDUZ",1901047,1,3,49,52
"KUNDUZ","KUNDUZ",1901030,5,31,69,100
"KUNDUZ","KUNDUZ",1901007,3,196,124,320
"KUNDUZ","KUNDUZ",1901001,4,149,107,256
"KUNDUZ","KUNDUZ",1901031,3,35,63,98
"KUNDUZ","KUNDUZ",1901031,4,72,125,197
"KUNDUZ","KUNDUZ",1901031,5,87,116,203
"KUNDUZ","KUNDUZ",1901019,1,103,69,172
"KUNDUZ","KUNDUZ",1901019,2,123,49,172
"KUNDUZ","KUNDUZ",1901019,3,222,101,323
"KUNDUZ","KUNDUZ",1901019,4,95,40,135
"KUNDUZ","KUNDUZ",1901011,3,33,16,49
"KUNDUZ","KUNDUZ",1901011,4,34,19,53
"KUNDUZ","KUNDUZ",1901011,5,13,15,28
"KUNDUZ","KUNDUZ",1901011,6,25,23,48
"KUNDUZ","KUNDUZ",1901011,7,38,25,63
"KUNDUZ","KUNDUZ",1901005,1,220,207,427
"KUNDUZ","KUNDUZ",1901005,2,122,93,215
"KUNDUZ","KUNDUZ",1901020,6,368,131,499
"KUNDUZ","KUNDUZ",1901018,1,38,192,230
"KUNDUZ","KUNDUZ",1901018,2,31,110,141
"KUNDUZ","KUNDUZ",1901018,7,57,155,212
"KUNDUZ","KUNDUZ",1901018,8,68,139,207
"KUNDUZ","KUNDUZ",1901004,3,303,247,550
"KUNDUZ","KUNDUZ",1901054,1,35,146,181
"KUNDUZ","KUNDUZ",1901008,5,55,47,102
"KUNDUZ","KUNDUZ",1901008,6,54,28,82
"KUNDUZ","KUNDUZ",1901015,3,193,162,355
"KUNDUZ","KUNDUZ",1901015,4,194,117,311
"KUNDUZ","KUNDUZ",1901015,5,244,114,358
"KUNDUZ","KUNDUZ",1901049,1,182,192,374
"KUNDUZ","KUNDUZ",1901027,2,19,81,100
"KUNDUZ","KUNDUZ",1901027,3,29,34,63
"KUNDUZ","KUNDUZ",1901027,4,50,48,98
"KUNDUZ","KUNDUZ",1901027,5,80,30,110
"KUNDUZ","KUNDUZ",1901004,2,279,228,507
"KUNDUZ","KUNDUZ",1901018,4,51,238,289
"KUNDUZ","KUNDUZ",1901016,5,401,122,523
"KUNDUZ","KUNDUZ",1901016,6,293,79,372
"KUNDUZ","KUNDUZ",1901030,1,45,248,293
"KUNDUZ","KUNDUZ",1901013,6,258,239,497
"KUNDUZ","KUNDUZ",1901030,3,71,210,281
"KUNDUZ","KUNDUZ",1901001,3,96,57,153
"KUNDUZ","KUNDUZ",1901031,2,67,60,127
"KUNDUZ","KUNDUZ",1901028,1,102,237,339
"KUNDUZ","KUNDUZ",1901028,2,32,184,216
"KUNDUZ","KUNDUZ",1901028,3,15,229,244
"KUNDUZ","KUNDUZ",1901028,4,31,152,183
"KUNDUZ","KUNDUZ",1901028,5,63,273,336
"KUNDUZ","KUNDUZ",1901002,1,153,297,450
"KUNDUZ","KUNDUZ",1901002,2,85,142,227
"KUNDUZ","KUNDUZ",1901048,4,40,232,272
"KUNDUZ","KUNDUZ",1901022,1,58,112,170
"KUNDUZ","KUNDUZ",1901022,2,23,155,178
"KUNDUZ","KUNDUZ",1901022,3,20,79,99
"KUNDUZ","KUNDUZ",1901022,4,6,154,160
"KUNDUZ","KUNDUZ",1901022,5,8,142,150
"KUNDUZ","KUNDUZ",1901020,5,400,126,526
"KUNDUZ","KUNDUZ",1901009,3,237,145,382
"KUNDUZ","KUNDUZ",1901009,4,168,74,242
"KUNDUZ","KUNDUZ",1901009,5,149,71,220
"KUNDUZ","KUNDUZ",1901018,3,32,187,219
"KUNDUZ","KUNDUZ",1901025,3,35,4,39
"KUNDUZ","KUNDUZ",1901025,4,7,0,7
"KUNDUZ","KUNDUZ",1901002,3,81,123,204
"KUNDUZ","KUNDUZ",1901054,2,28,113,141
"KUNDUZ","KUNDUZ",1901015,1,167,169,336
"KUNDUZ","KUNDUZ",1901015,2,297,235,532
"KUNDUZ","KUNDUZ",1901008,8,36,9,45
"KUNDUZ","KUNDUZ",1901009,1,156,89,245
"KUNDUZ","KUNDUZ",1901009,2,195,120,315
"KUNDUZ","KUNDUZ",1901036,2,72,33,105
"KUNDUZ","KUNDUZ",1901036,3,17,12,29
"KUNDUZ","KUNDUZ",1901025,1,18,19,37
"KUNDUZ","KUNDUZ",1901009,6,110,50,160
"KUNDUZ","KUNDUZ",1901004,5,231,158,389
"KUNDUZ","KUNDUZ",1901030,2,64,369,433
"KUNDUZ","KUNDUZ",1901024,1,15,315,330
"KUNDUZ","KUNDUZ",1901004,4,289,165,454
"KUNDUZ","KUNDUZ",1901035,3,16,461,477
"KUNDUZ","KUNDUZ",1901027,8,25,77,102
"KUNDUZ","KUNDUZ",1901007,2,175,108,283
"KUNDUZ","KUNDUZ",1901031,1,91,106,197
"KUNDUZ","KUNDUZ",1901025,2,15,2,17
"KUNDUZ","KUNDUZ",1901019,5,88,39,127
"KUNDUZ","KUNDUZ",1901055,3,9,8,17
"KUNDUZ","KUNDUZ",1901035,1,10,462,472
"KUNDUZ","KUNDUZ",1901024,2,35,292,327
"KUNDUZ","KUNDUZ",1901020,4,309,160,469
"KUNDUZ","KUNDUZ",1901020,1,354,147,501
"KUNDUZ","KUNDUZ",1901020,2,225,106,331
"KUNDUZ","KUNDUZ",1901020,3,390,150,540
"KUNDUZ","KUNDUZ",1901056,1,64,155,219
"KUNDUZ","KUNDUZ",1901055,2,90,159,249
"KUNDUZ","KUNDUZ",1901035,2,19,473,492
"KUNDUZ","KUNDUZ",1901055,1,33,198,231
"KUNDUZ","KUNDUZ",1901004,6,369,221,590
"KUNDUZ","KUNDUZ",1901002,4,83,108,191
"KUNDUZ","KUNDUZ",1901054,3,51,43,94
"KUNDUZ","KUNDUZ",1901001,1,92,51,143
"KUNDUZ","KUNDUZ",1901024,3,16,291,307
"KUNDUZ","KUNDUZ",1901036,1,126,52,178
"KUNDUZ","KUNDUZ",1901027,7,36,163,199
"KUNDUZ","KUNDUZ",1901002,5,93,120,213
"KUNDUZ","KUNDUZ",1901027,6,60,36,96
"KUNDUZ","KUNDUZ",1901007,1,263,183,446
"KUNDUZ","KUNDUZ",1901001,2,107,68,175
"KUNDUZ","KUNDUZ",1901029,1,5,17,22
"KUNDUZ","KUNDUZ",1901024,4,7,36,43
"KUNDUZ","KUNDUZ",1901024,5,38,67,105
"KUNDUZ","KUNDUZ",1901008,7,35,14,49
"KUNDUZ","CHAR DARA",1902123,1,103,321,424
"KUNDUZ","CHAR DARA",1902125,3,28,571,599
"KUNDUZ","CHAR DARA",1902114,1,67,327,394
"KUNDUZ","CHAR DARA",1902114,4,29,27,56
"KUNDUZ","CHAR DARA",1902114,3,39,145,184
"KUNDUZ","CHAR DARA",1902125,1,46,551,597
"KUNDUZ","CHAR DARA",1902125,2,121,478,599
"KUNDUZ","CHAR DARA",1902127,7,282,74,356
"KUNDUZ","CHAR DARA",1902116,3,81,37,118
"KUNDUZ","CHAR DARA",1902123,2,45,332,377
"KUNDUZ","CHAR DARA",1902127,5,3,177,180
"KUNDUZ","CHAR DARA",1902127,6,136,400,536
"KUNDUZ","CHAR DARA",1902122,2,3,32,35
"KUNDUZ","CHAR DARA",1902120,7,19,576,595
"KUNDUZ","CHAR DARA",1902114,2,59,255,314
"KUNDUZ","CHAR DARA",1902118,1,10,136,146
"KUNDUZ","CHAR DARA",1902115,1,50,130,180
"KUNDUZ","CHAR DARA",1902115,2,51,251,302
"KUNDUZ","CHAR DARA",1902127,4,35,20,55
"KUNDUZ","CHAR DARA",1902120,2,8,37,45
"KUNDUZ","CHAR DARA",1902117,6,107,69,176
"KUNDUZ","CHAR DARA",1902116,2,48,26,74
"KUNDUZ","CHAR DARA",1902120,6,19,573,592
"KUNDUZ","CHAR DARA",1902122,1,3,55,58
"KUNDUZ","CHAR DARA",1902115,3,137,365,502
"KUNDUZ","CHAR DARA",1902116,1,74,45,119
"KUNDUZ","CHAR DARA",1902120,4,1,205,206
"KUNDUZ","CHAR DARA",1902117,5,77,79,156
"KUNDUZ","CHAR DARA",1902117,1,126,87,213
"KUNDUZ","CHAR DARA",1902118,2,8,189,197
"KUNDUZ","CHAR DARA",1902118,3,19,207,226
"KUNDUZ","CHAR DARA",1902114,5,29,32,61
"KUNDUZ","CHAR DARA",1902120,1,40,51,91
"KUNDUZ","CHAR DARA",1902117,2,18,62,80
"KUNDUZ","CHAR DARA",1902127,3,30,388,418
"KUNDUZ","CHAR DARA",1902120,3,2,6,8
"KUNDUZ","CHAR DARA",1902127,2,33,203,236
"KUNDUZ","CHAR DARA",1902127,1,13,427,440
"KUNDUZ","ALI ABAD",1903138,5,209,11,220
"KUNDUZ","ALI ABAD",1903133,2,95,20,115
"KUNDUZ","ALI ABAD",1903134,1,21,165,186
"KUNDUZ","ALI ABAD",1903138,4,364,12,376
"KUNDUZ","ALI ABAD",1903133,1,194,25,219
"KUNDUZ","ALI ABAD",1903140,4,194,3,197
"KUNDUZ","ALI ABAD",1903135,2,311,25,336
"KUNDUZ","ALI ABAD",1903135,1,388,84,472
"KUNDUZ","ALI ABAD",1903138,3,331,19,350
"KUNDUZ","ALI ABAD",1903140,3,98,6,104
"KUNDUZ","ALI ABAD",1903138,2,179,11,190
"KUNDUZ","ALI ABAD",1903209,1,151,25,176
"KUNDUZ","ALI ABAD",1903133,3,147,17,164
"KUNDUZ","ALI ABAD",1903132,5,364,31,395
"KUNDUZ","ALI ABAD",1903134,2,16,119,135
"KUNDUZ","ALI ABAD",1903218,3,34,167,201
"KUNDUZ","ALI ABAD",1903132,4,288,22,310
"KUNDUZ","ALI ABAD",1903140,2,199,11,210
"KUNDUZ","ALI ABAD",1903138,1,144,11,155
"KUNDUZ","ALI ABAD",1903131,1,227,148,375
"KUNDUZ","ALI ABAD",1903132,3,143,24,167
"KUNDUZ","ALI ABAD",1903217,3,138,214,352
"KUNDUZ","ALI ABAD",1903209,2,304,3,307
"KUNDUZ","ALI ABAD",1903218,2,20,102,122
"KUNDUZ","ALI ABAD",1903132,2,168,43,211
"KUNDUZ","ALI ABAD",1903208,4,135,15,150
"KUNDUZ","ALI ABAD",1903132,1,229,35,264
"KUNDUZ","ALI ABAD",1903217,4,4,72,76
"KUNDUZ","ALI ABAD",1903137,1,13,269,282
"KUNDUZ","ALI ABAD",1903134,3,3,288,291
"KUNDUZ","ALI ABAD",1903208,3,196,11,207
"KUNDUZ","ALI ABAD",1903129,5,55,192,247
"KUNDUZ","ALI ABAD",1903217,2,29,65,94
"KUNDUZ","ALI ABAD",1903218,1,28,98,126
"KUNDUZ","ALI ABAD",1903137,2,14,210,224
"KUNDUZ","ALI ABAD",1903139,1,31,115,146
"KUNDUZ","ALI ABAD",1903134,4,5,234,239
"KUNDUZ","ALI ABAD",1903136,1,135,36,171
"KUNDUZ","ALI ABAD",1903136,5,120,31,151
"KUNDUZ","ALI ABAD",1903136,4,121,27,148
"KUNDUZ","ALI ABAD",1903129,3,60,201,261
"KUNDUZ","ALI ABAD",1903140,1,79,13,92
"KUNDUZ","ALI ABAD",1903129,4,60,300,360
"KUNDUZ","ALI ABAD",1903136,2,126,36,162
"KUNDUZ","ALI ABAD",1903131,2,78,72,150
"KUNDUZ","ALI ABAD",1903139,2,21,131,152
"KUNDUZ","ALI ABAD",1903139,3,25,175,200
"KUNDUZ","ALI ABAD",1903130,4,491,34,525
"KUNDUZ","ALI ABAD",1903136,3,48,14,62
"KUNDUZ","ALI ABAD",1903130,3,394,88,482
"KUNDUZ","ALI ABAD",1903217,1,30,109,139
"KUNDUZ","ALI ABAD",1903133,4,319,13,332
"KUNDUZ","ALI ABAD",1903129,2,88,236,324
"KUNDUZ","ALI ABAD",1903139,4,28,186,214
"KUNDUZ","ALI ABAD",1903131,3,70,157,227
"KUNDUZ","ALI ABAD",1903130,5,412,94,506
"KUNDUZ","ALI ABAD",1903208,2,272,188,460
"KUNDUZ","ALI ABAD",1903133,5,214,215,429
"KUNDUZ","ALI ABAD",1903130,1,361,61,422
"KUNDUZ","ALI ABAD",1903131,5,83,49,132
"KUNDUZ","ALI ABAD",1903131,4,95,18,113
"KUNDUZ","ALI ABAD",1903137,3,8,186,194
"KUNDUZ","ALI ABAD",1903129,1,110,219,329
"KUNDUZ","ALI ABAD",1903130,2,104,92,196
"KUNDUZ","ALI ABAD",1903208,1,272,140,412
"KUNDUZ","ALI ABAD",1903137,4,12,372,384
"KUNDUZ","KHAN ABAD",1904211,2,88,2,90
"KUNDUZ","KHAN ABAD",1904149,2,65,535,600
"KUNDUZ","KHAN ABAD",1904211,1,91,0,91
"KUNDUZ","KHAN ABAD",1904176,3,13,555,568
"KUNDUZ","KHAN ABAD",1904163,2,41,205,246
"KUNDUZ","KHAN ABAD",1904149,1,16,582,598
"KUNDUZ","KHAN ABAD",1904159,2,90,290,380
"KUNDUZ","KHAN ABAD",1904213,1,119,122,241
"KUNDUZ","KHAN ABAD",1904176,2,11,566,577
"KUNDUZ","KHAN ABAD",1904163,1,33,101,134
"KUNDUZ","KHAN ABAD",1904173,3,120,101,221
"KUNDUZ","KHAN ABAD",1904152,1,99,67,166
"KUNDUZ","KHAN ABAD",1904160,1,114,178,292
"KUNDUZ","KHAN ABAD",1904173,1,210,178,388
"KUNDUZ","KHAN ABAD",1904173,2,209,175,384
"KUNDUZ","KHAN ABAD",1904159,1,101,369,470
"KUNDUZ","KHAN ABAD",1904165,2,476,123,599
"KUNDUZ","KHAN ABAD",1904168,2,313,206,519
"KUNDUZ","KHAN ABAD",1904147,1,0,268,268
"KUNDUZ","KHAN ABAD",1904153,2,56,146,202
"KUNDUZ","KHAN ABAD",1904168,1,415,156,571
"KUNDUZ","KHAN ABAD",1904158,2,136,231,367
"KUNDUZ","KHAN ABAD",1904170,2,189,9,198
"KUNDUZ","KHAN ABAD",1904176,1,27,526,553
"KUNDUZ","KHAN ABAD",1904141,3,125,57,182
"KUNDUZ","KHAN ABAD",1904141,4,136,93,229
"KUNDUZ","KHAN ABAD",1904141,5,294,171,465
"KUNDUZ","KHAN ABAD",1904152,2,14,202,216
"KUNDUZ","KHAN ABAD",1904213,2,386,47,433
"KUNDUZ","KHAN ABAD",1904162,4,30,338,368
"KUNDUZ","KHAN ABAD",1904170,1,234,24,258
"KUNDUZ","KHAN ABAD",1904160,2,51,58,109
"KUNDUZ","KHAN ABAD",1904162,3,46,466,512
"KUNDUZ","KHAN ABAD",1904143,2,8,554,562
"KUNDUZ","KHAN ABAD",1904212,1,6,8,14
"KUNDUZ","KHAN ABAD",1904174,2,312,11,323
"KUNDUZ","KHAN ABAD",1904153,1,83,147,230
"KUNDUZ","KHAN ABAD",1904175,1,123,32,155
"KUNDUZ","KHAN ABAD",1904161,1,75,445,520
"KUNDUZ","KHAN ABAD",1904212,2,2,9,11
"KUNDUZ","KHAN ABAD",1904212,4,0,33,33
"KUNDUZ","KHAN ABAD",1904150,2,158,12,170
"KUNDUZ","KHAN ABAD",1904165,1,397,200,597
"KUNDUZ","KHAN ABAD",1904174,1,275,101,376
"KUNDUZ","KHAN ABAD",1904164,2,130,298,428
"KUNDUZ","KHAN ABAD",1904141,2,337,141,478
"KUNDUZ","KHAN ABAD",1904210,1,118,23,141
"KUNDUZ","KHAN ABAD",1904151,2,34,43,77
"KUNDUZ","KHAN ABAD",1904143,3,5,11,16
"KUNDUZ","KHAN ABAD",1904145,1,293,72,365
"KUNDUZ","KHAN ABAD",1904145,2,166,106,272
"KUNDUZ","KHAN ABAD",1904175,2,78,10,88
"KUNDUZ","KHAN ABAD",1904142,1,57,110,167
"KUNDUZ","KHAN ABAD",1904162,2,31,287,318
"KUNDUZ","KHAN ABAD",1904154,3,162,56,218
"KUNDUZ","KHAN ABAD",1904158,1,105,93,198
"KUNDUZ","KHAN ABAD",1904164,1,72,63,135
"KUNDUZ","KHAN ABAD",1904167,1,76,59,135
"KUNDUZ","KHAN ABAD",1904143,1,11,516,527
"KUNDUZ","KHAN ABAD",1904177,2,256,220,476
"KUNDUZ","KHAN ABAD",1904151,1,165,175,340
"KUNDUZ","KHAN ABAD",1904175,3,96,8,104
"KUNDUZ","KHAN ABAD",1904162,1,62,299,361
"KUNDUZ","KHAN ABAD",1904150,1,167,53,220
"KUNDUZ","KHAN ABAD",1904145,3,473,125,598
"KUNDUZ","KHAN ABAD",1904167,2,40,19,59
"KUNDUZ","KHAN ABAD",1904142,2,44,159,203
"KUNDUZ","KHAN ABAD",1904141,1,368,163,531
"KUNDUZ","KHAN ABAD",1904211,3,251,3,254
"KUNDUZ","KHAN ABAD",1904148,2,71,29,100
"KUNDUZ","KHAN ABAD",1904144,1,13,50,63
"KUNDUZ","KHAN ABAD",1904161,2,12,472,484
"KUNDUZ","KHAN ABAD",1904177,1,335,231,566
"KUNDUZ","KHAN ABAD",1904154,2,255,95,350
"KUNDUZ","KHAN ABAD",1904156,1,71,271,342
"KUNDUZ","KHAN ABAD",1904156,2,66,53,119
"KUNDUZ","KHAN ABAD",1904154,1,200,87,287
"KUNDUZ","KHAN ABAD",1904148,1,81,18,99
"KUNDUZ","KHAN ABAD",1904144,3,33,79,112
"KUNDUZ","KHAN ABAD",1904166,2,561,1,562
"KUNDUZ","KHAN ABAD",1904142,3,31,82,113
"KUNDUZ","KHAN ABAD",1904147,2,0,13,13
"KUNDUZ","KHAN ABAD",1904166,1,269,11,280
"KUNDUZ","KHAN ABAD",1904144,2,3,12,15
"KUNDUZ","KHAN ABAD",1904171,1,289,18,307
"KUNDUZ","KHAN ABAD",1904210,2,34,3,37
"KUNDUZ","KHAN ABAD",1904155,2,26,4,30
"KUNDUZ","KHAN ABAD",1904171,2,145,7,152
"KUNDUZ","KHAN ABAD",1904155,1,94,15,109
"KUNDUZ","HAZRAT-E-IMAM",1905082,1,291,187,478
"KUNDUZ","HAZRAT-E-IMAM",1905093,1,301,206,507
"KUNDUZ","HAZRAT-E-IMAM",1905078,1,18,67,85
"KUNDUZ","HAZRAT-E-IMAM",1905085,5,90,308,398
"KUNDUZ","HAZRAT-E-IMAM",1905085,6,9,21,30
"KUNDUZ","HAZRAT-E-IMAM",1905069,4,67,26,93
"KUNDUZ","HAZRAT-E-IMAM",1905082,2,266,182,448
"KUNDUZ","HAZRAT-E-IMAM",1905093,3,357,226,583
"KUNDUZ","HAZRAT-E-IMAM",1905084,4,46,90,136
"KUNDUZ","HAZRAT-E-IMAM",1905093,4,219,172,391
"KUNDUZ","HAZRAT-E-IMAM",1905093,2,381,196,577
"KUNDUZ","HAZRAT-E-IMAM",1905085,4,25,575,600
"KUNDUZ","HAZRAT-E-IMAM",1905203,1,83,94,177
"KUNDUZ","HAZRAT-E-IMAM",1905087,2,77,133,210
"KUNDUZ","HAZRAT-E-IMAM",1905077,1,26,31,57
"KUNDUZ","HAZRAT-E-IMAM",1905077,2,1,5,6
"KUNDUZ","HAZRAT-E-IMAM",1905084,3,26,47,73
"KUNDUZ","HAZRAT-E-IMAM",1905091,2,137,78,215
"KUNDUZ","HAZRAT-E-IMAM",1905087,3,81,132,213
"KUNDUZ","HAZRAT-E-IMAM",1905087,4,96,70,166
"KUNDUZ","HAZRAT-E-IMAM",1905091,1,123,76,199
"KUNDUZ","HAZRAT-E-IMAM",1905087,1,110,113,223
"KUNDUZ","HAZRAT-E-IMAM",1905203,2,91,106,197
"KUNDUZ","HAZRAT-E-IMAM",1905084,1,70,93,163
"KUNDUZ","HAZRAT-E-IMAM",1905079,4,60,52,112
"KUNDUZ","HAZRAT-E-IMAM",1905095,1,79,10,89
"KUNDUZ","HAZRAT-E-IMAM",1905079,2,28,146,174
"KUNDUZ","HAZRAT-E-IMAM",1905079,3,41,99,140
"KUNDUZ","HAZRAT-E-IMAM",1905095,4,108,2,110
"KUNDUZ","HAZRAT-E-IMAM",1905092,1,251,165,416
"KUNDUZ","HAZRAT-E-IMAM",1905095,2,56,7,63
"KUNDUZ","HAZRAT-E-IMAM",1905095,3,36,8,44
"KUNDUZ","HAZRAT-E-IMAM",1905070,2,87,210,297
"KUNDUZ","HAZRAT-E-IMAM",1905085,3,63,235,298
"KUNDUZ","HAZRAT-E-IMAM",1905085,2,55,233,288
"KUNDUZ","HAZRAT-E-IMAM",1905069,2,31,19,50
"KUNDUZ","HAZRAT-E-IMAM",1905069,3,28,30,58
"KUNDUZ","HAZRAT-E-IMAM",1905086,3,32,55,87
"KUNDUZ","HAZRAT-E-IMAM",1905086,5,41,17,58
"KUNDUZ","HAZRAT-E-IMAM",1905086,6,52,19,71
"KUNDUZ","HAZRAT-E-IMAM",1905065,2,15,56,71
"KUNDUZ","HAZRAT-E-IMAM",1905065,3,6,45,51
"KUNDUZ","HAZRAT-E-IMAM",1905082,3,200,108,308
"KUNDUZ","HAZRAT-E-IMAM",1905092,2,159,71,230
"KUNDUZ","HAZRAT-E-IMAM",1905070,1,116,160,276
"KUNDUZ","HAZRAT-E-IMAM",1905092,4,288,210,498
"KUNDUZ","HAZRAT-E-IMAM",1905084,2,35,30,65
"KUNDUZ","HAZRAT-E-IMAM",1905069,1,32,14,46
"KUNDUZ","HAZRAT-E-IMAM",1905083,2,38,375,413
"KUNDUZ","HAZRAT-E-IMAM",1905083,3,50,280,330
"KUNDUZ","HAZRAT-E-IMAM",1905200,1,67,360,427
"KUNDUZ","HAZRAT-E-IMAM",1905200,2,27,327,354
"KUNDUZ","HAZRAT-E-IMAM",1905200,3,33,170,203
"KUNDUZ","HAZRAT-E-IMAM",1905200,4,25,217,242
"KUNDUZ","HAZRAT-E-IMAM",1905091,3,171,60,231
"KUNDUZ","HAZRAT-E-IMAM",1905091,4,250,138,388
"KUNDUZ","HAZRAT-E-IMAM",1905091,5,225,94,319
"KUNDUZ","HAZRAT-E-IMAM",1905092,3,90,50,140
"KUNDUZ","HAZRAT-E-IMAM",1905080,1,146,48,194
"KUNDUZ","HAZRAT-E-IMAM",1905068,3,36,23,59
"KUNDUZ","HAZRAT-E-IMAM",1905083,1,29,466,495
"KUNDUZ","HAZRAT-E-IMAM",1905079,1,41,93,134
"KUNDUZ","HAZRAT-E-IMAM",1905072,3,65,160,225
"KUNDUZ","HAZRAT-E-IMAM",1905074,1,38,42,80
"KUNDUZ","HAZRAT-E-IMAM",1905074,2,68,213,281
"KUNDUZ","HAZRAT-E-IMAM",1905074,3,66,110,176
"KUNDUZ","HAZRAT-E-IMAM",1905074,4,73,152,225
"KUNDUZ","HAZRAT-E-IMAM",1905074,5,78,115,193
"KUNDUZ","HAZRAT-E-IMAM",1905074,6,80,235,315
"KUNDUZ","HAZRAT-E-IMAM",1905074,7,119,120,239
"KUNDUZ","HAZRAT-E-IMAM",1905078,2,20,69,89
"KUNDUZ","HAZRAT-E-IMAM",1905078,3,3,3,6
"KUNDUZ","HAZRAT-E-IMAM",1905080,2,94,28,122
"KUNDUZ","HAZRAT-E-IMAM",1905085,1,37,108,145
"KUNDUZ","HAZRAT-E-IMAM",1905097,4,13,83,96
"KUNDUZ","HAZRAT-E-IMAM",1905086,1,18,25,43
"KUNDUZ","HAZRAT-E-IMAM",1905086,2,25,30,55
"KUNDUZ","HAZRAT-E-IMAM",1905063,2,68,140,208
"KUNDUZ","HAZRAT-E-IMAM",1905086,4,32,47,79
"KUNDUZ","HAZRAT-E-IMAM",1905065,1,18,81,99
"KUNDUZ","HAZRAT-E-IMAM",1905070,4,53,160,213
"KUNDUZ","HAZRAT-E-IMAM",1905058,1,104,333,437
"KUNDUZ","HAZRAT-E-IMAM",1905065,4,9,99,108
"KUNDUZ","HAZRAT-E-IMAM",1905065,5,9,88,97
"KUNDUZ","HAZRAT-E-IMAM",1905081,3,53,222,275
"KUNDUZ","HAZRAT-E-IMAM",1905068,1,85,40,125
"KUNDUZ","HAZRAT-E-IMAM",1905068,2,61,49,110
"KUNDUZ","HAZRAT-E-IMAM",1905094,2,82,23,105
"KUNDUZ","HAZRAT-E-IMAM",1905094,3,67,36,103
"KUNDUZ","HAZRAT-E-IMAM",1905094,4,147,20,167
"KUNDUZ","HAZRAT-E-IMAM",1905201,2,51,148,199
"KUNDUZ","HAZRAT-E-IMAM",1905201,3,305,143,448
"KUNDUZ","HAZRAT-E-IMAM",1905070,3,94,82,176
"KUNDUZ","HAZRAT-E-IMAM",1905059,4,108,204,312
"KUNDUZ","HAZRAT-E-IMAM",1905059,5,42,306,348
"KUNDUZ","HAZRAT-E-IMAM",1905200,5,3,435,438
"KUNDUZ","HAZRAT-E-IMAM",1905200,6,3,100,103
"KUNDUZ","HAZRAT-E-IMAM",1905090,1,37,141,178
"KUNDUZ","HAZRAT-E-IMAM",1905081,4,27,173,200
"KUNDUZ","HAZRAT-E-IMAM",1905094,1,62,43,105
"KUNDUZ","HAZRAT-E-IMAM",1905090,4,29,123,152
"KUNDUZ","HAZRAT-E-IMAM",1905072,2,73,168,241
"KUNDUZ","HAZRAT-E-IMAM",1905061,2,103,66,169
"KUNDUZ","HAZRAT-E-IMAM",1905059,1,103,126,229
"KUNDUZ","HAZRAT-E-IMAM",1905059,2,56,207,263
"KUNDUZ","HAZRAT-E-IMAM",1905059,3,47,153,200
"KUNDUZ","HAZRAT-E-IMAM",1905063,4,134,105,239
"KUNDUZ","HAZRAT-E-IMAM",1905098,2,149,19,168
"KUNDUZ","HAZRAT-E-IMAM",1905057,1,142,169,311
"KUNDUZ","HAZRAT-E-IMAM",1905057,2,75,93,168
"KUNDUZ","HAZRAT-E-IMAM",1905057,3,66,167,233
"KUNDUZ","HAZRAT-E-IMAM",1905097,1,26,150,176
"KUNDUZ","HAZRAT-E-IMAM",1905097,2,43,161,204
"KUNDUZ","HAZRAT-E-IMAM",1905097,3,51,152,203
"KUNDUZ","HAZRAT-E-IMAM",1905075,2,3,54,57
"KUNDUZ","HAZRAT-E-IMAM",1905057,6,113,173,286
"KUNDUZ","HAZRAT-E-IMAM",1905063,1,105,173,278
"KUNDUZ","HAZRAT-E-IMAM",1905064,5,60,438,498
"KUNDUZ","HAZRAT-E-IMAM",1905063,3,49,99,148
"KUNDUZ","HAZRAT-E-IMAM",1905098,1,132,29,161
"KUNDUZ","HAZRAT-E-IMAM",1905067,2,48,20,68
"KUNDUZ","HAZRAT-E-IMAM",1905098,3,104,13,117
"KUNDUZ","HAZRAT-E-IMAM",1905098,4,128,8,136
"KUNDUZ","HAZRAT-E-IMAM",1905088,1,35,115,150
"KUNDUZ","HAZRAT-E-IMAM",1905203,3,80,67,147
"KUNDUZ","HAZRAT-E-IMAM",1905089,1,126,15,141
"KUNDUZ","HAZRAT-E-IMAM",1905089,2,146,18,164
"KUNDUZ","HAZRAT-E-IMAM",1905089,3,150,31,181
"KUNDUZ","HAZRAT-E-IMAM",1905089,4,328,24,352
"KUNDUZ","HAZRAT-E-IMAM",1905201,1,136,246,382
"KUNDUZ","HAZRAT-E-IMAM",1905202,3,71,42,113
"KUNDUZ","HAZRAT-E-IMAM",1905060,1,98,147,245
"KUNDUZ","HAZRAT-E-IMAM",1905067,1,76,21,97
"KUNDUZ","HAZRAT-E-IMAM",1905060,2,65,153,218
"KUNDUZ","HAZRAT-E-IMAM",1905067,3,79,27,106
"KUNDUZ","HAZRAT-E-IMAM",1905067,4,140,9,149
"KUNDUZ","HAZRAT-E-IMAM",1905073,1,212,70,282
"KUNDUZ","HAZRAT-E-IMAM",1905088,2,39,106,145
"KUNDUZ","HAZRAT-E-IMAM",1905090,2,35,198,233
"KUNDUZ","HAZRAT-E-IMAM",1905090,3,28,131,159
"KUNDUZ","HAZRAT-E-IMAM",1905072,1,57,120,177
"KUNDUZ","HAZRAT-E-IMAM",1905096,4,147,4,151
"KUNDUZ","HAZRAT-E-IMAM",1905202,2,38,25,63
"KUNDUZ","HAZRAT-E-IMAM",1905064,4,85,339,424
"KUNDUZ","HAZRAT-E-IMAM",1905202,4,48,30,78
"KUNDUZ","HAZRAT-E-IMAM",1905071,4,26,167,193
"KUNDUZ","HAZRAT-E-IMAM",1905058,2,111,220,331
"KUNDUZ","HAZRAT-E-IMAM",1905060,3,80,71,151
"KUNDUZ","HAZRAT-E-IMAM",1905060,4,111,291,402
"KUNDUZ","HAZRAT-E-IMAM",1905075,1,17,16,33
"KUNDUZ","HAZRAT-E-IMAM",1905057,5,114,234,348
"KUNDUZ","HAZRAT-E-IMAM",1905062,1,23,150,173
"KUNDUZ","HAZRAT-E-IMAM",1905062,2,18,77,95
"KUNDUZ","HAZRAT-E-IMAM",1905071,3,14,103,117
"KUNDUZ","HAZRAT-E-IMAM",1905081,1,48,350,398
"KUNDUZ","HAZRAT-E-IMAM",1905064,3,75,358,433
"KUNDUZ","HAZRAT-E-IMAM",1905061,1,46,136,182
"KUNDUZ","HAZRAT-E-IMAM",1905082,4,201,128,329
"KUNDUZ","HAZRAT-E-IMAM",1905071,2,21,171,192
"KUNDUZ","HAZRAT-E-IMAM",1905081,2,43,186,229
"KUNDUZ","HAZRAT-E-IMAM",1905058,3,59,145,204
"KUNDUZ","HAZRAT-E-IMAM",1905058,6,31,95,126
"KUNDUZ","HAZRAT-E-IMAM",1905096,1,130,11,141
"KUNDUZ","HAZRAT-E-IMAM",1905096,2,94,5,99
"KUNDUZ","HAZRAT-E-IMAM",1905202,1,23,24,47
"KUNDUZ","HAZRAT-E-IMAM",1905073,2,292,136,428
"KUNDUZ","HAZRAT-E-IMAM",1905058,5,52,102,154
"KUNDUZ","HAZRAT-E-IMAM",1905071,1,24,149,173
"KUNDUZ","HAZRAT-E-IMAM",1905096,3,93,7,100
"KUNDUZ","HAZRAT-E-IMAM",1905064,2,87,411,498
"KUNDUZ","HAZRAT-E-IMAM",1905088,4,101,184,285
"KUNDUZ","HAZRAT-E-IMAM",1905073,3,227,47,274
"KUNDUZ","HAZRAT-E-IMAM",1905203,4,35,59,94
"KUNDUZ","HAZRAT-E-IMAM",1905057,4,53,116,169
"KUNDUZ","HAZRAT-E-IMAM",1905064,1,66,251,317
"KUNDUZ","HAZRAT-E-IMAM",1905065,6,10,87,97
"KUNDUZ","HAZRAT-E-IMAM",1905073,5,165,34,199
"KUNDUZ","HAZRAT-E-IMAM",1905073,4,170,61,231
"KUNDUZ","HAZRAT-E-IMAM",1905088,3,76,158,234
"KUNDUZ","HAZRAT-E-IMAM",1905058,4,67,118,185
"KUNDUZ","DASHT-E-ARCHI",1906216,3,45,60,105
"KUNDUZ","DASHT-E-ARCHI",1906182,5,66,250,316
"KUNDUZ","DASHT-E-ARCHI",1906216,4,61,57,118
"KUNDUZ","DASHT-E-ARCHI",1906182,6,75,379,454
"KUNDUZ","DASHT-E-ARCHI",1906188,1,1,60,61
"KUNDUZ","DASHT-E-ARCHI",1906216,2,24,5,29
"KUNDUZ","DASHT-E-ARCHI",1906182,3,86,357,443
"KUNDUZ","DASHT-E-ARCHI",1906179,1,38,59,97
"KUNDUZ","DASHT-E-ARCHI",1906182,4,73,269,342
"KUNDUZ","DASHT-E-ARCHI",1906215,1,33,154,187
"KUNDUZ","DASHT-E-ARCHI",1906183,2,39,542,581
"KUNDUZ","DASHT-E-ARCHI",1906182,1,69,136,205
"KUNDUZ","DASHT-E-ARCHI",1906193,1,26,144,170
"KUNDUZ","DASHT-E-ARCHI",1906182,2,90,259,349
"KUNDUZ","DASHT-E-ARCHI",1906188,2,1,34,35
"KUNDUZ","DASHT-E-ARCHI",1906179,4,158,267,425
"KUNDUZ","DASHT-E-ARCHI",1906214,2,34,540,574
"KUNDUZ","DASHT-E-ARCHI",1906194,1,31,15,46
"KUNDUZ","DASHT-E-ARCHI",1906216,1,31,15,46
"KUNDUZ","DASHT-E-ARCHI",1906185,3,27,172,199
"KUNDUZ","DASHT-E-ARCHI",1906183,1,23,562,585
"KUNDUZ","DASHT-E-ARCHI",1906179,2,56,124,180
"KUNDUZ","DASHT-E-ARCHI",1906179,3,64,105,169
"KUNDUZ","DASHT-E-ARCHI",1906183,3,31,558,589
"KUNDUZ","DASHT-E-ARCHI",1906193,4,54,174,228
"KUNDUZ","DASHT-E-ARCHI",1906190,1,30,314,344
"KUNDUZ","DASHT-E-ARCHI",1906185,2,209,284,493
"KUNDUZ","DASHT-E-ARCHI",1906193,3,21,176,197
"KUNDUZ","DASHT-E-ARCHI",1906181,4,4,97,101
"KUNDUZ","DASHT-E-ARCHI",1906214,1,80,518,598
"KUNDUZ","DASHT-E-ARCHI",1906187,2,100,294,394
"KUNDUZ","DASHT-E-ARCHI",1906187,1,45,348,393
"KUNDUZ","DASHT-E-ARCHI",1906178,2,74,136,210
"KUNDUZ","DASHT-E-ARCHI",1906181,1,6,49,55
"KUNDUZ","DASHT-E-ARCHI",1906193,5,26,209,235
"KUNDUZ","DASHT-E-ARCHI",1906193,2,19,242,261
"KUNDUZ","DASHT-E-ARCHI",1906181,3,10,80,90
"KUNDUZ","DASHT-E-ARCHI",1906178,3,73,168,241
"KUNDUZ","DASHT-E-ARCHI",1906190,5,14,543,557
"KUNDUZ","DASHT-E-ARCHI",1906189,4,48,120,168
"KUNDUZ","DASHT-E-ARCHI",1906185,1,90,395,485
"KUNDUZ","DASHT-E-ARCHI",1906189,5,22,169,191
"KUNDUZ","DASHT-E-ARCHI",1906188,3,4,17,21
"KUNDUZ","DASHT-E-ARCHI",1906189,1,60,142,202
"KUNDUZ","DASHT-E-ARCHI",1906180,3,22,171,193
"KUNDUZ","DASHT-E-ARCHI",1906180,1,29,156,185
"KUNDUZ","DASHT-E-ARCHI",1906178,6,63,111,174
"KUNDUZ","DASHT-E-ARCHI",1906180,2,15,167,182
"KUNDUZ","DASHT-E-ARCHI",1906190,3,52,255,307
"KUNDUZ","DASHT-E-ARCHI",1906178,5,106,163,269
"KUNDUZ","DASHT-E-ARCHI",1906190,2,53,261,314
"KUNDUZ","DASHT-E-ARCHI",1906181,2,17,54,71
"KUNDUZ","DASHT-E-ARCHI",1906178,1,64,138,202
"KUNDUZ","DASHT-E-ARCHI",1906189,2,46,117,163
"KUNDUZ","DASHT-E-ARCHI",1906189,3,108,228,336
"KUNDUZ","DASHT-E-ARCHI",1906178,4,30,68,98
"KUNDUZ","DASHT-E-ARCHI",1906190,4,16,382,398
"KUNDUZ","DASHT-E-ARCHI",1906180,4,34,529,563
"KUNDUZ","QALA-E-ZAL",1907106,2,12,6,18
"KUNDUZ","QALA-E-ZAL",1907219,2,280,201,481
"KUNDUZ","QALA-E-ZAL",1907107,1,39,71,110
"KUNDUZ","QALA-E-ZAL",1907204,1,110,117,227
"KUNDUZ","QALA-E-ZAL",1907219,3,341,183,524
"KUNDUZ","QALA-E-ZAL",1907100,3,101,114,215
"KUNDUZ","QALA-E-ZAL",1907101,1,58,157,215
"KUNDUZ","QALA-E-ZAL",1907101,2,56,136,192
"KUNDUZ","QALA-E-ZAL",1907100,2,102,106,208
"KUNDUZ","QALA-E-ZAL",1907106,1,15,26,41
"KUNDUZ","QALA-E-ZAL",1907105,4,1,1,2
"KUNDUZ","QALA-E-ZAL",1907105,3,1,3,4
"KUNDUZ","QALA-E-ZAL",1907100,1,92,93,185
"KUNDUZ","QALA-E-ZAL",1907102,3,45,121,166
"KUNDUZ","QALA-E-ZAL",1907101,3,26,78,104
"KUNDUZ","QALA-E-ZAL",1907100,4,146,191,337
"KUNDUZ","QALA-E-ZAL",1907205,2,27,154,181
"KUNDUZ","QALA-E-ZAL",1907204,2,34,72,106
"KUNDUZ","QALA-E-ZAL",1907109,1,84,126,210
"KUNDUZ","QALA-E-ZAL",1907110,3,1,51,52
"KUNDUZ","QALA-E-ZAL",1907109,3,105,139,244
"KUNDUZ","QALA-E-ZAL",1907110,1,15,68,83
"KUNDUZ","QALA-E-ZAL",1907104,1,126,89,215
"KUNDUZ","QALA-E-ZAL",1907109,2,94,168,262
"KUNDUZ","QALA-E-ZAL",1907205,1,78,248,326
"KUNDUZ","QALA-E-ZAL",1907105,2,6,23,29
"KUNDUZ","QALA-E-ZAL",1907111,2,8,159,167
"KUNDUZ","QALA-E-ZAL",1907219,1,270,226,496
"KUNDUZ","QALA-E-ZAL",1907110,2,10,68,78
"KUNDUZ","QALA-E-ZAL",1907105,1,8,21,29
"KUNDUZ","QALA-E-ZAL",1907103,2,82,54,136
"KUNDUZ","QALA-E-ZAL",1907112,2,46,19,65
"KUNDUZ","QALA-E-ZAL",1907107,2,35,120,155
"KUNDUZ","QALA-E-ZAL",1907107,3,58,78,136
"KUNDUZ","QALA-E-ZAL",1907112,1,121,39,160
"KUNDUZ","QALA-E-ZAL",1907103,1,85,39,124
"KUNDUZ","QALA-E-ZAL",1907099,5,63,289,352
"KUNDUZ","QALA-E-ZAL",1907103,4,174,122,296
"KUNDUZ","QALA-E-ZAL",1907102,2,36,91,127
"KUNDUZ","QALA-E-ZAL",1907099,1,46,106,152
"KUNDUZ","QALA-E-ZAL",1907099,2,48,151,199
"KUNDUZ","QALA-E-ZAL",1907111,1,26,163,189
"KUNDUZ","QALA-E-ZAL",1907101,4,70,191,261
"KUNDUZ","QALA-E-ZAL",1907103,3,117,79,196
"KUNDUZ","QALA-E-ZAL",1907108,1,178,139,317
"KUNDUZ","QALA-E-ZAL",1907206,1,28,94,122
"KUNDUZ","QALA-E-ZAL",1907102,1,52,152,204
"KUNDUZ","QALA-E-ZAL",1907104,2,97,67,164
"KUNDUZ","QALA-E-ZAL",1907108,4,313,196,509
"KUNDUZ","QALA-E-ZAL",1907104,3,86,70,156
"KUNDUZ","QALA-E-ZAL",1907099,3,51,131,182
"KUNDUZ","QALA-E-ZAL",1907099,4,28,161,189
"KUNDUZ","QALA-E-ZAL",1907108,3,229,170,399
"KUNDUZ","QALA-E-ZAL",1907113,2,2,6,8
"KUNDUZ","QALA-E-ZAL",1907104,4,99,206,305
"KUNDUZ","QALA-E-ZAL",1907206,2,60,429,489
"KUNDUZ","QALA-E-ZAL",1907108,2,223,129,352
"KUNDUZ","QALA-E-ZAL",1907113,1,21,17,38
"SAMANGAN","AYBAK",2001007,4,409,178,587
"SAMANGAN","AYBAK",2001007,3,397,194,591
"SAMANGAN","AYBAK",2001007,2,396,180,576
"SAMANGAN","AYBAK",2001007,1,417,174,591
"SAMANGAN","AYBAK",2001007,6,237,132,369
"SAMANGAN","AYBAK",2001010,4,141,124,265
"SAMANGAN","AYBAK",2001015,3,37,470,507
"SAMANGAN","AYBAK",2001007,5,318,123,441
"SAMANGAN","AYBAK",2001011,5,205,75,280
"SAMANGAN","AYBAK",2001011,6,195,64,259
"SAMANGAN","AYBAK",2001005,5,102,424,526
"SAMANGAN","AYBAK",2001011,4,273,70,343
"SAMANGAN","AYBAK",2001015,1,137,383,520
"SAMANGAN","AYBAK",2001015,2,102,254,356
"SAMANGAN","AYBAK",2001011,7,106,60,166
"SAMANGAN","AYBAK",2001010,5,168,113,281
"SAMANGAN","AYBAK",2001003,1,50,428,478
"SAMANGAN","AYBAK",2001005,1,54,376,430
"SAMANGAN","AYBAK",2001007,7,397,100,497
"SAMANGAN","AYBAK",2001005,4,79,510,589
"SAMANGAN","AYBAK",2001010,3,332,203,535
"SAMANGAN","AYBAK",2001006,2,139,386,525
"SAMANGAN","AYBAK",2001005,2,75,315,390
"SAMANGAN","AYBAK",2001010,2,257,190,447
"SAMANGAN","AYBAK",2001007,8,305,124,429
"SAMANGAN","AYBAK",2001007,9,257,154,411
"SAMANGAN","AYBAK",2001006,3,121,375,496
"SAMANGAN","AYBAK",2001010,6,381,204,585
"SAMANGAN","AYBAK",2001011,3,258,93,351
"SAMANGAN","AYBAK",2001001,3,76,31,107
"SAMANGAN","AYBAK",2001009,5,256,336,592
"SAMANGAN","AYBAK",2001009,6,221,371,592
"SAMANGAN","AYBAK",2001009,7,98,185,283
"SAMANGAN","AYBAK",2001006,1,91,227,318
"SAMANGAN","AYBAK",2001003,5,54,537,591
"SAMANGAN","AYBAK",2001003,6,6,95,101
"SAMANGAN","AYBAK",2001006,4,99,308,407
"SAMANGAN","AYBAK",2001010,7,311,275,586
"SAMANGAN","AYBAK",2001010,8,361,232,593
"SAMANGAN","AYBAK",2001010,9,100,46,146
"SAMANGAN","AYBAK",2001011,2,223,101,324
"SAMANGAN","AYBAK",2001016,4,113,20,133
"SAMANGAN","AYBAK",2001009,4,142,326,468
"SAMANGAN","AYBAK",2001012,3,285,4,289
"SAMANGAN","AYBAK",2001003,2,15,258,273
"SAMANGAN","AYBAK",2001003,3,61,531,592
"SAMANGAN","AYBAK",2001003,4,53,538,591
"SAMANGAN","AYBAK",2001018,3,27,151,178
"SAMANGAN","AYBAK",2001018,4,68,151,219
"SAMANGAN","AYBAK",2001004,1,51,236,287
"SAMANGAN","AYBAK",2001014,1,23,421,444
"SAMANGAN","AYBAK",2001006,5,194,387,581
"SAMANGAN","AYBAK",2001012,1,353,17,370
"SAMANGAN","AYBAK",2001011,1,228,97,325
"SAMANGAN","AYBAK",2001005,3,55,276,331
"SAMANGAN","AYBAK",2001012,2,407,20,427
"SAMANGAN","AYBAK",2001002,3,198,49,247
"SAMANGAN","AYBAK",2001002,4,215,58,273
"SAMANGAN","AYBAK",2001010,1,253,166,419
"SAMANGAN","AYBAK",2001018,2,49,143,192
"SAMANGAN","AYBAK",2001012,5,404,14,418
"SAMANGAN","AYBAK",2001012,6,566,20,586
"SAMANGAN","AYBAK",2001089,2,13,55,68
"SAMANGAN","AYBAK",2001089,3,41,186,227
"SAMANGAN","AYBAK",2001004,2,43,195,238
"SAMANGAN","AYBAK",2001014,2,26,399,425
"SAMANGAN","AYBAK",2001013,1,172,12,184
"SAMANGAN","AYBAK",2001009,3,118,301,419
"SAMANGAN","AYBAK",2001001,2,85,64,149
"SAMANGAN","AYBAK",2001013,3,37,2,39
"SAMANGAN","AYBAK",2001013,4,415,17,432
"SAMANGAN","AYBAK",2001018,1,56,224,280
"SAMANGAN","AYBAK",2001012,4,90,0,90
"SAMANGAN","AYBAK",2001008,5,398,176,574
"SAMANGAN","AYBAK",2001008,6,446,143,589
"SAMANGAN","AYBAK",2001017,1,29,425,454
"SAMANGAN","AYBAK",2001017,2,27,258,285
"SAMANGAN","AYBAK",2001008,9,261,145,406
"SAMANGAN","AYBAK",2001004,3,46,176,222
"SAMANGAN","AYBAK",2001006,6,162,422,584
"SAMANGAN","AYBAK",2001009,1,137,235,372
"SAMANGAN","AYBAK",2001009,2,67,126,193
"SAMANGAN","AYBAK",2001016,3,487,91,578
"SAMANGAN","AYBAK",2001008,3,422,160,582
"SAMANGAN","AYBAK",2001008,4,381,202,583
"SAMANGAN","AYBAK",2001089,1,40,76,116
"SAMANGAN","AYBAK",2001016,2,318,71,389
"SAMANGAN","AYBAK",2001002,2,162,43,205
"SAMANGAN","AYBAK",2001008,7,243,133,376
"SAMANGAN","AYBAK",2001016,1,282,54,336
"SAMANGAN","AYBAK",2001008,8,351,137,488
"SAMANGAN","AYBAK",2001006,7,49,180,229
"SAMANGAN","AYBAK",2001004,4,123,415,538
"SAMANGAN","AYBAK",2001087,5,242,70,312
"SAMANGAN","AYBAK",2001088,1,47,387,434
"SAMANGAN","AYBAK",2001008,1,393,193,586
"SAMANGAN","AYBAK",2001087,4,361,220,581
"SAMANGAN","AYBAK",2001008,2,417,172,589
"SAMANGAN","AYBAK",2001087,2,231,95,326
"SAMANGAN","AYBAK",2001002,1,222,49,271
"SAMANGAN","AYBAK",2001013,2,256,37,293
"SAMANGAN","AYBAK",2001088,2,48,416,464
"SAMANGAN","AYBAK",2001087,3,268,120,388
"SAMANGAN","AYBAK",2001004,5,33,67,100
"SAMANGAN","AYBAK",2001001,1,158,58,216
"SAMANGAN","AYBAK",2001087,1,363,169,532
"SAMANGAN","HAZRAT-E-ͲSULTAN",2002025,4,227,345,572
"SAMANGAN","HAZRAT-E-ͲSULTAN",2002025,5,103,86,189
"SAMANGAN","HAZRAT-E-ͲSULTAN",2002023,1,50,283,333
"SAMANGAN","HAZRAT-E-ͲSULTAN",2002025,1,228,361,589
"SAMANGAN","HAZRAT-E-ͲSULTAN",2002025,2,136,302,438
"SAMANGAN","HAZRAT-E-ͲSULTAN",2002024,4,139,32,171
"SAMANGAN","HAZRAT-E-ͲSULTAN",2002026,2,112,284,396
"SAMANGAN","HAZRAT-E-ͲSULTAN",2002023,2,56,330,386
"SAMANGAN","HAZRAT-E-ͲSULTAN",2002020,1,111,398,509
"SAMANGAN","HAZRAT-E-ͲSULTAN",2002026,3,171,371,542
"SAMANGAN","HAZRAT-E-ͲSULTAN",2002021,1,95,175,270
"SAMANGAN","HAZRAT-E-ͲSULTAN",2002021,2,115,106,221
"SAMANGAN","HAZRAT-E-ͲSULTAN",2002021,3,156,100,256
"SAMANGAN","HAZRAT-E-ͲSULTAN",2002025,3,257,325,582
"SAMANGAN","HAZRAT-E-ͲSULTAN",2002026,1,100,237,337
"SAMANGAN","HAZRAT-E-ͲSULTAN",2002024,3,536,54,590
"SAMANGAN","HAZRAT-E-ͲSULTAN",2002028,2,166,109,275
"SAMANGAN","HAZRAT-E-ͲSULTAN",2002023,3,45,349,394
"SAMANGAN","HAZRAT-E-ͲSULTAN",2002020,2,225,226,451
"SAMANGAN","HAZRAT-E-ͲSULTAN",2002029,2,9,7,16
"SAMANGAN","HAZRAT-E-ͲSULTAN",2002023,4,41,529,570
"SAMANGAN","HAZRAT-E-ͲSULTAN",2002020,3,120,180,300
"SAMANGAN","HAZRAT-E-ͲSULTAN",2002019,3,28,101,129
"SAMANGAN","HAZRAT-E-ͲSULTAN",2002019,2,29,40,69
"SAMANGAN","HAZRAT-E-ͲSULTAN",2002028,1,230,140,370
"SAMANGAN","HAZRAT-E-ͲSULTAN",2002024,1,296,62,358
"SAMANGAN","HAZRAT-E-ͲSULTAN",2002022,1,147,219,366
"SAMANGAN","HAZRAT-E-ͲSULTAN",2002023,5,48,27,75
"SAMANGAN","HAZRAT-E-ͲSULTAN",2002019,1,24,69,93
"SAMANGAN","HAZRAT-E-ͲSULTAN",2002024,2,389,60,449
"SAMANGAN","HAZRAT-E-ͲSULTAN",2002022,3,155,250,405
"SAMANGAN","HAZRAT-E-ͲSULTAN",2002023,6,38,262,300
"SAMANGAN","HAZRAT-E-ͲSULTAN",2002020,4,156,191,347
"SAMANGAN","HAZRAT-E-ͲSULTAN",2002029,1,17,15,32
"SAMANGAN","HAZRAT-E-ͲSULTAN",2002022,2,114,207,321
"SAMANGAN","HAZRAT-E-ͲSULTAN",2002027,2,109,326,435
"SAMANGAN","HAZRAT-E-ͲSULTAN",2002027,1,99,269,368
"SAMANGAN","KHURAM WA SABAGH",2003085,2,137,64,201
"SAMANGAN","KHURAM WA SABAGH",2003080,2,570,8,578
"SAMANGAN","KHURAM WA SABAGH",2003085,1,280,59,339
"SAMANGAN","KHURAM WA SABAGH",2003097,2,116,4,120
"SAMANGAN","KHURAM WA SABAGH",2003080,1,553,10,563
"SAMANGAN","KHURAM WA SABAGH",2003085,3,250,96,346
"SAMANGAN","KHURAM WA SABAGH",2003084,1,215,376,591
"SAMANGAN","KHURAM WA SABAGH",2003097,1,140,12,152
"SAMANGAN","KHURAM WA SABAGH",2003082,1,227,107,334
"SAMANGAN","KHURAM WA SABAGH",2003096,1,191,128,319
"SAMANGAN","KHURAM WA SABAGH",2003096,2,193,139,332
"SAMANGAN","KHURAM WA SABAGH",2003080,3,563,14,577
"SAMANGAN","KHURAM WA SABAGH",2003079,1,574,20,594
"SAMANGAN","KHURAM WA SABAGH",2003079,2,583,9,592
"SAMANGAN","KHURAM WA SABAGH",2003082,2,233,130,363
"SAMANGAN","KHURAM WA SABAGH",2003079,4,590,5,595
"SAMANGAN","KHURAM WA SABAGH",2003084,2,146,235,381
"SAMANGAN","KHURAM WA SABAGH",2003078,3,319,3,322
"SAMANGAN","KHURAM WA SABAGH",2003081,2,361,35,396
"SAMANGAN","KHURAM WA SABAGH",2003081,3,541,48,589
"SAMANGAN","KHURAM WA SABAGH",2003081,4,221,11,232
"SAMANGAN","KHURAM WA SABAGH",2003097,3,298,60,358
"SAMANGAN","KHURAM WA SABAGH",2003083,2,312,79,391
"SAMANGAN","KHURAM WA SABAGH",2003079,3,598,1,599
"SAMANGAN","KHURAM WA SABAGH",2003081,1,419,39,458
"SAMANGAN","KHURAM WA SABAGH",2003086,1,345,253,598
"SAMANGAN","KHURAM WA SABAGH",2003086,2,349,245,594
"SAMANGAN","KHURAM WA SABAGH",2003078,2,566,8,574
"SAMANGAN","KHURAM WA SABAGH",2003098,3,132,59,191
"SAMANGAN","KHURAM WA SABAGH",2003077,5,558,12,570
"SAMANGAN","KHURAM WA SABAGH",2003077,1,573,12,585
"SAMANGAN","KHURAM WA SABAGH",2003079,5,544,3,547
"SAMANGAN","KHURAM WA SABAGH",2003083,1,362,85,447
"SAMANGAN","KHURAM WA SABAGH",2003098,2,34,23,57
"SAMANGAN","KHURAM WA SABAGH",2003077,4,581,8,589
"SAMANGAN","KHURAM WA SABAGH",2003078,1,567,19,586
"SAMANGAN","KHURAM WA SABAGH",2003098,1,72,40,112
"SAMANGAN","KHURAM WA SABAGH",2003086,3,397,199,596
"SAMANGAN","KHURAM WA SABAGH",2003077,3,579,10,589
"SAMANGAN","KHURAM WA SABAGH",2003077,2,586,7,593
"SAMANGAN","FEROZ NAKHCHI",2004031,5,360,230,590
"SAMANGAN","FEROZ NAKHCHI",2004031,2,278,240,518
"SAMANGAN","FEROZ NAKHCHI",2004030,3,190,44,234
"SAMANGAN","FEROZ NAKHCHI",2004032,1,425,157,582
"SAMANGAN","FEROZ NAKHCHI",2004031,3,209,229,438
"SAMANGAN","FEROZ NAKHCHI",2004031,4,344,240,584
"SAMANGAN","FEROZ NAKHCHI",2004030,2,129,36,165
"SAMANGAN","FEROZ NAKHCHI",2004032,2,422,159,581
"SAMANGAN","FEROZ NAKHCHI",2004031,1,279,233,512
"SAMANGAN","FEROZ NAKHCHI",2004032,3,23,4,27
"SAMANGAN","FEROZ NAKHCHI",2004030,1,142,52,194
"SAMANGAN","ROI-DO-AB",2005094,3,95,208,303
"SAMANGAN","ROI-DO-AB",2005073,3,275,104,379
"SAMANGAN","ROI-DO-AB",2005094,2,212,217,429
"SAMANGAN","ROI-DO-AB",2005094,1,88,145,233
"SAMANGAN","ROI-DO-AB",2005068,2,145,65,210
"SAMANGAN","ROI-DO-AB",2005073,2,190,163,353
"SAMANGAN","ROI-DO-AB",2005072,2,189,29,218
"SAMANGAN","ROI-DO-AB",2005068,1,99,59,158
"SAMANGAN","ROI-DO-AB",2005066,1,564,19,583
"SAMANGAN","ROI-DO-AB",2005066,2,497,25,522
"SAMANGAN","ROI-DO-AB",2005069,4,38,402,440
"SAMANGAN","ROI-DO-AB",2005069,2,94,240,334
"SAMANGAN","ROI-DO-AB",2005072,1,118,28,146
"SAMANGAN","ROI-DO-AB",2005095,3,452,127,579
"SAMANGAN","ROI-DO-AB",2005069,3,9,295,304
"SAMANGAN","ROI-DO-AB",2005073,1,186,154,340
"SAMANGAN","ROI-DO-AB",2005071,3,350,245,595
"SAMANGAN","ROI-DO-AB",2005065,6,210,42,252
"SAMANGAN","ROI-DO-AB",2005070,2,440,149,589
"SAMANGAN","ROI-DO-AB",2005069,1,96,234,330
"SAMANGAN","ROI-DO-AB",2005070,3,371,221,592
"SAMANGAN","ROI-DO-AB",2005070,4,440,151,591
"SAMANGAN","ROI-DO-AB",2005070,1,389,199,588
"SAMANGAN","ROI-DO-AB",2005076,1,95,71,166
"SAMANGAN","ROI-DO-AB",2005075,1,84,33,117
"SAMANGAN","ROI-DO-AB",2005075,2,79,40,119
"SAMANGAN","ROI-DO-AB",2005066,4,77,6,83
"SAMANGAN","ROI-DO-AB",2005099,1,186,28,214
"SAMANGAN","ROI-DO-AB",2005071,2,426,172,598
"SAMANGAN","ROI-DO-AB",2005065,5,202,42,244
"SAMANGAN","ROI-DO-AB",2005066,3,500,7,507
"SAMANGAN","ROI-DO-AB",2005100,3,168,107,275
"SAMANGAN","ROI-DO-AB",2005065,3,182,28,210
"SAMANGAN","ROI-DO-AB",2005076,2,51,31,82
"SAMANGAN","ROI-DO-AB",2005067,1,98,15,113
"SAMANGAN","ROI-DO-AB",2005095,2,366,229,595
"SAMANGAN","ROI-DO-AB",2005072,4,414,99,513
"SAMANGAN","ROI-DO-AB",2005068,3,171,126,297
"SAMANGAN","ROI-DO-AB",2005074,3,392,106,498
"SAMANGAN","ROI-DO-AB",2005067,2,20,7,27
"SAMANGAN","ROI-DO-AB",2005074,2,171,95,266
"SAMANGAN","ROI-DO-AB",2005065,4,141,20,161
"SAMANGAN","ROI-DO-AB",2005071,1,363,234,597
"SAMANGAN","ROI-DO-AB",2005095,1,293,304,597
"SAMANGAN","ROI-DO-AB",2005074,1,388,59,447
"SAMANGAN","ROI-DO-AB",2005075,3,114,57,171
"SAMANGAN","ROI-DO-AB",2005065,1,249,37,286
"SAMANGAN","ROI-DO-AB",2005072,3,181,43,224
"SAMANGAN","ROI-DO-AB",2005099,2,209,33,242
"SAMANGAN","ROI-DO-AB",2005100,2,131,55,186
"SAMANGAN","ROI-DO-AB",2005065,2,161,43,204
"SAMANGAN","ROI-DO-AB",2005100,1,143,59,202
"SAMANGAN","ROI-DO-AB",2005099,3,501,83,584
"SAMANGAN","DARA-E-SOOF-E-XXXXXX",2006054,2,125,22,147
"SAMANGAN","DARA-E-SOOF-E-XXXXXX",2006054,2,125,22,147
"SAMANGAN","DARA-E-SOOF-E-XXXXXX",2006092,4,565,35,600
"SAMANGAN","DARA-E-SOOF-E-XXXXXX",2006092,4,565,35,600
"SAMANGAN","DARA-E-SOOF-E-XXXXXX",2006058,1,69,238,307
"SAMANGAN","DARA-E-SOOF-E-XXXXXX",2006058,1,69,238,307
"SAMANGAN","DARA-E-SOOF-E-XXXXXX",2006063,3,507,76,583
"SAMANGAN","DARA-E-SOOF-E-XXXXXX",2006063,3,507,76,583
"SAMANGAN","DARA-E-SOOF-E-XXXXXX",2006054,1,162,11,173
"SAMANGAN","DARA-E-SOOF-E-XXXXXX",2006054,1,162,11,173
"SAMANGAN","DARA-E-SOOF-E-XXXXXX",2006063,1,178,91,269
"SAMANGAN","DARA-E-SOOF-E-XXXXXX",2006063,1,178,91,269
"SAMANGAN","DARA-E-SOOF-E-XXXXXX",2006063,2,113,50,163
"SAMANGAN","DARA-E-SOOF-E-XXXXXX",2006063,2,113,50,163
"SAMANGAN","DARA-E-SOOF-E-XXXXXX",2006052,1,275,42,317
"SAMANGAN","DARA-E-SOOF-E-XXXXXX",2006052,1,275,42,317
"SAMANGAN","DARA-E-SOOF-E-XXXXXX",2006064,2,20,394,414
"SAMANGAN","DARA-E-SOOF-E-XXXXXX",2006064,2,20,394,414
"SAMANGAN","DARA-E-SOOF-E-XXXXXX",2006051,1,344,12,356
"SAMANGAN","DARA-E-SOOF-E-XXXXXX",2006051,1,344,12,356
"SAMANGAN","DARA-E-SOOF-E-XXXXXX",2006054,3,539,50,589
"SAMANGAN","DARA-E-SOOF-E-XXXXXX",2006054,3,539,50,589
"SAMANGAN","DARA-E-SOOF-E-XXXXXX",2006048,3,57,16,73
"SAMANGAN","DARA-E-SOOF-E-XXXXXX",2006048,3,57,16,73
"SAMANGAN","DARA-E-SOOF-E-XXXXXX",2006092,3,509,53,562
"SAMANGAN","DARA-E-SOOF-E-XXXXXX",2006092,3,509,53,562
"SAMANGAN","DARA-E-SOOF-E-XXXXXX",2006050,1,551,44,595
"SAMANGAN","DARA-E-SOOF-E-XXXXXX",2006050,1,551,44,595
"SAMANGAN","DARA-E-SOOF-E-XXXXXX",2006048,2,139,41,180
"SAMANGAN","DARA-E-SOOF-E-XXXXXX",2006048,2,139,41,180
"SAMANGAN","DARA-E-SOOF-E-XXXXXX",2006101,2,105,72,177
"SAMANGAN","DARA-E-SOOF-E-XXXXXX",2006101,2,105,72,177
"SAMANGAN","DARA-E-SOOF-E-XXXXXX",2006048,4,42,10,52
"SAMANGAN","DARA-E-SOOF-E-XXXXXX",2006048,4,42,10,52
"SAMANGAN","DARA-E-SOOF-E-XXXXXX",2006064,1,109,417,526
"SAMANGAN","DARA-E-SOOF-E-XXXXXX",2006064,1,109,417,526
"SAMANGAN","DARA-E-SOOF-E-XXXXXX",2006050,6,496,83,579
"SAMANGAN","DARA-E-SOOF-E-XXXXXX",2006050,6,496,83,579
"SAMANGAN","DARA-E-SOOF-E-XXXXXX",2006050,2,532,58,590
"SAMANGAN","DARA-E-SOOF-E-XXXXXX",2006050,2,532,58,590
"SAMANGAN","DARA-E-SOOF-E-XXXXXX",2006101,3,164,170,334
"SAMANGAN","DARA-E-SOOF-E-XXXXXX",2006101,3,164,170,334
"SAMANGAN","DARA-E-SOOF-E-XXXXXX",2006052,2,336,43,379
"SAMANGAN","DARA-E-SOOF-E-XXXXXX",2006052,2,336,43,379
"SAMANGAN","DARA-E-SOOF-E-XXXXXX",2006062,2,19,244,263
"SAMANGAN","DARA-E-SOOF-E-XXXXXX",2006062,2,19,244,263
"SAMANGAN","DARA-E-SOOF-E-XXXXXX",2006050,5,538,54,592
"SAMANGAN","DARA-E-SOOF-E-XXXXXX",2006050,5,538,54,592
"SAMANGAN","DARA-E-SOOF-E-XXXXXX",2006050,3,423,34,457
"SAMANGAN","DARA-E-SOOF-E-XXXXXX",2006050,3,423,34,457
"SAMANGAN","DARA-E-SOOF-E-XXXXXX",2006050,4,571,24,595
"SAMANGAN","DARA-E-SOOF-E-XXXXXX",2006050,4,571,24,595
"SAMANGAN","DARA-E-SOOF-E-XXXXXX",2006048,5,28,22,50
"SAMANGAN","DARA-E-SOOF-E-XXXXXX",2006048,5,28,22,50
"SAMANGAN","DARA-E-SOOF-E-XXXXXX",2006052,3,357,7,364
"SAMANGAN","DARA-E-SOOF-E-XXXXXX",2006052,3,357,7,364
"SAMANGAN","DARA-E-SOOF-E-XXXXXX",2006056,2,70,70,140
"SAMANGAN","DARA-E-SOOF-E-XXXXXX",2006056,2,70,70,140
"SAMANGAN","DARA-E-SOOF-E-XXXXXX",2006093,1,193,68,261
"SAMANGAN","DARA-E-SOOF-E-XXXXXX",2006093,1,193,68,261
"SAMANGAN","DARA-E-SOOF-E-XXXXXX",2006093,2,229,40,269
"SAMANGAN","DARA-E-SOOF-E-XXXXXX",2006093,2,229,40,269
"SAMANGAN","DARA-E-SOOF-E-XXXXXX",2006092,2,208,16,224
"SAMANGAN","DARA-E-SOOF-E-XXXXXX",2006092,2,208,16,224
"SAMANGAN","DARA-E-SOOF-E-XXXXXX",2006048,1,86,32,118
"SAMANGAN","DARA-E-SOOF-E-XXXXXX",2006048,1,86,32,118
"SAMANGAN","DARA-E-SOOF-E-XXXXXX",2006060,2,43,376,419
"SAMANGAN","DARA-E-SOOF-E-XXXXXX",2006060,2,43,376,419
"SAMANGAN","DARA-E-SOOF-E-XXXXXX",2006060,3,573,17,590
"SAMANGAN","DARA-E-SOOF-E-XXXXXX",2006060,3,573,17,590
"SAMANGAN","DARA-E-SOOF-E-XXXXXX",2006060,4,39,372,411
"SAMANGAN","DARA-E-SOOF-E-XXXXXX",2006060,4,39,372,411
"SAMANGAN","DARA-E-SOOF-E-XXXXXX",2006057,2,249,19,268
"SAMANGAN","DARA-E-SOOF-E-XXXXXX",2006057,2,249,19,268
"SAMANGAN","DARA-E-SOOF-E-XXXXXX",2006101,1,59,63,122
"SAMANGAN","DARA-E-SOOF-E-XXXXXX",2006101,1,59,63,122
"SAMANGAN","DARA-E-SOOF-E-XXXXXX",2006055,3,206,8,214
"SAMANGAN","DARA-E-SOOF-E-XXXXXX",2006055,3,206,8,214
"SAMANGAN","DARA-E-SOOF-E-XXXXXX",2006053,4,206,6,212
"SAMANGAN","DARA-E-SOOF-E-XXXXXX",2006053,4,206,6,212
"SAMANGAN","DARA-E-SOOF-E-XXXXXX",2006051,2,477,23,500
"SAMANGAN","DARA-E-SOOF-E-XXXXXX",2006051,2,477,23,500
"SAMANGAN","DARA-E-SOOF-E-XXXXXX",2006058,2,200,270,470
"SAMANGAN","DARA-E-SOOF-E-XXXXXX",2006058,2,200,270,470
"SAMANGAN","DARA-E-SOOF-E-XXXXXX",2006053,3,208,1,209
"SAMANGAN","DARA-E-SOOF-E-XXXXXX",2006053,3,208,1,209
"SAMANGAN","DARA-E-SOOF-E-XXXXXX",2006062,4,6,563,569
"SAMANGAN","DARA-E-SOOF-E-XXXXXX",2006062,4,6,563,569
"SAMANGAN","DARA-E-SOOF-E-XXXXXX",2006053,2,423,7,430
"SAMANGAN","DARA-E-SOOF-E-XXXXXX",2006053,2,423,7,430
"SAMANGAN","DARA-E-SOOF-E-XXXXXX",2006060,1,13,354,367
"SAMANGAN","DARA-E-SOOF-E-XXXXXX",2006060,1,13,354,367
"SAMANGAN","DARA-E-SOOF-E-XXXXXX",2006062,3,6,563,569
"SAMANGAN","DARA-E-SOOF-E-XXXXXX",2006062,3,6,563,569
"SAMANGAN","DARA-E-SOOF-E-XXXXXX",2006056,1,254,16,270
"SAMANGAN","DARA-E-SOOF-E-XXXXXX",2006056,1,254,16,270
"SAMANGAN","DARA-E-SOOF-E-XXXXXX",2006057,1,211,13,224
"SAMANGAN","DARA-E-SOOF-E-XXXXXX",2006057,1,211,13,224
"SAMANGAN","DARA-E-SOOF-E-XXXXXX",2006059,4,39,316,355
"SAMANGAN","DARA-E-SOOF-E-XXXXXX",2006059,4,39,316,355
"SAMANGAN","DARA-E-SOOF-E-XXXXXX",2006057,3,575,15,590
"SAMANGAN","DARA-E-SOOF-E-XXXXXX",2006057,3,575,15,590
"SAMANGAN","DARA-E-SOOF-E-XXXXXX",2006052,4,292,6,298
"SAMANGAN","DARA-E-SOOF-E-XXXXXX",2006052,4,292,6,298
"SAMANGAN","DARA-E-SOOF-E-XXXXXX",2006062,1,34,339,373
"SAMANGAN","DARA-E-SOOF-E-XXXXXX",2006062,1,34,339,373
"SAMANGAN","DARA-E-SOOF-E-XXXXXX",2006053,1,447,11,458
"SAMANGAN","DARA-E-SOOF-E-XXXXXX",2006053,1,447,11,458
"SAMANGAN","DARA-E-SOOF-E-XXXXXX",2006049,1,158,13,171
"SAMANGAN","DARA-E-SOOF-E-XXXXXX",2006049,1,158,13,171
"SAMANGAN","DARA-E-SOOF-E-XXXXXX",2006061,3,547,19,566
"SAMANGAN","DARA-E-SOOF-E-XXXXXX",2006061,3,547,19,566
"SAMANGAN","DARA-E-SOOF-E-XXXXXX",2006055,2,207,12,219
"SAMANGAN","DARA-E-SOOF-E-XXXXXX",2006055,2,207,12,219
"SAMANGAN","DARA-E-SOOF-E-XXXXXX",2006059,2,38,284,322
"SAMANGAN","DARA-E-SOOF-E-XXXXXX",2006059,2,38,284,322
"SAMANGAN","DARA-E-SOOF-E-XXXXXX",2006059,5,25,324,349
"SAMANGAN","DARA-E-SOOF-E-XXXXXX",2006059,5,25,324,349
"SAMANGAN","DARA-E-SOOF-E-XXXXXX",2006055,1,245,9,254
"SAMANGAN","DARA-E-SOOF-E-XXXXXX",2006055,1,245,9,254
"SAMANGAN","DARA-E-SOOF-E-XXXXXX",2006049,3,38,4,42
"SAMANGAN","DARA-E-SOOF-E-XXXXXX",2006049,3,38,4,42
"SAMANGAN","DARA-E-SOOF-E-XXXXXX",2006061,2,559,36,595
"SAMANGAN","DARA-E-SOOF-E-XXXXXX",2006061,2,559,36,595
"SAMANGAN","DARA-E-SOOF-E-XXXXXX",2006092,1,149,15,164
"SAMANGAN","DARA-E-SOOF-E-XXXXXX",2006092,1,149,15,164
"SAMANGAN","DARA-E-SOOF-E-XXXXXX",2006061,1,563,32,595
"SAMANGAN","DARA-E-SOOF-E-XXXXXX",2006061,1,563,32,595
"SAMANGAN","DARA-E-SOOF-E-XXXXXX",2006059,1,47,267,314
"SAMANGAN","DARA-E-SOOF-E-XXXXXX",2006059,1,47,267,314
"SAMANGAN","DARA-E-SOOF-E-XXXXXX",2006049,2,120,17,137
"SAMANGAN","DARA-E-SOOF-E-XXXXXX",2006049,2,120,17,137
"SAMANGAN","DARA-E-SOOF-E-XXXXXX",2006061,4,589,10,599
"SAMANGAN","DARA-E-SOOF-E-XXXXXX",2006061,4,589,10,599
"SAMANGAN","DARA-E-SOOF-E-XXXXXX",2006058,4,87,178,265
"SAMANGAN","DARA-E-SOOF-E-XXXXXX",2006058,4,87,178,265
"SAMANGAN","DARA-E-SOOF-E-XXXXXX",2006058,3,63,253,316
"SAMANGAN","DARA-E-SOOF-E-XXXXXX",2006058,3,63,253,316
"SAMANGAN","DARA-E-SOOF-E-XXXXXX",2006059,3,30,287,317
"SAMANGAN","DARA-E-SOOF-E-XXXXXX",2006059,3,30,287,317
NA,NA,2007037,2,149,62,211
NA,NA,2007036,1,437,146,583
NA,NA,2007036,2,408,175,583
NA,NA,2007036,3,467,118,585
NA,NA,2007035,1,263,72,335
NA,NA,2007035,2,286,135,421
NA,NA,2007037,1,208,38,246
NA,NA,2007039,1,258,118,376
NA,NA,2007039,2,302,100,402
NA,NA,2007039,3,315,83,398
NA,NA,2007033,1,370,99,469
NA,NA,2007033,2,221,80,301
NA,NA,2007033,3,252,103,355
NA,NA,2007033,4,405,102,507
NA,NA,2007033,5,308,139,447
NA,NA,2007034,1,289,105,394
NA,NA,2007034,2,180,54,234
NA,NA,2007034,3,296,74,370
NA,NA,2007038,2,194,121,315
NA,NA,2007040,1,323,79,402
NA,NA,2007040,2,207,144,351
NA,NA,2007040,3,250,57,307
NA,NA,2007040,4,195,126,321
NA,NA,2007040,5,390,17,407
NA,NA,2007042,3,301,132,433
NA,NA,2007042,4,300,267,567
NA,NA,2007045,1,400,186,586
NA,NA,2007045,2,477,115,592
NA,NA,2007045,3,481,117,598
NA,NA,2007035,3,425,80,505
NA,NA,2007038,1,298,106,404
NA,NA,2007042,1,195,155,350
NA,NA,2007042,2,268,236,504
NA,NA,2007041,3,181,344,525
NA,NA,2007044,1,192,68,260
NA,NA,2007044,2,328,61,389
NA,NA,2007044,3,490,109,599
NA,NA,2007045,4,381,215,596
NA,NA,2007041,1,291,105,396
NA,NA,2007041,2,279,69,348
NA,NA,2007046,3,406,180,586
NA,NA,2007042,5,326,274,600
NA,NA,2007043,1,390,208,598
NA,NA,2007043,2,439,161,600
NA,NA,2007041,4,496,64,560
NA,NA,2007047,2,294,26,320
NA,NA,2007046,2,383,208,591
NA,NA,2007047,1,247,30,277
NA,NA,2007090,1,481,99,580
NA,NA,2007091,2,422,66,488
NA,NA,2007091,1,330,107,437
NA,NA,2007046,1,354,235,589
NA,NA,2007090,2,206,40,246
"KAPISA","MAHMUDI RAQ",201010,2,110,10,120
"KAPISA","MAHMUDI RAQ",201010,3,60,5,65
"KAPISA","MAHMUDI RAQ",201008,1,324,16,340
"KAPISA","MAHMUDI RAQ",201004,3,6,16,22
"KAPISA","MAHMUDI RAQ",201002,6,154,5,159
"KAPISA","MAHMUDI RAQ",201004,1,5,25,30
"KAPISA","MAHMUDI RAQ",201002,5,184,15,199
"KAPISA","MAHMUDI RAQ",201003,4,250,12,262
"KAPISA","MAHMUDI RAQ",201010,1,173,28,201
"KAPISA","MAHMUDI RAQ",201004,2,13,28,41
"KAPISA","MAHMUDI RAQ",201006,2,69,63,132
"KAPISA","MAHMUDI RAQ",201006,3,104,40,144
"KAPISA","MAHMUDI RAQ",201010,4,124,14,138
"KAPISA","MAHMUDI RAQ",201002,4,243,15,258
"KAPISA","MAHMUDI RAQ",201010,5,142,26,168
"KAPISA","MAHMUDI RAQ",201015,1,237,135,372
"KAPISA","MAHMUDI RAQ",201006,4,78,89,167
"KAPISA","MAHMUDI RAQ",201006,1,83,126,209
"KAPISA","MAHMUDI RAQ",201005,4,150,22,172
"KAPISA","MAHMUDI RAQ",201005,5,160,17,177
"KAPISA","MAHMUDI RAQ",201015,2,285,111,396
"KAPISA","MAHMUDI RAQ",201008,2,182,13,195
"KAPISA","MAHMUDI RAQ",201011,3,207,30,237
"KAPISA","MAHMUDI RAQ",201001,2,42,27,69
"KAPISA","MAHMUDI RAQ",201012,4,45,22,67
"KAPISA","MAHMUDI RAQ",201002,3,279,10,289
"KAPISA","MAHMUDI RAQ",201015,3,71,21,92
"KAPISA","MAHMUDI RAQ",201015,4,89,0,89
"KAPISA","MAHMUDI RAQ",201004,4,2,14,16
"KAPISA","MAHMUDI RAQ",201001,1,119,26,145
"KAPISA","MAHMUDI RAQ",201013,3,115,49,164
"KAPISA","MAHMUDI RAQ",201009,6,91,0,91
"KAPISA","MAHMUDI RAQ",201009,7,70,2,72
"KAPISA","MAHMUDI RAQ",201004,5,9,1,10
"KAPISA","MAHMUDI RAQ",201003,3,213,14,227
"KAPISA","MAHMUDI RAQ",201009,1,553,23,576
"KAPISA","MAHMUDI RAQ",201011,4,181,13,194
"KAPISA","MAHMUDI RAQ",201003,2,118,6,124
"KAPISA","MAHMUDI RAQ",201008,3,183,13,196
"KAPISA","MAHMUDI RAQ",201002,2,233,6,239
"KAPISA","MAHMUDI RAQ",201009,2,561,24,585
"KAPISA","MAHMUDI RAQ",201003,5,283,3,286
"KAPISA","MAHMUDI RAQ",201002,1,347,16,363
"KAPISA","MAHMUDI RAQ",201011,2,131,25,156
"KAPISA","MAHMUDI RAQ",201016,2,9,21,30
"KAPISA","MAHMUDI RAQ",201016,3,6,24,30
"KAPISA","MAHMUDI RAQ",201011,1,163,12,175
"KAPISA","MAHMUDI RAQ",201014,1,19,128,147
"KAPISA","MAHMUDI RAQ",201014,2,13,135,148
"KAPISA","MAHMUDI RAQ",201014,3,2,30,32
"KAPISA","MAHMUDI RAQ",201006,5,87,6,93
"KAPISA","MAHMUDI RAQ",201013,1,85,23,108
"KAPISA","MAHMUDI RAQ",201013,2,62,29,91
"KAPISA","MAHMUDI RAQ",201005,3,94,11,105
"KAPISA","MAHMUDI RAQ",201009,3,553,31,584
"KAPISA","MAHMUDI RAQ",201012,3,34,75,109
"KAPISA","MAHMUDI RAQ",201003,1,239,5,244
"KAPISA","MAHMUDI RAQ",201001,4,31,11,42
"KAPISA","MAHMUDI RAQ",201012,2,25,40,65
"KAPISA","MAHMUDI RAQ",201008,5,217,7,224
"KAPISA","MAHMUDI RAQ",201001,3,24,9,33
"KAPISA","MAHMUDI RAQ",201009,4,567,21,588
"KAPISA","MAHMUDI RAQ",201001,5,27,6,33
"KAPISA","MAHMUDI RAQ",201012,1,48,88,136
"KAPISA","MAHMUDI RAQ",201001,7,16,1,17
"KAPISA","MAHMUDI RAQ",201018,1,29,37,66
"KAPISA","MAHMUDI RAQ",201009,5,119,3,122
"KAPISA","MAHMUDI RAQ",201008,4,153,9,162
"KAPISA","MAHMUDI RAQ",201001,6,13,2,15
"KAPISA","MAHMUDI RAQ",201007,5,178,278,456
"KAPISA","MAHMUDI RAQ",201007,1,36,85,121
"KAPISA","MAHMUDI RAQ",201016,1,42,248,290
"KAPISA","MAHMUDI RAQ",201017,3,9,0,9
"KAPISA","MAHMUDI RAQ",201017,1,36,64,100
"KAPISA","MAHMUDI RAQ",201007,6,349,130,479
"KAPISA","MAHMUDI RAQ",201018,2,6,9,15
"KAPISA","MAHMUDI RAQ",201018,3,8,11,19
"KAPISA","MAHMUDI RAQ",201017,2,11,2,13
"KAPISA","MAHMUDI RAQ",201014,4,7,18,25
"KAPISA","MAHMUDI RAQ",201005,1,198,13,211
"KAPISA","MAHMUDI RAQ",201005,2,107,9,116
"KAPISA","MAHMUDI RAQ",201007,2,134,36,170
"KAPISA","MAHMUDI RAQ",201007,3,15,23,38
"KAPISA","MAHMUDI RAQ",201007,4,37,47,84
"KAPISA","HISSA-E-DUWU",202019,2,283,8,291
"KAPISA","HISSA-E-DUWU",202020,4,340,12,352
"KAPISA","HISSA-E-DUWU",202025,2,393,20,413
"KAPISA","HISSA-E-DUWU",202025,3,222,4,226
"KAPISA","HISSA-E-DUWU",202019,1,267,11,278
"KAPISA","HISSA-E-DUWU",202025,1,248,8,256
"KAPISA","HISSA-E-DUWU",202019,3,277,1,278
"KAPISA","HISSA-E-DUWU",202021,1,436,16,452
"KAPISA","HISSA-E-DUWU",202020,3,407,20,427
"KAPISA","HISSA-E-DUWU",202023,4,270,4,274
"KAPISA","HISSA-E-DUWU",202023,3,274,14,288
"KAPISA","HISSA-E-DUWU",202024,2,189,5,194
"KAPISA","HISSA-E-DUWU",202020,2,571,11,582
"KAPISA","HISSA-E-DUWU",202019,5,300,6,306
"KAPISA","HISSA-E-DUWU",202024,1,165,7,172
"KAPISA","HISSA-E-DUWU",202023,1,489,17,506
"KAPISA","HISSA-E-DUWU",202019,4,186,9,195
"KAPISA","HISSA-E-DUWU",202020,1,574,15,589
"KAPISA","HISSA-E-DUWU",202022,3,292,17,309
"KAPISA","HISSA-E-DUWU",202023,2,352,10,362
"KAPISA","HISSA-E-DUWU",202022,1,312,5,317
"KAPISA","HISSA-E-DUWU",202021,4,220,2,222
"KAPISA","HISSA-E-DUWU",202022,2,178,15,193
"KAPISA","HISSA-E-DUWU",202024,3,130,3,133
"KAPISA","HISSA-E-DUWU",202021,2,315,8,323
"KAPISA","HISSA-E-DUWU",202024,4,161,5,166
"KAPISA","HISSA-E-DUWU",202021,3,179,1,180
"KAPISA","KOH BAND",203071,2,580,18,598
"KAPISA","KOH BAND",203071,1,515,82,597
"KAPISA","KOH BAND",203074,2,512,80,592
"KAPISA","KOH BAND",203071,3,575,23,598
"KAPISA","KOH BAND",203075,3,46,8,54
"KAPISA","KOH BAND",203070,2,457,38,495
"KAPISA","KOH BAND",203071,4,593,4,597
"KAPISA","KOH BAND",203074,1,531,68,599
"KAPISA","KOH BAND",203075,2,94,33,127
"KAPISA","KOH BAND",203070,1,250,22,272
"KAPISA","KOH BAND",203073,5,243,14,257
"KAPISA","KOH BAND",203074,3,564,28,592
"KAPISA","KOH BAND",203068,2,354,34,388
"KAPISA","KOH BAND",203073,4,340,15,355
"KAPISA","KOH BAND",203067,4,544,15,559
"KAPISA","KOH BAND",203068,1,538,50,588
"KAPISA","KOH BAND",203067,1,402,37,439
"KAPISA","KOH BAND",203075,1,73,86,159
"KAPISA","KOH BAND",203073,3,525,62,587
"KAPISA","KOH BAND",203067,3,514,60,574
"KAPISA","KOH BAND",203067,2,496,37,533
"KAPISA","KOH BAND",203073,1,351,35,386
"KAPISA","KOH BAND",203073,2,296,24,320
"KAPISA","HISSA-E-AWALI",204030,3,171,2,173
"KAPISA","HISSA-E-AWALI",204030,1,335,7,342
"KAPISA","HISSA-E-AWALI",204034,3,557,16,573
"KAPISA","HISSA-E-AWALI",204034,4,227,1,228
"KAPISA","HISSA-E-AWALI",204032,4,347,5,352
"KAPISA","HISSA-E-AWALI",204030,2,236,1,237
"KAPISA","HISSA-E-AWALI",204027,5,474,10,484
"KAPISA","HISSA-E-AWALI",204027,6,55,0,55
"KAPISA","HISSA-E-AWALI",204034,2,473,20,493
"KAPISA","HISSA-E-AWALI",204032,5,122,3,125
"KAPISA","HISSA-E-AWALI",204034,1,518,17,535
"KAPISA","HISSA-E-AWALI",204030,4,191,14,205
"KAPISA","HISSA-E-AWALI",204028,1,180,3,183
"KAPISA","HISSA-E-AWALI",204031,1,547,6,553
"KAPISA","HISSA-E-AWALI",204027,4,582,10,592
"KAPISA","HISSA-E-AWALI",204032,3,359,4,363
"KAPISA","HISSA-E-AWALI",204029,1,564,36,600
"KAPISA","HISSA-E-AWALI",204028,2,290,8,298
"KAPISA","HISSA-E-AWALI",204037,2,248,4,252
"KAPISA","HISSA-E-AWALI",204028,5,465,5,470
"KAPISA","HISSA-E-AWALI",204027,1,581,11,592
"KAPISA","HISSA-E-AWALI",204033,1,472,21,493
"KAPISA","HISSA-E-AWALI",204028,3,435,11,446
"KAPISA","HISSA-E-AWALI",204032,2,262,6,268
"KAPISA","HISSA-E-AWALI",204037,1,291,17,308
"KAPISA","HISSA-E-AWALI",204027,2,584,11,595
"KAPISA","HISSA-E-AWALI",204038,2,173,4,177
"KAPISA","HISSA-E-AWALI",204028,4,374,3,377
"KAPISA","HISSA-E-AWALI",204032,1,169,3,172
"KAPISA","HISSA-E-AWALI",204031,2,314,6,320
"KAPISA","HISSA-E-AWALI",204027,3,581,10,591
"KAPISA","HISSA-E-AWALI",204035,3,320,4,324
"KAPISA","HISSA-E-AWALI",204036,1,161,45,206
"KAPISA","HISSA-E-AWALI",204036,3,270,27,297
"KAPISA","HISSA-E-AWALI",204037,3,331,2,333
"KAPISA","HISSA-E-AWALI",204038,1,148,7,155
"KAPISA","HISSA-E-AWALI",204031,4,588,4,592
"KAPISA","HISSA-E-AWALI",204036,2,117,52,169
"KAPISA","HISSA-E-AWALI",204035,1,399,18,417
"KAPISA","HISSA-E-AWALI",204035,2,351,13,364
"KAPISA","HISSA-E-AWALI",204029,6,571,22,593
"KAPISA","HISSA-E-AWALI",204031,5,588,6,594
"KAPISA","HISSA-E-AWALI",204038,3,223,8,231
"KAPISA","HISSA-E-AWALI",204031,3,404,5,409
"KAPISA","HISSA-E-AWALI",204033,2,188,14,202
"KAPISA","HISSA-E-AWALI",204029,2,297,12,309
"KAPISA","HISSA-E-AWALI",204029,4,156,14,170
"KAPISA","HISSA-E-AWALI",204034,5,290,1,291
"KAPISA","HISSA-E-AWALI",204029,5,541,56,597
"KAPISA","HISSA-E-AWALI",204026,6,240,3,243
"KAPISA","HISSA-E-AWALI",204029,3,283,27,310
"KAPISA","HISSA-E-AWALI",204026,4,46,6,52
"KAPISA","HISSA-E-AWALI",204033,4,584,11,595
"KAPISA","HISSA-E-AWALI",204026,1,238,20,258
"KAPISA","HISSA-E-AWALI",204026,2,129,16,145
"KAPISA","HISSA-E-AWALI",204026,3,118,14,132
"KAPISA","HISSA-E-AWALI",204033,3,422,16,438
"KAPISA","HISSA-E-AWALI",204026,5,216,15,231
"KAPISA","NIJRAB",205061,1,546,47,593
"KAPISA","NIJRAB",205039,1,3,166,169
"KAPISA","NIJRAB",205065,2,329,64,393
"KAPISA","NIJRAB",205042,2,588,9,597
"KAPISA","NIJRAB",205042,1,582,13,595
"KAPISA","NIJRAB",205044,3,566,28,594
"KAPISA","NIJRAB",205062,2,247,1,248
"KAPISA","NIJRAB",205055,2,207,292,499
"KAPISA","NIJRAB",205039,3,0,69,69
"KAPISA","NIJRAB",205059,1,566,26,592
"KAPISA","NIJRAB",205062,1,181,6,187
"KAPISA","NIJRAB",205056,3,583,12,595
"KAPISA","NIJRAB",205044,1,528,36,564
"KAPISA","NIJRAB",205044,2,519,39,558
"KAPISA","NIJRAB",205065,1,103,78,181
"KAPISA","NIJRAB",205039,2,2,102,104
"KAPISA","NIJRAB",205061,2,227,13,240
"KAPISA","NIJRAB",205055,1,454,73,527
"KAPISA","NIJRAB",205053,4,532,14,546
"KAPISA","NIJRAB",205066,1,562,32,594
"KAPISA","NIJRAB",205064,2,197,29,226
"KAPISA","NIJRAB",205056,1,565,35,600
"KAPISA","NIJRAB",205046,1,402,16,418
"KAPISA","NIJRAB",205045,2,578,3,581
"KAPISA","NIJRAB",205048,3,586,12,598
"KAPISA","NIJRAB",205051,1,546,46,592
"KAPISA","NIJRAB",205056,2,464,34,498
"KAPISA","NIJRAB",205051,3,596,3,599
"KAPISA","NIJRAB",205046,2,591,9,600
"KAPISA","NIJRAB",205054,1,484,30,514
"KAPISA","NIJRAB",205066,2,595,5,600
"KAPISA","NIJRAB",205058,1,191,69,260
"KAPISA","NIJRAB",205052,1,513,25,538
"KAPISA","NIJRAB",205058,2,90,22,112
"KAPISA","NIJRAB",205058,3,69,27,96
"KAPISA","NIJRAB",205064,1,145,23,168
"KAPISA","NIJRAB",205053,3,598,1,599
"KAPISA","NIJRAB",205048,1,532,16,548
"KAPISA","NIJRAB",205048,2,373,21,394
"KAPISA","NIJRAB",205052,2,568,30,598
"KAPISA","NIJRAB",205051,2,547,50,597
"KAPISA","NIJRAB",205041,1,367,123,490
"KAPISA","NIJRAB",205059,2,583,11,594
"KAPISA","NIJRAB",205049,1,532,61,593
"KAPISA","NIJRAB",205054,3,573,24,597
"KAPISA","NIJRAB",205045,1,568,14,582
"KAPISA","NIJRAB",205041,2,156,54,210
"KAPISA","NIJRAB",205043,4,600,0,600
"KAPISA","NIJRAB",205049,2,553,46,599
"KAPISA","NIJRAB",205043,2,38,17,55
"KAPISA","NIJRAB",205043,3,202,0,202
"KAPISA","NIJRAB",205057,2,399,198,597
"KAPISA","NIJRAB",205043,1,31,8,39
"KAPISA","NIJRAB",205050,2,438,155,593
"KAPISA","NIJRAB",205053,2,575,12,587
"KAPISA","NIJRAB",205047,1,543,10,553
"KAPISA","NIJRAB",205050,1,583,15,598
"KAPISA","NIJRAB",205057,1,535,60,595
"KAPISA","NIJRAB",205054,2,383,29,412
"KAPISA","NIJRAB",205060,1,180,49,229
"KAPISA","NIJRAB",205060,2,410,53,463
"KAPISA","NIJRAB",205053,1,526,63,589
"KAPISA","NIJRAB",205047,2,585,10,595
"KAPISA","TAGAB",206098,1,45,253,298
"KAPISA","TAGAB",206098,3,200,119,319
"KAPISA","TAGAB",206076,2,8,58,66
"KAPISA","TAGAB",206098,2,177,355,532
"KAPISA","TAGAB",206081,2,3,109,112
"KAPISA","TAGAB",206076,1,10,304,314
"KAPISA","TAGAB",206078,2,9,58,67
"KAPISA","TAGAB",206081,1,7,153,160
"KAPISA","TAGAB",206085,3,2,35,37
"KAPISA","TAGAB",206078,1,34,225,259
"KAPISA","TAGAB",206085,1,3,74,77
"KAPISA","TAGAB",206085,2,3,106,109
"KAPISA","TAGAB",206084,2,14,138,152
"KAPISA","TAGAB",206085,4,0,5,5
"KAPISA","TAGAB",206078,3,3,140,143
"KAPISA","TAGAB",206084,3,86,328,414
"KAPISA","TAGAB",206084,1,31,146,177
"KAPISA","TAGAB",206078,4,5,112,117
"KAPISA","TAGAB",206084,4,98,488,586
"KAPISA","TAGAB",206083,1,4,48,52
"KAPISA","TAGAB",206083,2,2,48,50
"KAPISA","TAGAB",206083,3,0,63,63
"BALKH","MAZAR-E-SHARIF",2101041,7,525,62,587
"BALKH","MAZAR-E-SHARIF",2101030,3,102,73,175
"BALKH","MAZAR-E-SHARIF",2101001,5,147,60,207
"BALKH","MAZAR-E-SHARIF",2101041,4,479,104,583
"BALKH","MAZAR-E-SHARIF",2101001,4,157,40,197
"BALKH","MAZAR-E-SHARIF",2101016,1,468,111,579
"BALKH","MAZAR-E-SHARIF",2101024,5,191,126,317
"BALKH","MAZAR-E-SHARIF",2101001,3,185,72,257
"BALKH","MAZAR-E-SHARIF",2101002,8,558,27,585
"BALKH","MAZAR-E-SHARIF",2101013,1,194,195,389
"BALKH","MAZAR-E-SHARIF",2101001,6,121,28,149
"BALKH","MAZAR-E-SHARIF",2101030,4,101,69,170
"BALKH","MAZAR-E-SHARIF",2101001,7,122,35,157
"BALKH","MAZAR-E-SHARIF",2101042,5,130,64,194
"BALKH","MAZAR-E-SHARIF",2101016,2,449,134,583
"BALKH","MAZAR-E-SHARIF",2101041,3,472,107,579
"BALKH","MAZAR-E-SHARIF",2101002,7,495,35,530
"BALKH","MAZAR-E-SHARIF",2101048,3,218,51,269
"BALKH","MAZAR-E-SHARIF",2101042,6,45,22,67
"BALKH","MAZAR-E-SHARIF",2101016,3,258,71,329
"BALKH","MAZAR-E-SHARIF",2101041,6,524,61,585
"BALKH","MAZAR-E-SHARIF",2101013,2,217,178,395
"BALKH","MAZAR-E-SHARIF",2101041,8,496,52,548
"BALKH","MAZAR-E-SHARIF",2101041,5,535,54,589
"BALKH","MAZAR-E-SHARIF",2101018,2,439,153,592
"BALKH","MAZAR-E-SHARIF",2101041,2,469,112,581
"BALKH","MAZAR-E-SHARIF",2101001,2,322,95,417
"BALKH","MAZAR-E-SHARIF",2101018,1,374,122,496
"BALKH","MAZAR-E-SHARIF",2101041,1,467,116,583
"BALKH","MAZAR-E-SHARIF",2101035,4,248,277,525
"BALKH","MAZAR-E-SHARIF",2101035,5,224,212,436
"BALKH","MAZAR-E-SHARIF",2101035,2,255,302,557
"BALKH","MAZAR-E-SHARIF",2101035,3,247,243,490
"BALKH","MAZAR-E-SHARIF",2101034,2,175,74,249
"BALKH","MAZAR-E-SHARIF",2101034,3,211,95,306
"BALKH","MAZAR-E-SHARIF",2101035,6,157,173,330
"BALKH","MAZAR-E-SHARIF",2101034,1,270,127,397
"BALKH","MAZAR-E-SHARIF",2101013,4,125,100,225
"BALKH","MAZAR-E-SHARIF",2101034,8,291,78,369
"BALKH","MAZAR-E-SHARIF",2101034,9,161,59,220
"BALKH","MAZAR-E-SHARIF",2101036,1,195,136,331
"BALKH","MAZAR-E-SHARIF",2101036,2,239,148,387
"BALKH","MAZAR-E-SHARIF",2101036,3,228,184,412
"BALKH","MAZAR-E-SHARIF",2101036,4,184,145,329
"BALKH","MAZAR-E-SHARIF",2101016,4,269,63,332
"BALKH","MAZAR-E-SHARIF",2101016,5,312,66,378
"BALKH","MAZAR-E-SHARIF",2101016,6,77,28,105
"BALKH","MAZAR-E-SHARIF",2101017,1,199,222,421
"BALKH","MAZAR-E-SHARIF",2101017,2,227,239,466
"BALKH","MAZAR-E-SHARIF",2101017,3,98,151,249
"BALKH","MAZAR-E-SHARIF",2101017,4,93,173,266
"BALKH","MAZAR-E-SHARIF",2101042,3,201,98,299
"BALKH","MAZAR-E-SHARIF",2101042,4,67,42,109
"BALKH","MAZAR-E-SHARIF",2101037,1,293,194,487
"BALKH","MAZAR-E-SHARIF",2101037,2,304,269,573
"BALKH","MAZAR-E-SHARIF",2101048,1,336,105,441
"BALKH","MAZAR-E-SHARIF",2101048,2,360,109,469
"BALKH","MAZAR-E-SHARIF",2101037,5,203,163,366
"BALKH","MAZAR-E-SHARIF",2101048,4,233,53,286
"BALKH","MAZAR-E-SHARIF",2101048,5,228,53,281
"BALKH","MAZAR-E-SHARIF",2101045,1,533,38,571
"BALKH","MAZAR-E-SHARIF",2101045,2,532,49,581
"BALKH","MAZAR-E-SHARIF",2101045,3,541,40,581
"BALKH","MAZAR-E-SHARIF",2101013,3,108,118,226
"BALKH","MAZAR-E-SHARIF",2101020,6,275,176,451
"BALKH","MAZAR-E-SHARIF",2101001,1,465,124,589
"BALKH","MAZAR-E-SHARIF",2101035,1,297,289,586
"BALKH","MAZAR-E-SHARIF",2101046,2,460,127,587
"BALKH","MAZAR-E-SHARIF",2101046,3,319,44,363
"BALKH","MAZAR-E-SHARIF",2101046,4,341,55,396
"BALKH","MAZAR-E-SHARIF",2101046,5,253,47,300
"BALKH","MAZAR-E-SHARIF",2101046,6,169,102,271
"BALKH","MAZAR-E-SHARIF",2101018,10,212,52,264
"BALKH","MAZAR-E-SHARIF",2101001,8,382,90,472
"BALKH","MAZAR-E-SHARIF",2101001,9,311,69,380
"BALKH","MAZAR-E-SHARIF",2101034,4,248,107,355
"BALKH","MAZAR-E-SHARIF",2101034,5,347,158,505
"BALKH","MAZAR-E-SHARIF",2101034,6,294,104,398
"BALKH","MAZAR-E-SHARIF",2101034,7,200,104,304
"BALKH","MAZAR-E-SHARIF",2101025,10,169,39,208
"BALKH","MAZAR-E-SHARIF",2101004,1,203,222,425
"BALKH","MAZAR-E-SHARIF",2101004,2,147,201,348
"BALKH","MAZAR-E-SHARIF",2101004,3,161,189,350
"BALKH","MAZAR-E-SHARIF",2101004,4,130,142,272
"BALKH","MAZAR-E-SHARIF",2101036,5,114,106,220
"BALKH","MAZAR-E-SHARIF",2101036,6,284,139,423
"BALKH","MAZAR-E-SHARIF",2101036,7,243,108,351
"BALKH","MAZAR-E-SHARIF",2101036,8,154,77,231
"BALKH","MAZAR-E-SHARIF",2101036,9,64,38,102
"BALKH","MAZAR-E-SHARIF",2101042,1,231,129,360
"BALKH","MAZAR-E-SHARIF",2101042,2,271,154,425
"BALKH","MAZAR-E-SHARIF",2101008,6,172,144,316
"BALKH","MAZAR-E-SHARIF",2101008,7,150,161,311
"BALKH","MAZAR-E-SHARIF",2101008,8,115,100,215
"BALKH","MAZAR-E-SHARIF",2101024,1,278,194,472
"BALKH","MAZAR-E-SHARIF",2101037,3,227,176,403
"BALKH","MAZAR-E-SHARIF",2101037,4,278,213,491
"BALKH","MAZAR-E-SHARIF",2101024,4,285,171,456
"BALKH","MAZAR-E-SHARIF",2101014,1,358,211,569
"BALKH","MAZAR-E-SHARIF",2101030,1,335,254,589
"BALKH","MAZAR-E-SHARIF",2101020,2,210,188,398
"BALKH","MAZAR-E-SHARIF",2101020,3,279,249,528
"BALKH","MAZAR-E-SHARIF",2101020,4,198,182,380
"BALKH","MAZAR-E-SHARIF",2101020,5,281,132,413
"BALKH","MAZAR-E-SHARIF",2101045,4,532,33,565
"BALKH","MAZAR-E-SHARIF",2101045,5,263,23,286
"BALKH","MAZAR-E-SHARIF",2101046,1,469,118,587
"BALKH","MAZAR-E-SHARIF",2101047,1,477,107,584
"BALKH","MAZAR-E-SHARIF",2101047,2,479,98,577
"BALKH","MAZAR-E-SHARIF",2101047,3,453,129,582
"BALKH","MAZAR-E-SHARIF",2101047,4,477,107,584
"BALKH","MAZAR-E-SHARIF",2101047,5,236,50,286
"BALKH","MAZAR-E-SHARIF",2101047,6,206,31,237
"BALKH","MAZAR-E-SHARIF",2101029,1,319,265,584
"BALKH","MAZAR-E-SHARIF",2101029,2,322,264,586
"BALKH","MAZAR-E-SHARIF",2101001,10,233,72,305
"BALKH","MAZAR-E-SHARIF",2101015,1,278,311,589
"BALKH","MAZAR-E-SHARIF",2101015,2,266,254,520
"BALKH","MAZAR-E-SHARIF",2101015,3,166,220,386
"BALKH","MAZAR-E-SHARIF",2101015,4,209,217,426
"BALKH","MAZAR-E-SHARIF",2101015,5,258,318,576
"BALKH","MAZAR-E-SHARIF",2101015,6,149,187,336
"BALKH","MAZAR-E-SHARIF",2101015,7,165,146,311
"BALKH","MAZAR-E-SHARIF",2101015,8,158,155,313
"BALKH","MAZAR-E-SHARIF",2101004,5,138,169,307
"BALKH","MAZAR-E-SHARIF",2101004,6,206,201,407
"BALKH","MAZAR-E-SHARIF",2101008,1,271,317,588
"BALKH","MAZAR-E-SHARIF",2101008,2,245,310,555
"BALKH","MAZAR-E-SHARIF",2101008,3,236,247,483
"BALKH","MAZAR-E-SHARIF",2101008,4,179,174,353
"BALKH","MAZAR-E-SHARIF",2101008,5,142,145,287
"BALKH","MAZAR-E-SHARIF",2101044,6,433,151,584
"BALKH","MAZAR-E-SHARIF",2101044,7,263,130,393
"BALKH","MAZAR-E-SHARIF",2101044,8,218,55,273
"BALKH","MAZAR-E-SHARIF",2101003,3,449,139,588
"BALKH","MAZAR-E-SHARIF",2101024,2,246,207,453
"BALKH","MAZAR-E-SHARIF",2101024,3,274,205,479
"BALKH","MAZAR-E-SHARIF",2101003,6,83,128,211
"BALKH","MAZAR-E-SHARIF",2101005,10,178,198,376
"BALKH","MAZAR-E-SHARIF",2101037,6,184,143,327
"BALKH","MAZAR-E-SHARIF",2101030,2,92,61,153
"BALKH","MAZAR-E-SHARIF",2101014,5,293,133,426
"BALKH","MAZAR-E-SHARIF",2101014,6,429,159,588
"BALKH","MAZAR-E-SHARIF",2101014,7,383,199,582
"BALKH","MAZAR-E-SHARIF",2101014,8,388,204,592
"BALKH","MAZAR-E-SHARIF",2101032,1,282,207,489
"BALKH","MAZAR-E-SHARIF",2101020,7,192,194,386
"BALKH","MAZAR-E-SHARIF",2101032,3,200,151,351
"BALKH","MAZAR-E-SHARIF",2101032,4,261,117,378
"BALKH","MAZAR-E-SHARIF",2101032,5,157,104,261
"BALKH","MAZAR-E-SHARIF",2101032,6,89,71,160
"BALKH","MAZAR-E-SHARIF",2101025,1,462,86,548
"BALKH","MAZAR-E-SHARIF",2101025,2,420,67,487
"BALKH","MAZAR-E-SHARIF",2101025,3,290,41,331
"BALKH","MAZAR-E-SHARIF",2101025,4,417,59,476
"BALKH","MAZAR-E-SHARIF",2101025,5,302,46,348
"BALKH","MAZAR-E-SHARIF",2101025,6,345,49,394
"BALKH","MAZAR-E-SHARIF",2101025,7,293,40,333
"BALKH","MAZAR-E-SHARIF",2101025,8,294,37,331
"BALKH","MAZAR-E-SHARIF",2101025,9,259,44,303
"BALKH","MAZAR-E-SHARIF",2101002,3,248,33,281
"BALKH","MAZAR-E-SHARIF",2101002,4,286,48,334
"BALKH","MAZAR-E-SHARIF",2101002,5,288,58,346
"BALKH","MAZAR-E-SHARIF",2101002,6,548,42,590
"BALKH","MAZAR-E-SHARIF",2101015,9,206,229,435
"BALKH","MAZAR-E-SHARIF",2101019,1,389,138,527
"BALKH","MAZAR-E-SHARIF",2101019,2,305,56,361
"BALKH","MAZAR-E-SHARIF",2101019,3,226,82,308
"BALKH","MAZAR-E-SHARIF",2101005,1,227,366,593
"BALKH","MAZAR-E-SHARIF",2101005,2,254,295,549
"BALKH","MAZAR-E-SHARIF",2101005,3,268,322,590
"BALKH","MAZAR-E-SHARIF",2101005,4,155,204,359
"BALKH","MAZAR-E-SHARIF",2101005,5,237,341,578
"BALKH","MAZAR-E-SHARIF",2101005,6,208,275,483
"BALKH","MAZAR-E-SHARIF",2101005,7,143,177,320
"BALKH","MAZAR-E-SHARIF",2101003,4,304,90,394
"BALKH","MAZAR-E-SHARIF",2101003,5,260,29,289
"BALKH","MAZAR-E-SHARIF",2101005,9,206,257,463
"BALKH","MAZAR-E-SHARIF",2101027,2,269,121,390
"BALKH","MAZAR-E-SHARIF",2101006,1,189,246,435
"BALKH","MAZAR-E-SHARIF",2101020,1,230,156,386
"BALKH","MAZAR-E-SHARIF",2101014,2,366,225,591
"BALKH","MAZAR-E-SHARIF",2101014,3,342,188,530
"BALKH","MAZAR-E-SHARIF",2101014,4,317,174,491
"BALKH","MAZAR-E-SHARIF",2101022,6,164,42,206
"BALKH","MAZAR-E-SHARIF",2101022,7,257,45,302
"BALKH","MAZAR-E-SHARIF",2101018,3,361,140,501
"BALKH","MAZAR-E-SHARIF",2101018,4,219,70,289
"BALKH","MAZAR-E-SHARIF",2101018,5,233,74,307
"BALKH","MAZAR-E-SHARIF",2101018,6,407,144,551
"BALKH","MAZAR-E-SHARIF",2101018,7,280,67,347
"BALKH","MAZAR-E-SHARIF",2101018,8,338,111,449
"BALKH","MAZAR-E-SHARIF",2101018,9,245,86,331
"BALKH","MAZAR-E-SHARIF",2101040,6,370,146,516
"BALKH","MAZAR-E-SHARIF",2101040,7,266,103,369
"BALKH","MAZAR-E-SHARIF",2101043,1,167,95,262
"BALKH","MAZAR-E-SHARIF",2101043,2,200,162,362
"BALKH","MAZAR-E-SHARIF",2101043,3,152,64,216
"BALKH","MAZAR-E-SHARIF",2101043,4,146,64,210
"BALKH","MAZAR-E-SHARIF",2101043,5,82,55,137
"BALKH","MAZAR-E-SHARIF",2101021,1,278,186,464
"BALKH","MAZAR-E-SHARIF",2101021,2,241,151,392
"BALKH","MAZAR-E-SHARIF",2101021,3,269,157,426
"BALKH","MAZAR-E-SHARIF",2101021,4,154,74,228
"BALKH","MAZAR-E-SHARIF",2101021,5,134,72,206
"BALKH","MAZAR-E-SHARIF",2101028,4,207,145,352
"BALKH","MAZAR-E-SHARIF",2101007,2,288,130,418
"BALKH","MAZAR-E-SHARIF",2101007,3,226,131,357
"BALKH","MAZAR-E-SHARIF",2101007,4,216,100,316
"BALKH","MAZAR-E-SHARIF",2101007,5,96,32,128
"BALKH","MAZAR-E-SHARIF",2101007,6,52,40,92
"BALKH","MAZAR-E-SHARIF",2101007,7,39,14,53
"BALKH","MAZAR-E-SHARIF",2101007,8,39,11,50
"BALKH","MAZAR-E-SHARIF",2101003,1,431,154,585
"BALKH","MAZAR-E-SHARIF",2101003,2,453,136,589
"BALKH","MAZAR-E-SHARIF",2101033,6,238,194,432
"BALKH","MAZAR-E-SHARIF",2101033,7,124,105,229
"BALKH","MAZAR-E-SHARIF",2101027,1,240,112,352
"BALKH","MAZAR-E-SHARIF",2101039,9,450,139,589
"BALKH","MAZAR-E-SHARIF",2101027,3,189,53,242
"BALKH","MAZAR-E-SHARIF",2101027,4,167,80,247
"BALKH","MAZAR-E-SHARIF",2101022,1,270,104,374
"BALKH","MAZAR-E-SHARIF",2101022,2,211,70,281
"BALKH","MAZAR-E-SHARIF",2101022,3,227,93,320
"BALKH","MAZAR-E-SHARIF",2101010,4,35,24,59
"BALKH","MAZAR-E-SHARIF",2101010,5,56,33,89
"BALKH","MAZAR-E-SHARIF",2101022,8,246,46,292
"BALKH","MAZAR-E-SHARIF",2101022,9,299,67,366
"BALKH","MAZAR-E-SHARIF",2101040,1,394,187,581
"BALKH","MAZAR-E-SHARIF",2101040,2,404,184,588
"BALKH","MAZAR-E-SHARIF",2101040,3,461,122,583
"BALKH","MAZAR-E-SHARIF",2101040,4,377,196,573
"BALKH","MAZAR-E-SHARIF",2101040,5,355,157,512
"BALKH","MAZAR-E-SHARIF",2101011,6,119,108,227
"BALKH","MAZAR-E-SHARIF",2101023,1,334,76,410
"BALKH","MAZAR-E-SHARIF",2101040,8,261,126,387
"BALKH","MAZAR-E-SHARIF",2101029,3,320,236,556
"BALKH","MAZAR-E-SHARIF",2101029,4,333,245,578
"BALKH","MAZAR-E-SHARIF",2101029,5,309,262,571
"BALKH","MAZAR-E-SHARIF",2101029,6,343,212,555
"BALKH","MAZAR-E-SHARIF",2101029,7,308,216,524
"BALKH","MAZAR-E-SHARIF",2101029,8,172,140,312
"BALKH","MAZAR-E-SHARIF",2101029,9,157,98,255
"BALKH","MAZAR-E-SHARIF",2101007,1,301,206,507
"BALKH","MAZAR-E-SHARIF",2101028,1,335,258,593
"BALKH","MAZAR-E-SHARIF",2101028,2,358,233,591
"BALKH","MAZAR-E-SHARIF",2101028,3,229,143,372
"BALKH","MAZAR-E-SHARIF",2101028,5,144,92,236
"BALKH","MAZAR-E-SHARIF",2101028,6,90,54,144
"BALKH","MAZAR-E-SHARIF",2101019,4,363,87,450
"BALKH","MAZAR-E-SHARIF",2101019,5,409,160,569
"BALKH","MAZAR-E-SHARIF",2101039,1,382,206,588
"BALKH","MAZAR-E-SHARIF",2101039,2,406,178,584
"BALKH","MAZAR-E-SHARIF",2101039,3,393,194,587
"BALKH","MAZAR-E-SHARIF",2101039,4,406,174,580
"BALKH","MAZAR-E-SHARIF",2101039,5,432,153,585
"BALKH","MAZAR-E-SHARIF",2101039,6,429,125,554
"BALKH","MAZAR-E-SHARIF",2101005,8,259,267,526
"BALKH","MAZAR-E-SHARIF",2101039,7,453,131,584
"BALKH","MAZAR-E-SHARIF",2101039,10,173,88,261
"BALKH","MAZAR-E-SHARIF",2101039,11,220,102,322
"BALKH","MAZAR-E-SHARIF",2101026,2,179,86,265
"BALKH","MAZAR-E-SHARIF",2101010,1,364,222,586
"BALKH","MAZAR-E-SHARIF",2101010,2,373,214,587
"BALKH","MAZAR-E-SHARIF",2101022,4,312,119,431
"BALKH","MAZAR-E-SHARIF",2101022,5,181,45,226
"BALKH","MAZAR-E-SHARIF",2101010,6,62,34,96
"BALKH","MAZAR-E-SHARIF",2101010,7,242,125,367
"BALKH","MAZAR-E-SHARIF",2101032,2,254,147,401
"BALKH","MAZAR-E-SHARIF",2101011,2,385,203,588
"BALKH","MAZAR-E-SHARIF",2101011,3,55,47,102
"BALKH","MAZAR-E-SHARIF",2101011,4,117,31,148
"BALKH","MAZAR-E-SHARIF",2101011,5,43,22,65
"BALKH","MAZAR-E-SHARIF",2101026,1,139,68,207
"BALKH","MAZAR-E-SHARIF",2101031,10,72,30,102
"BALKH","MAZAR-E-SHARIF",2101023,2,380,113,493
"BALKH","MAZAR-E-SHARIF",2101023,3,186,60,246
"BALKH","MAZAR-E-SHARIF",2101023,4,433,129,562
"BALKH","MAZAR-E-SHARIF",2101023,5,351,46,397
"BALKH","MAZAR-E-SHARIF",2101023,6,365,74,439
"BALKH","MAZAR-E-SHARIF",2101023,7,471,75,546
"BALKH","MAZAR-E-SHARIF",2101002,1,532,60,592
"BALKH","MAZAR-E-SHARIF",2101002,2,437,48,485
"BALKH","MAZAR-E-SHARIF",2101038,6,322,244,566
"BALKH","MAZAR-E-SHARIF",2101031,7,76,34,110
"BALKH","MAZAR-E-SHARIF",2101031,8,94,69,163
"BALKH","MAZAR-E-SHARIF",2101031,9,73,39,112
"BALKH","MAZAR-E-SHARIF",2101044,3,365,214,579
"BALKH","MAZAR-E-SHARIF",2101012,1,176,122,298
"BALKH","MAZAR-E-SHARIF",2101044,1,413,174,587
"BALKH","MAZAR-E-SHARIF",2101044,2,401,183,584
"BALKH","MAZAR-E-SHARIF",2101033,4,131,118,249
"BALKH","MAZAR-E-SHARIF",2101044,4,369,206,575
"BALKH","MAZAR-E-SHARIF",2101044,5,442,139,581
"BALKH","MAZAR-E-SHARIF",2101033,3,235,193,428
"BALKH","MAZAR-E-SHARIF",2101039,8,439,150,589
"BALKH","MAZAR-E-SHARIF",2101033,5,173,207,380
"BALKH","MAZAR-E-SHARIF",2101009,3,161,116,277
"BALKH","MAZAR-E-SHARIF",2101009,4,175,70,245
"BALKH","MAZAR-E-SHARIF",2101026,4,87,33,120
"BALKH","MAZAR-E-SHARIF",2101010,3,371,214,585
"BALKH","MAZAR-E-SHARIF",2101006,3,230,272,502
"BALKH","MAZAR-E-SHARIF",2101026,3,107,34,141
"BALKH","MAZAR-E-SHARIF",2101006,6,95,146,241
"BALKH","MAZAR-E-SHARIF",2101009,1,293,149,442
"BALKH","MAZAR-E-SHARIF",2101009,2,271,131,402
"BALKH","MAZAR-E-SHARIF",2101006,5,138,149,287
"BALKH","MAZAR-E-SHARIF",2101038,2,200,164,364
"BALKH","MAZAR-E-SHARIF",2101009,5,321,148,469
"BALKH","MAZAR-E-SHARIF",2101031,1,316,160,476
"BALKH","MAZAR-E-SHARIF",2101031,6,65,48,113
"BALKH","MAZAR-E-SHARIF",2101011,1,361,225,586
"BALKH","MAZAR-E-SHARIF",2101012,2,222,163,385
"BALKH","MAZAR-E-SHARIF",2101038,4,215,180,395
"BALKH","MAZAR-E-SHARIF",2101038,1,310,265,575
"BALKH","MAZAR-E-SHARIF",2101012,4,188,141,329
"BALKH","MAZAR-E-SHARIF",2101038,3,263,220,483
"BALKH","MAZAR-E-SHARIF",2101033,1,254,263,517
"BALKH","MAZAR-E-SHARIF",2101038,5,316,263,579
"BALKH","MAZAR-E-SHARIF",2101031,4,146,90,236
"BALKH","MAZAR-E-SHARIF",2101012,5,157,136,293
"BALKH","MAZAR-E-SHARIF",2101012,3,221,164,385
"BALKH","MAZAR-E-SHARIF",2101031,3,130,76,206
"BALKH","MAZAR-E-SHARIF",2101031,5,145,65,210
"BALKH","MAZAR-E-SHARIF",2101033,2,221,203,424
"BALKH","MAZAR-E-SHARIF",2101031,2,245,158,403
"BALKH","MAZAR-E-SHARIF",2101006,2,191,227,418
"BALKH","MAZAR-E-SHARIF",2101006,4,186,280,466
"BALKH","NAHR-E-SHAHI",2102070,2,457,126,583
"BALKH","NAHR-E-SHAHI",2102070,1,457,126,583
"BALKH","NAHR-E-SHAHI",2102067,6,285,296,581
"BALKH","NAHR-E-SHAHI",2102063,3,334,180,514
"BALKH","NAHR-E-SHAHI",2102063,2,373,215,588
"BALKH","NAHR-E-SHAHI",2102063,5,337,71,408
"BALKH","NAHR-E-SHAHI",2102067,8,321,245,566
"BALKH","NAHR-E-SHAHI",2102067,5,313,259,572
"BALKH","NAHR-E-SHAHI",2102065,2,306,273,579
"BALKH","NAHR-E-SHAHI",2102067,4,288,295,583
"BALKH","NAHR-E-SHAHI",2102067,7,294,297,591
"BALKH","NAHR-E-SHAHI",2102063,4,325,168,493
"BALKH","NAHR-E-SHAHI",2102067,9,123,235,358
"BALKH","NAHR-E-SHAHI",2102068,1,297,51,348
"BALKH","NAHR-E-SHAHI",2102065,3,264,322,586
"BALKH","NAHR-E-SHAHI",2102063,1,374,216,590
"BALKH","NAHR-E-SHAHI",2102065,5,172,172,344
"BALKH","NAHR-E-SHAHI",2102063,6,335,57,392
"BALKH","NAHR-E-SHAHI",2102068,2,228,49,277
"BALKH","NAHR-E-SHAHI",2102064,5,472,70,542
"BALKH","NAHR-E-SHAHI",2102064,2,452,116,568
"BALKH","NAHR-E-SHAHI",2102064,4,475,62,537
"BALKH","NAHR-E-SHAHI",2102065,1,294,293,587
"BALKH","NAHR-E-SHAHI",2102070,3,451,146,597
"BALKH","NAHR-E-SHAHI",2102065,4,293,287,580
"BALKH","NAHR-E-SHAHI",2102070,4,499,91,590
"BALKH","NAHR-E-SHAHI",2102070,5,489,89,578
"BALKH","NAHR-E-SHAHI",2102067,3,322,255,577
"BALKH","NAHR-E-SHAHI",2102066,2,178,23,201
"BALKH","NAHR-E-SHAHI",2102066,3,53,92,145
"BALKH","NAHR-E-SHAHI",2102064,3,459,119,578
"BALKH","NAHR-E-SHAHI",2102069,2,5,59,64
"BALKH","NAHR-E-SHAHI",2102069,3,3,1,4
"BALKH","NAHR-E-SHAHI",2102069,4,4,1,5
"BALKH","NAHR-E-SHAHI",2102069,1,8,63,71
"BALKH","NAHR-E-SHAHI",2102067,2,293,281,574
"BALKH","NAHR-E-SHAHI",2102321,1,377,12,389
"BALKH","NAHR-E-SHAHI",2102321,2,442,6,448
"BALKH","NAHR-E-SHAHI",2102064,1,461,115,576
"BALKH","NAHR-E-SHAHI",2102068,3,348,29,377
"BALKH","NAHR-E-SHAHI",2102067,1,289,294,583
"BALKH","NAHR-E-SHAHI",2102063,7,313,87,400
"BALKH","NAHR-E-SHAHI",2102066,1,113,155,268
"BALKH","NAHR-E-SHAHI",2102070,6,154,40,194
"BALKH","DEHDADI",2103050,1,248,116,364
"BALKH","DEHDADI",2103050,2,297,181,478
"BALKH","DEHDADI",2103057,1,160,95,255
"BALKH","DEHDADI",2103057,4,411,177,588
"BALKH","DEHDADI",2103058,3,165,79,244
"BALKH","DEHDADI",2103058,4,162,90,252
"BALKH","DEHDADI",2103058,2,326,154,480
"BALKH","DEHDADI",2103050,4,307,180,487
"BALKH","DEHDADI",2103059,4,445,40,485
"BALKH","DEHDADI",2103056,1,308,123,431
"BALKH","DEHDADI",2103050,3,233,117,350
"BALKH","DEHDADI",2103059,2,462,108,570
"BALKH","DEHDADI",2103059,3,406,65,471
"BALKH","DEHDADI",2103052,2,323,257,580
"BALKH","DEHDADI",2103052,3,171,147,318
"BALKH","DEHDADI",2103059,5,195,33,228
"BALKH","DEHDADI",2103056,2,228,84,312
"BALKH","DEHDADI",2103057,2,215,135,350
"BALKH","DEHDADI",2103051,1,502,85,587
"BALKH","DEHDADI",2103058,1,285,168,453
"BALKH","DEHDADI",2103053,3,204,78,282
"BALKH","DEHDADI",2103062,4,147,59,206
"BALKH","DEHDADI",2103056,3,246,81,327
"BALKH","DEHDADI",2103051,2,375,49,424
"BALKH","DEHDADI",2103051,3,37,11,48
"BALKH","DEHDADI",2103060,1,476,94,570
"BALKH","DEHDADI",2103062,3,194,96,290
"BALKH","DEHDADI",2103057,5,106,48,154
"BALKH","DEHDADI",2103059,1,464,120,584
"BALKH","DEHDADI",2103061,6,211,169,380
"BALKH","DEHDADI",2103054,2,296,77,373
"BALKH","DEHDADI",2103052,1,321,253,574
"BALKH","DEHDADI",2103050,5,236,133,369
"BALKH","DEHDADI",2103057,3,257,194,451
"BALKH","DEHDADI",2103052,4,228,214,442
"BALKH","DEHDADI",2103052,5,311,276,587
"BALKH","DEHDADI",2103053,1,154,52,206
"BALKH","DEHDADI",2103053,2,151,63,214
"BALKH","DEHDADI",2103062,1,214,118,332
"BALKH","DEHDADI",2103062,2,273,151,424
"BALKH","DEHDADI",2103055,2,256,100,356
"BALKH","DEHDADI",2103060,2,503,23,526
"BALKH","DEHDADI",2103054,1,412,185,597
"BALKH","DEHDADI",2103055,1,313,130,443
"BALKH","DEHDADI",2103049,1,192,105,297
"BALKH","DEHDADI",2103061,4,266,215,481
"BALKH","DEHDADI",2103056,4,428,157,585
"BALKH","DEHDADI",2103049,4,349,132,481
"BALKH","DEHDADI",2103049,3,126,72,198
"BALKH","DEHDADI",2103061,1,183,158,341
"BALKH","DEHDADI",2103061,5,243,207,450
"BALKH","DEHDADI",2103060,3,101,16,117
"BALKH","DEHDADI",2103052,6,331,263,594
"BALKH","DEHDADI",2103052,7,112,125,237
"BALKH","DEHDADI",2103055,3,403,183,586
"BALKH","DEHDADI",2103055,4,91,46,137
"BALKH","DEHDADI",2103061,3,318,210,528
"BALKH","DEHDADI",2103049,2,149,85,234
"BALKH","DEHDADI",2103061,2,143,117,260
"BALKH","CHAR KENT",2104286,1,84,46,130
"BALKH","CHAR KENT",2104276,2,103,65,168
"BALKH","CHAR KENT",2104276,1,108,166,274
"BALKH","CHAR KENT",2104283,3,161,29,190
"BALKH","CHAR KENT",2104274,3,132,11,143
"BALKH","CHAR KENT",2104279,1,133,36,169
"BALKH","CHAR KENT",2104283,2,183,56,239
"BALKH","CHAR KENT",2104274,2,66,15,81
"BALKH","CHAR KENT",2104285,3,53,21,74
"BALKH","CHAR KENT",2104279,2,171,12,183
"BALKH","CHAR KENT",2104282,2,80,29,109
"BALKH","CHAR KENT",2104277,2,39,188,227
"BALKH","CHAR KENT",2104280,1,309,51,360
"BALKH","CHAR KENT",2104277,1,81,136,217
"BALKH","CHAR KENT",2104277,3,13,72,85
"BALKH","CHAR KENT",2104275,3,158,45,203
"BALKH","CHAR KENT",2104280,2,115,22,137
"BALKH","CHAR KENT",2104278,1,70,71,141
"BALKH","CHAR KENT",2104278,2,36,192,228
"BALKH","CHAR KENT",2104274,1,74,37,111
"BALKH","CHAR KENT",2104283,1,202,13,215
"BALKH","CHAR KENT",2104285,2,45,50,95
"BALKH","CHAR KENT",2104281,1,115,56,171
"BALKH","CHAR KENT",2104282,1,134,126,260
"BALKH","CHAR KENT",2104275,1,106,63,169
"BALKH","CHAR KENT",2104275,2,151,48,199
"BALKH","CHAR KENT",2104284,1,197,19,216
"BALKH","CHAR KENT",2104281,2,64,46,110
"BALKH","CHAR KENT",2104278,3,12,18,30
"BALKH","CHAR KENT",2104285,1,26,20,46
"BALKH","CHAR KENT",2104284,2,170,25,195
"BALKH","CHAR KENT",2104286,2,97,39,136
"BALKH","CHAR KENT",2104284,3,230,20,250
"BALKH","MARMUL",2105071,1,574,13,587
"BALKH","MARMUL",2105071,2,595,1,596
"BALKH","MARMUL",2105073,3,582,4,586
"BALKH","MARMUL",2105072,3,592,2,594
"BALKH","MARMUL",2105071,3,561,10,571
"BALKH","MARMUL",2105073,2,179,6,185
"BALKH","MARMUL",2105075,2,588,0,588
"BALKH","MARMUL",2105071,4,574,4,578
"BALKH","MARMUL",2105072,2,532,11,543
"BALKH","MARMUL",2105075,1,579,8,587
"BALKH","MARMUL",2105073,1,253,9,262
"BALKH","MARMUL",2105074,2,550,6,556
"BALKH","MARMUL",2105074,3,589,1,590
"BALKH","MARMUL",2105072,1,470,12,482
"BALKH","MARMUL",2105074,1,388,10,398
"BALKH","BALKH",2106177,2,7,53,60
"BALKH","BALKH",2106169,1,77,354,431
"BALKH","BALKH",2106169,2,49,276,325
"BALKH","BALKH",2106151,3,181,148,329
"BALKH","BALKH",2106148,2,184,184,368
"BALKH","BALKH",2106151,1,226,160,386
"BALKH","BALKH",2106151,2,116,115,231
"BALKH","BALKH",2106168,3,70,66,136
"BALKH","BALKH",2106153,1,278,304,582
"BALKH","BALKH",2106153,2,354,224,578
"BALKH","BALKH",2106153,3,43,72,115
"BALKH","BALKH",2106165,1,108,279,387
"BALKH","BALKH",2106173,1,15,131,146
"BALKH","BALKH",2106168,1,54,59,113
"BALKH","BALKH",2106168,2,41,57,98
"BALKH","BALKH",2106159,1,134,25,159
"BALKH","BALKH",2106157,1,54,366,420
"BALKH","BALKH",2106173,2,4,30,34
"BALKH","BALKH",2106177,1,16,132,148
"BALKH","BALKH",2106154,2,87,170,257
"BALKH","BALKH",2106159,2,88,18,106
"BALKH","BALKH",2106159,3,363,19,382
"BALKH","BALKH",2106174,3,170,41,211
"BALKH","BALKH",2106148,3,320,132,452
"BALKH","BALKH",2106154,3,202,220,422
"BALKH","BALKH",2106167,1,184,301,485
"BALKH","BALKH",2106154,1,133,182,315
"BALKH","BALKH",2106176,6,105,73,178
"BALKH","BALKH",2106155,3,337,81,418
"BALKH","BALKH",2106176,4,89,73,162
"BALKH","BALKH",2106176,5,112,56,168
"BALKH","BALKH",2106170,1,11,188,199
"BALKH","BALKH",2106163,3,298,11,309
"BALKH","BALKH",2106147,4,137,108,245
"BALKH","BALKH",2106169,3,76,266,342
"BALKH","BALKH",2106171,3,8,24,32
"BALKH","BALKH",2106158,1,216,38,254
"BALKH","BALKH",2106158,2,159,54,213
"BALKH","BALKH",2106158,3,126,42,168
"BALKH","BALKH",2106158,4,390,172,562
"BALKH","BALKH",2106147,1,227,183,410
"BALKH","BALKH",2106147,3,126,96,222
"BALKH","BALKH",2106166,3,13,212,225
"BALKH","BALKH",2106161,1,234,113,347
"BALKH","BALKH",2106165,2,103,255,358
"BALKH","BALKH",2106170,2,8,79,87
"BALKH","BALKH",2106172,1,218,74,292
"BALKH","BALKH",2106171,2,15,35,50
"BALKH","BALKH",2106171,1,7,31,38
"BALKH","BALKH",2106174,1,167,26,193
"BALKH","BALKH",2106174,2,128,20,148
"BALKH","BALKH",2106152,2,285,37,322
"BALKH","BALKH",2106152,3,400,23,423
"BALKH","BALKH",2106166,1,10,143,153
"BALKH","BALKH",2106166,2,19,139,158
"BALKH","BALKH",2106163,2,213,17,230
"BALKH","BALKH",2106172,2,152,31,183
"BALKH","BALKH",2106160,1,80,190,270
"BALKH","BALKH",2106160,2,73,236,309
"BALKH","BALKH",2106160,3,63,208,271
"BALKH","BALKH",2106176,3,207,273,480
"BALKH","BALKH",2106167,5,132,175,307
"BALKH","BALKH",2106149,3,236,228,464
"BALKH","BALKH",2106148,1,194,180,374
"BALKH","BALKH",2106147,2,149,149,298
"BALKH","BALKH",2106320,3,6,127,133
"BALKH","BALKH",2106320,4,18,112,130
"BALKH","BALKH",2106163,1,192,30,222
"BALKH","BALKH",2106156,1,485,61,546
"BALKH","BALKH",2106167,2,138,197,335
"BALKH","BALKH",2106157,2,42,315,357
"BALKH","BALKH",2106161,2,157,69,226
"BALKH","BALKH",2106164,3,82,309,391
"BALKH","BALKH",2106152,1,358,32,390
"BALKH","BALKH",2106320,2,11,112,123
"BALKH","BALKH",2106157,3,38,383,421
"BALKH","BALKH",2106164,2,71,231,302
"BALKH","BALKH",2106155,1,480,44,524
"BALKH","BALKH",2106156,2,418,62,480
"BALKH","BALKH",2106320,1,16,157,173
"BALKH","BALKH",2106149,1,176,184,360
"BALKH","BALKH",2106149,2,178,192,370
"BALKH","BALKH",2106155,2,179,31,210
"BALKH","BALKH",2106167,4,186,255,441
"BALKH","BALKH",2106162,2,23,67,90
"BALKH","BALKH",2106161,4,122,20,142
"BALKH","BALKH",2106164,1,63,186,249
"BALKH","BALKH",2106176,2,206,242,448
"BALKH","BALKH",2106162,1,39,290,329
"BALKH","BALKH",2106167,3,150,213,363
"BALKH","BALKH",2106161,3,304,26,330
"BALKH","BALKH",2106165,3,73,135,208
"BALKH","BALKH",2106176,1,153,216,369
"BALKH","BALKH",2106156,4,372,39,411
"BALKH","BALKH",2106156,3,361,38,399
"BALKH","SHOLGARA",2107248,3,231,63,294
"BALKH","SHOLGARA",2107248,2,132,46,178
"BALKH","SHOLGARA",2107248,1,97,28,125
"BALKH","SHOLGARA",2107243,1,19,173,192
"BALKH","SHOLGARA",2107239,1,268,187,455
"BALKH","SHOLGARA",2107249,2,35,195,230
"BALKH","SHOLGARA",2107272,1,409,103,512
"BALKH","SHOLGARA",2107239,3,385,205,590
"BALKH","SHOLGARA",2107261,3,6,150,156
"BALKH","SHOLGARA",2107238,3,327,181,508
"BALKH","SHOLGARA",2107246,1,240,134,374
"BALKH","SHOLGARA",2107272,2,298,162,460
"BALKH","SHOLGARA",2107243,2,2,104,106
"BALKH","SHOLGARA",2107239,2,292,168,460
"BALKH","SHOLGARA",2107247,2,33,138,171
"BALKH","SHOLGARA",2107247,3,118,164,282
"BALKH","SHOLGARA",2107261,2,33,291,324
"BALKH","SHOLGARA",2107255,1,124,128,252
"BALKH","SHOLGARA",2107245,2,98,84,182
"BALKH","SHOLGARA",2107257,2,60,184,244
"BALKH","SHOLGARA",2107249,1,30,163,193
"BALKH","SHOLGARA",2107242,2,33,108,141
"BALKH","SHOLGARA",2107261,1,48,332,380
"BALKH","SHOLGARA",2107263,3,327,96,423
"BALKH","SHOLGARA",2107247,4,126,231,357
"BALKH","SHOLGARA",2107260,2,87,25,112
"BALKH","SHOLGARA",2107260,3,158,67,225
"BALKH","SHOLGARA",2107257,1,28,198,226
"BALKH","SHOLGARA",2107260,1,109,71,180
"BALKH","SHOLGARA",2107267,1,90,137,227
"BALKH","SHOLGARA",2107250,1,175,150,325
"BALKH","SHOLGARA",2107246,2,174,87,261
"BALKH","SHOLGARA",2107253,1,75,156,231
"BALKH","SHOLGARA",2107242,1,45,80,125
"BALKH","SHOLGARA",2107263,1,130,39,169
"BALKH","SHOLGARA",2107238,1,239,103,342
"BALKH","SHOLGARA",2107238,2,191,120,311
"BALKH","SHOLGARA",2107273,2,178,110,288
"BALKH","SHOLGARA",2107266,1,101,241,342
"BALKH","SHOLGARA",2107266,2,31,103,134
"BALKH","SHOLGARA",2107272,3,498,39,537
"BALKH","SHOLGARA",2107251,1,182,47,229
"BALKH","SHOLGARA",2107270,1,44,106,150
"BALKH","SHOLGARA",2107270,2,70,200,270
"BALKH","SHOLGARA",2107265,1,69,30,99
"BALKH","SHOLGARA",2107265,2,23,13,36
"BALKH","SHOLGARA",2107265,3,180,42,222
"BALKH","SHOLGARA",2107241,1,36,77,113
"BALKH","SHOLGARA",2107241,2,48,66,114
"BALKH","SHOLGARA",2107241,3,82,50,132
"BALKH","SHOLGARA",2107247,1,35,89,124
"BALKH","SHOLGARA",2107244,1,69,78,147
"BALKH","SHOLGARA",2107244,2,32,33,65
"BALKH","SHOLGARA",2107245,1,87,146,233
"BALKH","SHOLGARA",2107268,1,27,165,192
"BALKH","SHOLGARA",2107251,2,170,44,214
"BALKH","SHOLGARA",2107251,3,446,90,536
"BALKH","SHOLGARA",2107267,2,120,118,238
"BALKH","SHOLGARA",2107255,2,64,64,128
"BALKH","SHOLGARA",2107237,1,180,176,356
"BALKH","SHOLGARA",2107246,3,334,142,476
"BALKH","SHOLGARA",2107237,3,100,140,240
"BALKH","SHOLGARA",2107263,2,179,86,265
"BALKH","SHOLGARA",2107237,5,290,301,591
"BALKH","SHOLGARA",2107262,1,156,67,223
"BALKH","SHOLGARA",2107262,2,134,36,170
"BALKH","SHOLGARA",2107244,3,156,87,243
"BALKH","SHOLGARA",2107250,2,157,118,275
"BALKH","SHOLGARA",2107266,3,4,43,47
"BALKH","SHOLGARA",2107266,4,0,45,45
"BALKH","SHOLGARA",2107257,3,32,387,419
"BALKH","SHOLGARA",2107240,2,548,50,598
"BALKH","SHOLGARA",2107250,3,347,210,557
"BALKH","SHOLGARA",2107250,4,246,125,371
"BALKH","SHOLGARA",2107240,1,418,81,499
"BALKH","SHOLGARA",2107262,3,427,136,563
"BALKH","SHOLGARA",2107273,1,128,80,208
"BALKH","SHOLGARA",2107237,4,233,240,473
"BALKH","SHOLGARA",2107258,3,259,34,293
"BALKH","SHOLGARA",2107253,2,85,141,226
"BALKH","SHOLGARA",2107258,1,165,125,290
"BALKH","SHOLGARA",2107258,2,150,38,188
"BALKH","SHOLGARA",2107269,2,71,134,205
"BALKH","SHOLGARA",2107256,1,181,57,238
"BALKH","SHOLGARA",2107256,2,100,16,116
"BALKH","SHOLGARA",2107256,3,407,54,461
"BALKH","SHOLGARA",2107271,1,29,73,102
"BALKH","SHOLGARA",2107271,2,82,56,138
"BALKH","SHOLGARA",2107268,2,5,195,200
"BALKH","SHOLGARA",2107254,1,420,178,598
"BALKH","SHOLGARA",2107252,3,116,35,151
"BALKH","SHOLGARA",2107269,1,108,246,354
"BALKH","SHOLGARA",2107237,2,135,120,255
"BALKH","SHOLGARA",2107252,2,71,36,107
"BALKH","SHOLGARA",2107259,1,66,61,127
"BALKH","SHOLGARA",2107259,2,57,125,182
"BALKH","SHOLGARA",2107259,3,120,118,238
"BALKH","SHOLGARA",2107252,1,24,16,40
"BALKH","SHOLGARA",2107264,1,197,392,589
"BALKH","SHOLGARA",2107264,2,323,166,489
"BALKH","SHOLGARA",2107254,3,432,153,585
"BALKH","SHOLGARA",2107259,4,226,220,446
"BALKH","SHOLGARA",2107254,2,315,281,596
"BALKH","CHIMTAL",2108224,5,2,7,9
"BALKH","CHIMTAL",2108218,3,57,242,299
"BALKH","CHIMTAL",2108218,2,69,112,181
"BALKH","CHIMTAL",2108224,2,45,37,82
"BALKH","CHIMTAL",2108229,1,104,20,124
"BALKH","CHIMTAL",2108224,1,22,63,85
"BALKH","CHIMTAL",2108221,1,28,23,51
"BALKH","CHIMTAL",2108230,2,248,48,296
"BALKH","CHIMTAL",2108224,4,4,8,12
"BALKH","CHIMTAL",2108211,2,204,44,248
"BALKH","CHIMTAL",2108234,1,8,103,111
"BALKH","CHIMTAL",2108323,1,377,36,413
"BALKH","CHIMTAL",2108230,1,296,62,358
"BALKH","CHIMTAL",2108224,3,10,34,44
"BALKH","CHIMTAL",2108216,1,138,20,158
"BALKH","CHIMTAL",2108234,2,2,1,3
"BALKH","CHIMTAL",2108211,1,212,54,266
"BALKH","CHIMTAL",2108226,4,341,8,349
"BALKH","CHIMTAL",2108225,1,246,12,258
"BALKH","CHIMTAL",2108229,2,158,24,182
"BALKH","CHIMTAL",2108226,3,416,18,434
"BALKH","CHIMTAL",2108225,7,166,5,171
"BALKH","CHIMTAL",2108225,5,93,12,105
"BALKH","CHIMTAL",2108231,2,6,3,9
"BALKH","CHIMTAL",2108218,1,40,214,254
"BALKH","CHIMTAL",2108227,2,427,13,440
"BALKH","CHIMTAL",2108227,3,403,20,423
"BALKH","CHIMTAL",2108226,5,366,6,372
"BALKH","CHIMTAL",2108219,1,121,66,187
"BALKH","CHIMTAL",2108229,3,248,14,262
"BALKH","CHIMTAL",2108221,2,60,49,109
"BALKH","CHIMTAL",2108221,3,116,10,126
"BALKH","CHIMTAL",2108225,2,222,20,242
"BALKH","CHIMTAL",2108225,3,92,7,99
"BALKH","CHIMTAL",2108225,6,83,4,87
"BALKH","CHIMTAL",2108232,2,231,27,258
"BALKH","CHIMTAL",2108214,3,516,63,579
"BALKH","CHIMTAL",2108227,1,360,29,389
"BALKH","CHIMTAL",2108223,2,4,95,99
"BALKH","CHIMTAL",2108226,1,358,24,382
"BALKH","CHIMTAL",2108323,2,55,0,55
"BALKH","CHIMTAL",2108227,5,247,11,258
"BALKH","CHIMTAL",2108219,2,104,31,135
"BALKH","CHIMTAL",2108211,3,382,70,452
"BALKH","CHIMTAL",2108213,1,29,342,371
"BALKH","CHIMTAL",2108222,1,12,88,100
"BALKH","CHIMTAL",2108222,2,67,81,148
"BALKH","CHIMTAL",2108225,4,80,16,96
"BALKH","CHIMTAL",2108231,1,86,216,302
"BALKH","CHIMTAL",2108232,1,150,57,207
"BALKH","CHIMTAL",2108223,1,29,303,332
"BALKH","CHIMTAL",2108216,2,206,35,241
"BALKH","CHIMTAL",2108216,3,284,47,331
"BALKH","CHIMTAL",2108226,2,361,10,371
"BALKH","CHIMTAL",2108227,4,200,12,212
"BALKH","CHIMTAL",2108213,3,28,300,328
"BALKH","CHIMTAL",2108214,1,512,70,582
"BALKH","CHIMTAL",2108219,3,176,48,224
"BALKH","CHIMTAL",2108213,2,13,349,362
"BALKH","CHIMTAL",2108233,3,5,1,6
"BALKH","CHIMTAL",2108212,3,278,156,434
"BALKH","CHIMTAL",2108214,2,295,30,325
"BALKH","CHIMTAL",2108217,2,64,22,86
"BALKH","CHIMTAL",2108212,2,210,104,314
"BALKH","CHIMTAL",2108220,1,39,147,186
"BALKH","CHIMTAL",2108227,6,320,18,338
"BALKH","CHIMTAL",2108227,7,191,9,200
"BALKH","CHIMTAL",2108217,1,85,83,168
"BALKH","CHIMTAL",2108227,8,318,5,323
"BALKH","CHIMTAL",2108233,1,12,198,210
"BALKH","CHIMTAL",2108233,2,5,115,120
"BALKH","CHIMTAL",2108235,2,28,69,97
"BALKH","CHIMTAL",2108212,1,170,73,243
"BALKH","CHIMTAL",2108220,2,48,59,107
"BALKH","CHIMTAL",2108235,1,3,3,6
"BALKH","CHIMTAL",2108215,2,324,14,338
"BALKH","CHIMTAL",2108215,1,414,72,486
"BALKH","DAWLAT ABAD",2109126,1,67,85,152
"BALKH","DAWLAT ABAD",2109131,2,23,105,128
"BALKH","DAWLAT ABAD",2109118,1,135,43,178
"BALKH","DAWLAT ABAD",2109141,1,56,227,283
"BALKH","DAWLAT ABAD",2109137,2,365,31,396
"BALKH","DAWLAT ABAD",2109131,1,76,82,158
"BALKH","DAWLAT ABAD",2109137,3,318,52,370
"BALKH","DAWLAT ABAD",2109120,4,55,508,563
"BALKH","DAWLAT ABAD",2109141,2,27,67,94
"BALKH","DAWLAT ABAD",2109131,3,22,77,99
"BALKH","DAWLAT ABAD",2109126,2,66,94,160
"BALKH","DAWLAT ABAD",2109126,3,33,46,79
"BALKH","DAWLAT ABAD",2109133,3,54,129,183
"BALKH","DAWLAT ABAD",2109137,1,396,61,457
"BALKH","DAWLAT ABAD",2109143,2,50,20,70
"BALKH","DAWLAT ABAD",2109120,3,58,508,566
"BALKH","DAWLAT ABAD",2109133,2,83,79,162
"BALKH","DAWLAT ABAD",2109123,1,52,323,375
"BALKH","DAWLAT ABAD",2109118,2,76,48,124
"BALKH","DAWLAT ABAD",2109118,3,170,44,214
"BALKH","DAWLAT ABAD",2109118,4,134,37,171
"BALKH","DAWLAT ABAD",2109139,1,63,147,210
"BALKH","DAWLAT ABAD",2109132,4,139,248,387
"BALKH","DAWLAT ABAD",2109119,2,397,86,483
"BALKH","DAWLAT ABAD",2109136,1,153,69,222
"BALKH","DAWLAT ABAD",2109136,2,149,10,159
"BALKH","DAWLAT ABAD",2109120,2,54,446,500
"BALKH","DAWLAT ABAD",2109139,2,31,109,140
"BALKH","DAWLAT ABAD",2109127,2,39,161,200
"BALKH","DAWLAT ABAD",2109127,3,7,57,64
"BALKH","DAWLAT ABAD",2109131,4,81,62,143
"BALKH","DAWLAT ABAD",2109131,5,62,143,205
"BALKH","DAWLAT ABAD",2109135,2,386,43,429
"BALKH","DAWLAT ABAD",2109132,1,124,234,358
"BALKH","DAWLAT ABAD",2109132,2,201,196,397
"BALKH","DAWLAT ABAD",2109143,1,86,93,179
"BALKH","DAWLAT ABAD",2109142,1,143,195,338
"BALKH","DAWLAT ABAD",2109142,2,140,178,318
"BALKH","DAWLAT ABAD",2109120,1,66,517,583
"BALKH","DAWLAT ABAD",2109128,3,34,85,119
"BALKH","DAWLAT ABAD",2109127,1,62,223,285
"BALKH","DAWLAT ABAD",2109146,1,14,79,93
"BALKH","DAWLAT ABAD",2109145,1,8,117,125
"BALKH","DAWLAT ABAD",2109123,2,129,311,440
"BALKH","DAWLAT ABAD",2109135,1,223,50,273
"BALKH","DAWLAT ABAD",2109144,2,96,21,117
"BALKH","DAWLAT ABAD",2109128,1,32,138,170
"BALKH","DAWLAT ABAD",2109138,1,251,175,426
"BALKH","DAWLAT ABAD",2109132,3,156,257,413
"BALKH","DAWLAT ABAD",2109128,2,25,98,123
"BALKH","DAWLAT ABAD",2109124,1,82,145,227
"BALKH","DAWLAT ABAD",2109133,1,75,83,158
"BALKH","DAWLAT ABAD",2109124,3,241,201,442
"BALKH","DAWLAT ABAD",2109129,1,132,127,259
"BALKH","DAWLAT ABAD",2109125,2,34,161,195
"BALKH","DAWLAT ABAD",2109124,2,80,163,243
"BALKH","DAWLAT ABAD",2109140,2,198,5,203
"BALKH","DAWLAT ABAD",2109138,2,103,96,199
"BALKH","DAWLAT ABAD",2109121,2,62,99,161
"BALKH","DAWLAT ABAD",2109119,1,390,103,493
"BALKH","DAWLAT ABAD",2109134,2,24,2,26
"BALKH","DAWLAT ABAD",2109121,1,118,143,261
"BALKH","DAWLAT ABAD",2109146,2,3,30,33
"BALKH","DAWLAT ABAD",2109140,1,183,16,199
"BALKH","DAWLAT ABAD",2109129,2,161,113,274
"BALKH","DAWLAT ABAD",2109130,1,296,153,449
"BALKH","DAWLAT ABAD",2109122,2,58,311,369
"BALKH","DAWLAT ABAD",2109134,1,50,51,101
"BALKH","DAWLAT ABAD",2109144,1,84,32,116
"BALKH","DAWLAT ABAD",2109125,1,107,242,349
"BALKH","DAWLAT ABAD",2109145,2,9,171,180
"BALKH","DAWLAT ABAD",2109122,1,76,367,443
"BALKH","DAWLAT ABAD",2109124,4,234,117,351
"BALKH","DAWLAT ABAD",2109130,2,258,58,316
"BALKH","KHULM",2110078,1,404,107,511
"BALKH","KHULM",2110098,1,127,37,164
"BALKH","KHULM",2110098,2,202,16,218
"BALKH","KHULM",2110096,2,25,13,38
"BALKH","KHULM",2110081,3,177,19,196
"BALKH","KHULM",2110084,2,76,6,82
"BALKH","KHULM",2110087,3,215,22,237
"BALKH","KHULM",2110086,1,143,56,199
"BALKH","KHULM",2110090,1,123,88,211
"BALKH","KHULM",2110084,1,125,30,155
"BALKH","KHULM",2110076,2,182,61,243
"BALKH","KHULM",2110096,1,42,19,61
"BALKH","KHULM",2110097,2,26,126,152
"BALKH","KHULM",2110086,2,107,49,156
"BALKH","KHULM",2110079,1,262,28,290
"BALKH","KHULM",2110087,2,144,26,170
"BALKH","KHULM",2110083,3,209,78,287
"BALKH","KHULM",2110080,3,146,34,180
"BALKH","KHULM",2110076,1,234,72,306
"BALKH","KHULM",2110087,1,166,29,195
"BALKH","KHULM",2110086,3,196,59,255
"BALKH","KHULM",2110077,2,281,76,357
"BALKH","KHULM",2110078,2,297,76,373
"BALKH","KHULM",2110078,3,173,19,192
"BALKH","KHULM",2110097,1,28,136,164
"BALKH","KHULM",2110091,2,167,21,188
"BALKH","KHULM",2110092,1,100,62,162
"BALKH","KHULM",2110092,2,77,88,165
"BALKH","KHULM",2110083,2,166,76,242
"BALKH","KHULM",2110090,3,187,102,289
"BALKH","KHULM",2110077,1,276,79,355
"BALKH","KHULM",2110077,3,191,41,232
"BALKH","KHULM",2110077,4,236,31,267
"BALKH","KHULM",2110080,1,217,64,281
"BALKH","KHULM",2110093,1,74,56,130
"BALKH","KHULM",2110093,2,52,14,66
"BALKH","KHULM",2110094,1,89,21,110
"BALKH","KHULM",2110090,2,79,62,141
"BALKH","KHULM",2110081,1,131,47,178
"BALKH","KHULM",2110081,2,145,45,190
"BALKH","KHULM",2110083,1,175,74,249
"BALKH","KHULM",2110079,2,295,33,328
"BALKH","KHULM",2110094,2,56,13,69
"BALKH","KHULM",2110089,1,100,147,247
"BALKH","KHULM",2110076,3,256,70,326
"BALKH","KHULM",2110082,3,118,42,160
"BALKH","KHULM",2110089,3,160,256,416
"BALKH","KHULM",2110088,3,297,28,325
"BALKH","KHULM",2110089,2,90,131,221
"BALKH","KHULM",2110077,5,225,37,262
"BALKH","KHULM",2110082,2,123,50,173
"BALKH","KHULM",2110079,3,309,25,334
"BALKH","KHULM",2110080,2,142,30,172
"BALKH","KHULM",2110091,1,225,42,267
"BALKH","KHULM",2110076,5,264,63,327
"BALKH","KHULM",2110085,1,76,11,87
"BALKH","KHULM",2110076,4,226,55,281
"BALKH","KHULM",2110088,1,178,42,220
"BALKH","KHULM",2110088,2,187,32,219
"BALKH","KHULM",2110082,1,223,89,312
"BALKH","KHULM",2110085,3,79,25,104
"BALKH","KHULM",2110076,7,193,32,225
"BALKH","KHULM",2110085,2,63,8,71
"BALKH","KHULM",2110076,6,186,42,228
"BALKH","CHAR BOLAK",2111197,2,82,150,232
"BALKH","CHAR BOLAK",2111202,1,47,57,104
"BALKH","CHAR BOLAK",2111202,2,12,35,47
"BALKH","CHAR BOLAK",2111194,1,29,220,249
"BALKH","CHAR BOLAK",2111187,2,293,218,511
"BALKH","CHAR BOLAK",2111184,2,71,218,289
"BALKH","CHAR BOLAK",2111188,2,25,106,131
"BALKH","CHAR BOLAK",2111185,2,17,61,78
"BALKH","CHAR BOLAK",2111184,1,110,147,257
"BALKH","CHAR BOLAK",2111187,1,13,170,183
"BALKH","CHAR BOLAK",2111194,2,13,170,183
"BALKH","CHAR BOLAK",2111194,3,26,348,374
"BALKH","CHAR BOLAK",2111184,3,178,180,358
"BALKH","CHAR BOLAK",2111188,1,50,256,306
"BALKH","CHAR BOLAK",2111185,1,38,148,186
"BALKH","CHAR BOLAK",2111178,2,145,157,302
"BALKH","CHAR BOLAK",2111178,4,55,40,95
"BALKH","CHAR BOLAK",2111199,3,59,67,126
"BALKH","CHAR BOLAK",2111192,2,22,161,183
"BALKH","CHAR BOLAK",2111197,1,105,280,385
"BALKH","CHAR BOLAK",2111178,3,189,74,263
"BALKH","CHAR BOLAK",2111192,1,11,114,125
"BALKH","CHAR BOLAK",2111190,2,21,45,66
"BALKH","CHAR BOLAK",2111322,2,168,417,585
"BALKH","CHAR BOLAK",2111203,1,3,28,31
"BALKH","CHAR BOLAK",2111210,1,19,119,138
"BALKH","CHAR BOLAK",2111193,3,35,192,227
"BALKH","CHAR BOLAK",2111199,1,48,58,106
"BALKH","CHAR BOLAK",2111180,1,175,303,478
"BALKH","CHAR BOLAK",2111180,2,135,169,304
"BALKH","CHAR BOLAK",2111203,2,5,35,40
"BALKH","CHAR BOLAK",2111203,3,19,16,35
"BALKH","CHAR BOLAK",2111192,3,17,207,224
"BALKH","CHAR BOLAK",2111205,1,59,387,446
"BALKH","CHAR BOLAK",2111190,1,56,120,176
"BALKH","CHAR BOLAK",2111196,2,65,182,247
"BALKH","CHAR BOLAK",2111181,3,311,19,330
"BALKH","CHAR BOLAK",2111179,2,20,94,114
"BALKH","CHAR BOLAK",2111196,1,36,463,499
"BALKH","CHAR BOLAK",2111179,3,55,142,197
"BALKH","CHAR BOLAK",2111193,2,25,108,133
"BALKH","CHAR BOLAK",2111199,2,49,50,99
"BALKH","CHAR BOLAK",2111207,2,358,182,540
"BALKH","CHAR BOLAK",2111198,1,21,207,228
"BALKH","CHAR BOLAK",2111189,1,135,54,189
"BALKH","CHAR BOLAK",2111210,2,8,125,133
"BALKH","CHAR BOLAK",2111206,2,4,48,52
"BALKH","CHAR BOLAK",2111181,1,170,31,201
"BALKH","CHAR BOLAK",2111181,2,142,50,192
"BALKH","CHAR BOLAK",2111179,1,31,135,166
"BALKH","CHAR BOLAK",2111183,1,32,77,109
"BALKH","CHAR BOLAK",2111178,1,101,113,214
"BALKH","CHAR BOLAK",2111182,2,7,437,444
"BALKH","CHAR BOLAK",2111193,1,25,103,128
"BALKH","CHAR BOLAK",2111322,1,18,163,181
"BALKH","CHAR BOLAK",2111207,1,132,101,233
"BALKH","CHAR BOLAK",2111191,1,35,366,401
"BALKH","CHAR BOLAK",2111205,2,46,193,239
"BALKH","CHAR BOLAK",2111200,3,18,66,84
"BALKH","CHAR BOLAK",2111206,1,31,159,190
"BALKH","CHAR BOLAK",2111182,1,34,333,367
"BALKH","CHAR BOLAK",2111191,2,10,115,125
"BALKH","CHAR BOLAK",2111201,2,86,12,98
"BALKH","CHAR BOLAK",2111198,2,15,179,194
"BALKH","CHAR BOLAK",2111200,1,14,70,84
"BALKH","CHAR BOLAK",2111209,2,2,3,5
"BALKH","CHAR BOLAK",2111195,1,19,375,394
"BALKH","CHAR BOLAK",2111186,1,185,39,224
"BALKH","CHAR BOLAK",2111186,2,63,4,67
"BALKH","CHAR BOLAK",2111200,2,6,27,33
"BALKH","CHAR BOLAK",2111201,1,92,74,166
"BALKH","CHAR BOLAK",2111189,2,126,36,162
"BALKH","CHAR BOLAK",2111183,3,66,125,191
"BALKH","CHAR BOLAK",2111209,1,8,123,131
"BALKH","CHAR BOLAK",2111198,3,2,146,148
"BALKH","CHAR BOLAK",2111183,2,67,123,190
"BALKH","CHAR BOLAK",2111195,2,13,436,449
"BALKH","SHORTEPA",2112108,1,43,83,126
"BALKH","SHORTEPA",2112108,2,57,105,162
"BALKH","SHORTEPA",2112114,1,85,43,128
"BALKH","SHORTEPA",2112111,3,65,194,259
"BALKH","SHORTEPA",2112110,3,205,189,394
"BALKH","SHORTEPA",2112109,2,332,146,478
"BALKH","SHORTEPA",2112112,2,136,167,303
"BALKH","SHORTEPA",2112109,3,82,247,329
"BALKH","SHORTEPA",2112112,1,229,184,413
"BALKH","SHORTEPA",2112117,1,171,115,286
"BALKH","SHORTEPA",2112110,1,274,227,501
"BALKH","SHORTEPA",2112108,3,55,117,172
"BALKH","SHORTEPA",2112110,2,281,217,498
"BALKH","SHORTEPA",2112111,2,56,163,219
"BALKH","SHORTEPA",2112114,2,154,51,205
"BALKH","SHORTEPA",2112114,3,151,22,173
"BALKH","SHORTEPA",2112108,4,2,71,73
"BALKH","SHORTEPA",2112113,1,116,203,319
"BALKH","SHORTEPA",2112113,2,47,105,152
"BALKH","SHORTEPA",2112116,1,181,324,505
"BALKH","SHORTEPA",2112116,2,82,141,223
"BALKH","SHORTEPA",2112109,1,145,380,525
"BALKH","SHORTEPA",2112111,1,57,154,211
"BALKH","SHORTEPA",2112115,2,90,353,443
"BALKH","SHORTEPA",2112115,3,54,165,219
"BALKH","SHORTEPA",2112113,4,44,134,178
"BALKH","SHORTEPA",2112112,3,7,16,23
"BALKH","SHORTEPA",2112113,3,77,191,268
"BALKH","SHORTEPA",2112115,1,135,459,594
"BALKH","SHORTEPA",2112117,2,72,35,107
"BALKH","KALDAR",2113104,1,203,255,458
"BALKH","KALDAR",2113102,1,166,140,306
"BALKH","KALDAR",2113101,1,71,201,272
"BALKH","KALDAR",2113106,2,21,26,47
"BALKH","KALDAR",2113099,2,309,270,579
"BALKH","KALDAR",2113099,4,362,194,556
"BALKH","KALDAR",2113101,2,142,150,292
"BALKH","KALDAR",2113099,6,167,176,343
"BALKH","KALDAR",2113102,2,108,70,178
"BALKH","KALDAR",2113099,1,364,227,591
"BALKH","KALDAR",2113099,5,367,174,541
"BALKH","KALDAR",2113101,3,98,161,259
"BALKH","KALDAR",2113099,3,314,261,575
"BALKH","KALDAR",2113100,1,105,128,233
"BALKH","KALDAR",2113103,2,116,34,150
"BALKH","KALDAR",2113100,2,103,152,255
"BALKH","KALDAR",2113106,1,141,115,256
"BALKH","KALDAR",2113107,2,41,23,64
"BALKH","KALDAR",2113107,1,135,103,238
"BALKH","KALDAR",2113103,1,210,85,295
"BALKH","KALDAR",2113104,2,48,87,135
"BALKH","KALDAR",2113105,1,188,87,275
"BALKH","KALDAR",2113105,2,67,64,131
"BALKH","KALDAR",2113100,3,79,73,152
"BALKH","KISHINDEH",2114302,2,78,98,176
"BALKH","KISHINDEH",2114293,2,135,12,147
"BALKH","KISHINDEH",2114287,3,150,47,197
"BALKH","KISHINDEH",2114297,2,209,1,210
"BALKH","KISHINDEH",2114287,2,269,58,327
"BALKH","KISHINDEH",2114302,1,101,167,268
"BALKH","KISHINDEH",2114287,4,104,24,128
"BALKH","KISHINDEH",2114298,1,77,111,188
"BALKH","KISHINDEH",2114287,6,463,115,578
"BALKH","KISHINDEH",2114292,1,402,8,410
"BALKH","KISHINDEH",2114300,2,193,27,220
"BALKH","KISHINDEH",2114293,1,240,18,258
"BALKH","KISHINDEH",2114297,1,316,18,334
"BALKH","KISHINDEH",2114296,1,164,13,177
"BALKH","KISHINDEH",2114300,1,124,36,160
"BALKH","KISHINDEH",2114287,5,436,149,585
"BALKH","KISHINDEH",2114298,3,124,256,380
"BALKH","KISHINDEH",2114292,2,312,2,314
"BALKH","KISHINDEH",2114293,3,272,64,336
"BALKH","KISHINDEH",2114298,2,81,115,196
"BALKH","KISHINDEH",2114291,2,260,109,369
"BALKH","KISHINDEH",2114295,1,330,37,367
"BALKH","KISHINDEH",2114291,3,416,165,581
"BALKH","KISHINDEH",2114287,1,453,102,555
"BALKH","KISHINDEH",2114288,1,164,17,181
"BALKH","KISHINDEH",2114301,2,505,13,518
"BALKH","KISHINDEH",2114288,3,467,15,482
"BALKH","KISHINDEH",2114295,2,331,31,362
"BALKH","KISHINDEH",2114301,3,420,24,444
"BALKH","KISHINDEH",2114288,2,175,13,188
"BALKH","KISHINDEH",2114289,2,180,0,180
"BALKH","KISHINDEH",2114291,1,271,70,341
"BALKH","KISHINDEH",2114299,2,390,19,409
"BALKH","KISHINDEH",2114289,1,161,13,174
"BALKH","KISHINDEH",2114299,1,228,25,253
"BALKH","KISHINDEH",2114301,1,577,17,594
"BALKH","KISHINDEH",2114290,1,172,241,413
"BALKH","KISHINDEH",2114290,3,156,337,493
"BALKH","KISHINDEH",2114296,2,179,3,182
"BALKH","KISHINDEH",2114290,2,147,184,331
"BALKH","KISHINDEH",2114296,3,209,0,209
"BALKH","ZARI",2115317,2,170,31,201
"BALKH","ZARI",2115318,3,476,67,543
"BALKH","ZARI",2115303,2,84,272,356
"BALKH","ZARI",2115317,1,106,66,172
"BALKH","ZARI",2115303,1,54,277,331
"BALKH","ZARI",2115303,3,52,152,204
"BALKH","ZARI",2115303,4,122,453,575
"BALKH","ZARI",2115318,1,409,178,587
"BALKH","ZARI",2115309,1,273,291,564
"BALKH","ZARI",2115311,2,491,45,536
"BALKH","ZARI",2115310,3,577,21,598
"BALKH","ZARI",2115319,1,360,226,586
"BALKH","ZARI",2115304,2,65,97,162
"BALKH","ZARI",2115318,2,354,84,438
"BALKH","ZARI",2115324,3,24,17,41
"BALKH","ZARI",2115304,1,63,118,181
"BALKH","ZARI",2115314,1,282,132,414
"BALKH","ZARI",2115307,3,594,5,599
"BALKH","ZARI",2115324,1,20,43,63
"BALKH","ZARI",2115311,3,575,13,588
"BALKH","ZARI",2115307,2,586,14,600
"BALKH","ZARI",2115313,4,206,207,413
"BALKH","ZARI",2115304,3,102,255,357
"BALKH","ZARI",2115311,1,449,45,494
"BALKH","ZARI",2115324,2,47,16,63
"BALKH","ZARI",2115307,1,501,92,593
"BALKH","ZARI",2115310,1,568,30,598
"BALKH","ZARI",2115319,2,341,244,585
"BALKH","ZARI",2115309,2,235,350,585
"BALKH","ZARI",2115306,1,275,31,306
"BALKH","ZARI",2115309,3,215,261,476
"BALKH","ZARI",2115310,2,550,48,598
"BALKH","ZARI",2115306,2,377,30,407
"BALKH","ZARI",2115305,1,132,175,307
"BALKH","ZARI",2115316,2,458,9,467
"BALKH","ZARI",2115308,1,299,66,365
"BALKH","ZARI",2115308,2,210,101,311
"BALKH","ZARI",2115305,4,147,133,280
"BALKH","ZARI",2115316,1,193,7,200
"BALKH","ZARI",2115313,2,319,217,536
"BALKH","ZARI",2115313,3,425,162,587
"BALKH","ZARI",2115319,3,192,236,428
"BALKH","ZARI",2115313,1,186,145,331
"BALKH","ZARI",2115314,2,586,14,600
"BALKH","ZARI",2115305,3,133,104,237
"BALKH","ZARI",2115305,2,157,116,273
"SAR-E-PUL","SAR-E-PUL",2201002,13,33,315,348
"SAR-E-PUL","SAR-E-PUL",2201002,11,51,274,325
"SAR-E-PUL","SAR-E-PUL",2201009,1,75,69,144
"SAR-E-PUL","SAR-E-PUL",2201004,3,151,205,356
"SAR-E-PUL","SAR-E-PUL",2201004,1,180,253,433
"SAR-E-PUL","SAR-E-PUL",2201002,12,53,347,400
"SAR-E-PUL","SAR-E-PUL",2201006,5,65,511,576
"SAR-E-PUL","SAR-E-PUL",2201002,10,55,348,403
"SAR-E-PUL","SAR-E-PUL",2201004,4,63,164,227
"SAR-E-PUL","SAR-E-PUL",2201004,2,125,260,385
"SAR-E-PUL","SAR-E-PUL",2201010,5,29,215,244
"SAR-E-PUL","SAR-E-PUL",2201003,1,54,150,204
"SAR-E-PUL","SAR-E-PUL",2201002,9,90,407,497
"SAR-E-PUL","SAR-E-PUL",2201004,6,228,359,587
"SAR-E-PUL","SAR-E-PUL",2201004,7,218,371,589
"SAR-E-PUL","SAR-E-PUL",2201010,6,3,17,20
"SAR-E-PUL","SAR-E-PUL",2201001,6,54,141,195
"SAR-E-PUL","SAR-E-PUL",2201001,3,124,256,380
"SAR-E-PUL","SAR-E-PUL",2201001,4,99,213,312
"SAR-E-PUL","SAR-E-PUL",2201001,5,114,220,334
"SAR-E-PUL","SAR-E-PUL",2201009,2,95,55,150
"SAR-E-PUL","SAR-E-PUL",2201001,7,37,139,176
"SAR-E-PUL","SAR-E-PUL",2201001,8,77,346,423
"SAR-E-PUL","SAR-E-PUL",2201001,9,51,275,326
"SAR-E-PUL","SAR-E-PUL",2201003,8,54,242,296
"SAR-E-PUL","SAR-E-PUL",2201003,9,46,193,239
"SAR-E-PUL","SAR-E-PUL",2201002,7,45,209,254
"SAR-E-PUL","SAR-E-PUL",2201002,8,83,220,303
"SAR-E-PUL","SAR-E-PUL",2201006,3,39,320,359
"SAR-E-PUL","SAR-E-PUL",2201006,4,39,359,398
"SAR-E-PUL","SAR-E-PUL",2201021,1,74,122,196
"SAR-E-PUL","SAR-E-PUL",2201005,1,199,321,520
"SAR-E-PUL","SAR-E-PUL",2201003,2,52,140,192
"SAR-E-PUL","SAR-E-PUL",2201003,3,99,290,389
"SAR-E-PUL","SAR-E-PUL",2201003,4,95,292,387
"SAR-E-PUL","SAR-E-PUL",2201009,3,59,70,129
"SAR-E-PUL","SAR-E-PUL",2201009,4,30,53,83
"SAR-E-PUL","SAR-E-PUL",2201009,5,100,95,195
"SAR-E-PUL","SAR-E-PUL",2201009,6,102,79,181
"SAR-E-PUL","SAR-E-PUL",2201015,3,433,67,500
"SAR-E-PUL","SAR-E-PUL",2201015,4,289,209,498
"SAR-E-PUL","SAR-E-PUL",2201013,1,30,78,108
"SAR-E-PUL","SAR-E-PUL",2201013,2,41,90,131
"SAR-E-PUL","SAR-E-PUL",2201013,3,27,153,180
"SAR-E-PUL","SAR-E-PUL",2201011,1,121,240,361
"SAR-E-PUL","SAR-E-PUL",2201004,5,87,156,243
"SAR-E-PUL","SAR-E-PUL",2201026,2,41,21,62
"SAR-E-PUL","SAR-E-PUL",2201026,3,48,6,54
"SAR-E-PUL","SAR-E-PUL",2201003,5,53,218,271
"SAR-E-PUL","SAR-E-PUL",2201003,6,90,466,556
"SAR-E-PUL","SAR-E-PUL",2201003,7,18,319,337
"SAR-E-PUL","SAR-E-PUL",2201015,2,162,25,187
"SAR-E-PUL","SAR-E-PUL",2201032,4,44,159,203
"SAR-E-PUL","SAR-E-PUL",2201004,8,160,271,431
"SAR-E-PUL","SAR-E-PUL",2201008,1,31,226,257
"SAR-E-PUL","SAR-E-PUL",2201008,2,33,226,259
"SAR-E-PUL","SAR-E-PUL",2201008,3,37,150,187
"SAR-E-PUL","SAR-E-PUL",2201008,4,55,201,256
"SAR-E-PUL","SAR-E-PUL",2201008,5,32,269,301
"SAR-E-PUL","SAR-E-PUL",2201007,1,187,45,232
"SAR-E-PUL","SAR-E-PUL",2201001,10,80,309,389
"SAR-E-PUL","SAR-E-PUL",2201001,11,79,278,357
"SAR-E-PUL","SAR-E-PUL",2201032,1,14,127,141
"SAR-E-PUL","SAR-E-PUL",2201032,2,19,75,94
"SAR-E-PUL","SAR-E-PUL",2201032,3,7,86,93
"SAR-E-PUL","SAR-E-PUL",2201002,6,66,275,341
"SAR-E-PUL","SAR-E-PUL",2201002,5,52,180,232
"SAR-E-PUL","SAR-E-PUL",2201006,2,47,328,375
"SAR-E-PUL","SAR-E-PUL",2201027,2,77,43,120
"SAR-E-PUL","SAR-E-PUL",2201027,3,151,36,187
"SAR-E-PUL","SAR-E-PUL",2201027,4,74,58,132
"SAR-E-PUL","SAR-E-PUL",2201013,4,91,330,421
"SAR-E-PUL","SAR-E-PUL",2201021,2,96,100,196
"SAR-E-PUL","SAR-E-PUL",2201021,3,91,29,120
"SAR-E-PUL","SAR-E-PUL",2201005,2,121,178,299
"SAR-E-PUL","SAR-E-PUL",2201005,3,142,205,347
"SAR-E-PUL","SAR-E-PUL",2201005,4,171,309,480
"SAR-E-PUL","SAR-E-PUL",2201005,5,107,278,385
"SAR-E-PUL","SAR-E-PUL",2201005,6,93,188,281
"SAR-E-PUL","SAR-E-PUL",2201010,1,34,175,209
"SAR-E-PUL","SAR-E-PUL",2201010,2,55,165,220
"SAR-E-PUL","SAR-E-PUL",2201010,3,44,153,197
"SAR-E-PUL","SAR-E-PUL",2201010,4,73,172,245
"SAR-E-PUL","SAR-E-PUL",2201031,1,80,387,467
"SAR-E-PUL","SAR-E-PUL",2201031,2,39,151,190
"SAR-E-PUL","SAR-E-PUL",2201026,1,32,37,69
"SAR-E-PUL","SAR-E-PUL",2201029,1,146,26,172
"SAR-E-PUL","SAR-E-PUL",2201011,2,131,89,220
"SAR-E-PUL","SAR-E-PUL",2201011,3,175,114,289
"SAR-E-PUL","SAR-E-PUL",2201017,1,130,146,276
"SAR-E-PUL","SAR-E-PUL",2201017,2,114,58,172
"SAR-E-PUL","SAR-E-PUL",2201017,3,115,87,202
"SAR-E-PUL","SAR-E-PUL",2201001,1,196,329,525
"SAR-E-PUL","SAR-E-PUL",2201032,5,51,140,191
"SAR-E-PUL","SAR-E-PUL",2201034,1,224,26,250
"SAR-E-PUL","SAR-E-PUL",2201034,2,144,87,231
"SAR-E-PUL","SAR-E-PUL",2201029,2,113,33,146
"SAR-E-PUL","SAR-E-PUL",2201029,3,115,56,171
"SAR-E-PUL","SAR-E-PUL",2201031,3,71,162,233
"SAR-E-PUL","SAR-E-PUL",2201002,2,21,72,93
"SAR-E-PUL","SAR-E-PUL",2201002,3,59,174,233
"SAR-E-PUL","SAR-E-PUL",2201002,4,82,379,461
"SAR-E-PUL","SAR-E-PUL",2201002,1,44,204,248
"SAR-E-PUL","SAR-E-PUL",2201027,1,76,68,144
"SAR-E-PUL","SAR-E-PUL",2201030,3,29,22,51
"SAR-E-PUL","SAR-E-PUL",2201020,3,273,315,588
"SAR-E-PUL","SAR-E-PUL",2201006,1,45,263,308
"SAR-E-PUL","SAR-E-PUL",2201020,1,461,137,598
"SAR-E-PUL","SAR-E-PUL",2201020,2,123,461,584
"SAR-E-PUL","SAR-E-PUL",2201011,4,293,244,537
"SAR-E-PUL","SAR-E-PUL",2201021,4,75,45,120
"SAR-E-PUL","SAR-E-PUL",2201007,6,408,52,460
"SAR-E-PUL","SAR-E-PUL",2201001,2,131,333,464
"SAR-E-PUL","SAR-E-PUL",2201007,7,224,43,267
"SAR-E-PUL","SAR-E-PUL",2201015,1,172,329,501
"SAR-E-PUL","SAR-E-PUL",2201007,5,217,32,249
"SAR-E-PUL","SAR-E-PUL",2201007,2,280,82,362
"SAR-E-PUL","SAR-E-PUL",2201007,4,116,43,159
"SAR-E-PUL","SAR-E-PUL",2201026,4,45,4,49
"SAR-E-PUL","SAR-E-PUL",2201030,1,39,54,93
"SAR-E-PUL","SAR-E-PUL",2201007,3,207,50,257
"SAR-E-PUL","SAR-E-PUL",2201029,4,257,83,340
"SAR-E-PUL","SAR-E-PUL",2201030,2,95,55,150
"SAR-E-PUL","SAYAD",2202052,4,91,100,191
"SAR-E-PUL","SAYAD",2202052,1,138,90,228
"SAR-E-PUL","SAYAD",2202053,2,150,165,315
"SAR-E-PUL","SAYAD",2202050,2,40,82,122
"SAR-E-PUL","SAYAD",2202053,1,161,104,265
"SAR-E-PUL","SAYAD",2202050,1,78,51,129
"SAR-E-PUL","SAYAD",2202050,3,9,99,108
"SAR-E-PUL","SAYAD",2202052,3,22,164,186
"SAR-E-PUL","SAYAD",2202060,1,354,153,507
"SAR-E-PUL","SAYAD",2202059,1,64,157,221
"SAR-E-PUL","SAYAD",2202059,2,15,21,36
"SAR-E-PUL","SAYAD",2202059,3,2,32,34
"SAR-E-PUL","SAYAD",2202048,5,14,367,381
"SAR-E-PUL","SAYAD",2202048,6,26,238,264
"SAR-E-PUL","SAYAD",2202056,2,106,8,114
"SAR-E-PUL","SAYAD",2202048,4,9,124,133
"SAR-E-PUL","SAYAD",2202060,2,293,194,487
"SAR-E-PUL","SAYAD",2202053,3,42,84,126
"SAR-E-PUL","SAYAD",2202052,2,135,119,254
"SAR-E-PUL","SAYAD",2202056,3,38,2,40
"SAR-E-PUL","SAYAD",2202055,2,93,36,129
"SAR-E-PUL","SAYAD",2202056,1,186,9,195
"SAR-E-PUL","SAYAD",2202049,1,128,134,262
"SAR-E-PUL","SAYAD",2202053,4,79,38,117
"SAR-E-PUL","SAYAD",2202048,3,15,149,164
"SAR-E-PUL","SAYAD",2202054,2,51,22,73
"SAR-E-PUL","SAYAD",2202054,3,43,22,65
"SAR-E-PUL","SAYAD",2202055,1,251,123,374
"SAR-E-PUL","SAYAD",2202054,1,75,47,122
"SAR-E-PUL","SAYAD",2202048,2,35,269,304
"SAR-E-PUL","SAYAD",2202049,3,43,44,87
"SAR-E-PUL","SAYAD",2202057,1,298,65,363
"SAR-E-PUL","SAYAD",2202057,2,157,39,196
"SAR-E-PUL","SAYAD",2202051,1,115,102,217
"SAR-E-PUL","SAYAD",2202048,1,27,233,260
"SAR-E-PUL","SAYAD",2202051,2,16,90,106
"SAR-E-PUL","SAYAD",2202049,2,124,129,253
"SAR-E-PUL","SAYAD",2202057,3,144,37,181
"SAR-E-PUL","KOHISTANAT",2203084,2,170,34,204
"SAR-E-PUL","KOHISTANAT",2203082,1,486,105,591
"SAR-E-PUL","KOHISTANAT",2203066,2,86,33,119
"SAR-E-PUL","KOHISTANAT",2203084,1,256,144,400
"SAR-E-PUL","KOHISTANAT",2203063,2,207,6,213
"SAR-E-PUL","KOHISTANAT",2203062,2,46,544,590
"SAR-E-PUL","KOHISTANAT",2203064,1,137,197,334
"SAR-E-PUL","KOHISTANAT",2203066,1,37,42,79
"SAR-E-PUL","KOHISTANAT",2203070,2,311,288,599
"SAR-E-PUL","KOHISTANAT",2203070,3,317,236,553
"SAR-E-PUL","KOHISTANAT",2203063,4,108,6,114
"SAR-E-PUL","KOHISTANAT",2203064,3,79,87,166
"SAR-E-PUL","KOHISTANAT",2203082,3,550,41,591
"SAR-E-PUL","KOHISTANAT",2203085,1,244,73,317
"SAR-E-PUL","KOHISTANAT",2203063,3,329,3,332
"SAR-E-PUL","KOHISTANAT",2203070,1,298,260,558
"SAR-E-PUL","KOHISTANAT",2203061,2,117,480,597
"SAR-E-PUL","KOHISTANAT",2203061,3,133,466,599
"SAR-E-PUL","KOHISTANAT",2203064,2,225,281,506
"SAR-E-PUL","KOHISTANAT",2203082,2,417,105,522
"SAR-E-PUL","KOHISTANAT",2203083,1,460,132,592
"SAR-E-PUL","KOHISTANAT",2203061,6,6,593,599
"SAR-E-PUL","KOHISTANAT",2203066,3,150,96,246
"SAR-E-PUL","KOHISTANAT",2203061,5,5,580,585
"SAR-E-PUL","KOHISTANAT",2203069,1,275,267,542
"SAR-E-PUL","KOHISTANAT",2203069,2,266,323,589
"SAR-E-PUL","KOHISTANAT",2203063,1,161,4,165
"SAR-E-PUL","KOHISTANAT",2203061,4,154,416,570
"SAR-E-PUL","KOHISTANAT",2203083,2,547,35,582
"SAR-E-PUL","KOHISTANAT",2203137,3,330,186,516
"SAR-E-PUL","KOHISTANAT",2203061,1,91,507,598
"SAR-E-PUL","KOHISTANAT",2203062,1,81,506,587
"SAR-E-PUL","KOHISTANAT",2203085,2,107,28,135
"SAR-E-PUL","KOHISTANAT",2203065,2,48,34,82
"SAR-E-PUL","KOHISTANAT",2203137,2,219,180,399
"SAR-E-PUL","KOHISTANAT",2203138,1,302,289,591
"SAR-E-PUL","KOHISTANAT",2203138,3,291,307,598
"SAR-E-PUL","KOHISTANAT",2203137,1,351,248,599
"SAR-E-PUL","KOHISTANAT",2203065,1,71,58,129
"SAR-E-PUL","KOHISTANAT",2203065,3,9,4,13
"SAR-E-PUL","KOHISTANAT",2203138,2,265,329,594
"SAR-E-PUL","SOZMA QALA",2204038,2,34,559,593
"SAR-E-PUL","SOZMA QALA",2204036,1,51,255,306
"SAR-E-PUL","SOZMA QALA",2204038,3,87,468,555
"SAR-E-PUL","SOZMA QALA",2204038,1,56,196,252
"SAR-E-PUL","SOZMA QALA",2204140,3,87,503,590
"SAR-E-PUL","SOZMA QALA",2204039,1,161,427,588
"SAR-E-PUL","SOZMA QALA",2204041,1,40,169,209
"SAR-E-PUL","SOZMA QALA",2204140,2,76,420,496
"SAR-E-PUL","SOZMA QALA",2204039,2,206,391,597
"SAR-E-PUL","SOZMA QALA",2204039,3,207,365,572
"SAR-E-PUL","SOZMA QALA",2204140,1,30,565,595
"SAR-E-PUL","SOZMA QALA",2204141,2,25,354,379
"SAR-E-PUL","SOZMA QALA",2204041,2,23,118,141
"SAR-E-PUL","SOZMA QALA",2204041,3,45,148,193
"SAR-E-PUL","SOZMA QALA",2204141,1,15,240,255
"SAR-E-PUL","SOZMA QALA",2204044,3,30,244,274
"SAR-E-PUL","SOZMA QALA",2204037,2,32,512,544
"SAR-E-PUL","SOZMA QALA",2204036,2,21,371,392
"SAR-E-PUL","SOZMA QALA",2204041,4,28,566,594
"SAR-E-PUL","SOZMA QALA",2204035,5,110,228,338
"SAR-E-PUL","SOZMA QALA",2204035,4,185,328,513
"SAR-E-PUL","SOZMA QALA",2204043,1,21,395,416
"SAR-E-PUL","SOZMA QALA",2204044,1,32,232,264
"SAR-E-PUL","SOZMA QALA",2204037,1,74,515,589
"SAR-E-PUL","SOZMA QALA",2204047,1,6,157,163
"SAR-E-PUL","SOZMA QALA",2204044,2,7,408,415
"SAR-E-PUL","SOZMA QALA",2204043,2,17,369,386
"SAR-E-PUL","SOZMA QALA",2204035,2,82,178,260
"SAR-E-PUL","SOZMA QALA",2204035,3,43,206,249
"SAR-E-PUL","SOZMA QALA",2204045,1,42,134,176
"SAR-E-PUL","SOZMA QALA",2204036,3,64,450,514
"SAR-E-PUL","SOZMA QALA",2204045,2,87,173,260
"SAR-E-PUL","SOZMA QALA",2204047,2,0,168,168
"SAR-E-PUL","SOZMA QALA",2204035,1,92,423,515
"SAR-E-PUL","SOZMA QALA",2204141,3,9,182,191
"SAR-E-PUL","SANG CHARAK",2205104,1,228,48,276
"SAR-E-PUL","SANG CHARAK",2205105,2,48,211,259
"SAR-E-PUL","SANG CHARAK",2205108,4,405,82,487
"SAR-E-PUL","SANG CHARAK",2205103,4,377,46,423
"SAR-E-PUL","SANG CHARAK",2205102,1,481,117,598
"SAR-E-PUL","SANG CHARAK",2205102,2,389,211,600
"SAR-E-PUL","SANG CHARAK",2205105,1,45,186,231
"SAR-E-PUL","SANG CHARAK",2205116,3,68,210,278
"SAR-E-PUL","SANG CHARAK",2205105,3,27,195,222
"SAR-E-PUL","SANG CHARAK",2205107,4,30,310,340
"SAR-E-PUL","SANG CHARAK",2205108,1,495,91,586
"SAR-E-PUL","SANG CHARAK",2205103,3,378,72,450
"SAR-E-PUL","SANG CHARAK",2205107,3,34,509,543
"SAR-E-PUL","SANG CHARAK",2205108,3,450,74,524
"SAR-E-PUL","SANG CHARAK",2205105,4,23,306,329
"SAR-E-PUL","SANG CHARAK",2205111,4,313,82,395
"SAR-E-PUL","SANG CHARAK",2205108,2,506,74,580
"SAR-E-PUL","SANG CHARAK",2205111,1,387,77,464
"SAR-E-PUL","SANG CHARAK",2205111,2,213,70,283
"SAR-E-PUL","SANG CHARAK",2205111,3,278,74,352
"SAR-E-PUL","SANG CHARAK",2205107,2,21,294,315
"SAR-E-PUL","SANG CHARAK",2205109,1,274,81,355
"SAR-E-PUL","SANG CHARAK",2205109,2,285,111,396
"SAR-E-PUL","SANG CHARAK",2205116,4,91,140,231
"SAR-E-PUL","SANG CHARAK",2205116,1,86,186,272
"SAR-E-PUL","SANG CHARAK",2205104,3,345,102,447
"SAR-E-PUL","SANG CHARAK",2205101,4,353,125,478
"SAR-E-PUL","SANG CHARAK",2205103,1,393,85,478
"SAR-E-PUL","SANG CHARAK",2205118,2,158,49,207
"SAR-E-PUL","SANG CHARAK",2205121,2,150,163,313
"SAR-E-PUL","SANG CHARAK",2205116,2,54,148,202
"SAR-E-PUL","SANG CHARAK",2205142,3,34,547,581
"SAR-E-PUL","SANG CHARAK",2205101,1,290,87,377
"SAR-E-PUL","SANG CHARAK",2205117,1,45,190,235
"SAR-E-PUL","SANG CHARAK",2205101,3,285,204,489
"SAR-E-PUL","SANG CHARAK",2205101,2,260,82,342
"SAR-E-PUL","SANG CHARAK",2205142,2,22,195,217
"SAR-E-PUL","SANG CHARAK",2205118,1,252,48,300
"SAR-E-PUL","SANG CHARAK",2205121,1,244,90,334
"SAR-E-PUL","SANG CHARAK",2205142,1,46,259,305
"SAR-E-PUL","SANG CHARAK",2205106,2,25,192,217
"SAR-E-PUL","SANG CHARAK",2205106,3,42,150,192
"SAR-E-PUL","SANG CHARAK",2205103,2,268,91,359
"SAR-E-PUL","SANG CHARAK",2205106,1,37,192,229
"SAR-E-PUL","SANG CHARAK",2205113,2,427,98,525
"SAR-E-PUL","SANG CHARAK",2205112,1,261,11,272
"SAR-E-PUL","SANG CHARAK",2205112,2,117,3,120
"SAR-E-PUL","SANG CHARAK",2205107,1,27,323,350
"SAR-E-PUL","SANG CHARAK",2205117,2,23,252,275
"SAR-E-PUL","SANG CHARAK",2205110,1,348,87,435
"SAR-E-PUL","SANG CHARAK",2205110,2,472,107,579
"SAR-E-PUL","SANG CHARAK",2205120,2,154,16,170
"SAR-E-PUL","SANG CHARAK",2205104,2,322,40,362
"SAR-E-PUL","SANG CHARAK",2205113,1,304,61,365
"SAR-E-PUL","SANG CHARAK",2205119,2,185,13,198
"SAR-E-PUL","SANG CHARAK",2205106,4,23,173,196
"SAR-E-PUL","SANG CHARAK",2205119,1,193,36,229
"SAR-E-PUL","SANG CHARAK",2205120,1,106,123,229
"SAR-E-PUL","SANG CHARAK",2205117,3,37,395,432
"SAR-E-PUL","GOSFANDI",2206123,1,59,334,393
"SAR-E-PUL","GOSFANDI",2206124,1,68,315,383
"SAR-E-PUL","GOSFANDI",2206128,2,160,54,214
"SAR-E-PUL","GOSFANDI",2206135,1,162,52,214
"SAR-E-PUL","GOSFANDI",2206123,3,38,556,594
"SAR-E-PUL","GOSFANDI",2206134,4,180,198,378
"SAR-E-PUL","GOSFANDI",2206130,2,68,113,181
"SAR-E-PUL","GOSFANDI",2206130,3,72,138,210
"SAR-E-PUL","GOSFANDI",2206123,2,62,240,302
"SAR-E-PUL","GOSFANDI",2206124,2,74,248,322
"SAR-E-PUL","GOSFANDI",2206128,1,136,68,204
"SAR-E-PUL","GOSFANDI",2206125,2,129,465,594
"SAR-E-PUL","GOSFANDI",2206128,3,215,110,325
"SAR-E-PUL","GOSFANDI",2206130,1,71,176,247
"SAR-E-PUL","GOSFANDI",2206134,1,168,217,385
"SAR-E-PUL","GOSFANDI",2206134,2,46,164,210
"SAR-E-PUL","GOSFANDI",2206134,3,245,268,513
"SAR-E-PUL","GOSFANDI",2206132,2,117,8,125
"SAR-E-PUL","GOSFANDI",2206130,4,58,151,209
"SAR-E-PUL","GOSFANDI",2206135,2,183,40,223
"SAR-E-PUL","GOSFANDI",2206126,2,87,24,111
"SAR-E-PUL","GOSFANDI",2206125,3,60,516,576
"SAR-E-PUL","GOSFANDI",2206136,3,136,432,568
"SAR-E-PUL","GOSFANDI",2206126,1,101,41,142
"SAR-E-PUL","GOSFANDI",2206143,2,84,22,106
"SAR-E-PUL","GOSFANDI",2206143,3,42,34,76
"SAR-E-PUL","GOSFANDI",2206132,1,226,72,298
"SAR-E-PUL","GOSFANDI",2206131,3,349,159,508
"SAR-E-PUL","GOSFANDI",2206123,4,37,554,591
"SAR-E-PUL","GOSFANDI",2206127,1,275,161,436
"SAR-E-PUL","GOSFANDI",2206136,2,68,201,269
"SAR-E-PUL","GOSFANDI",2206123,6,18,470,488
"SAR-E-PUL","GOSFANDI",2206127,4,313,185,498
"SAR-E-PUL","GOSFANDI",2206125,1,67,505,572
"SAR-E-PUL","GOSFANDI",2206143,1,76,38,114
"SAR-E-PUL","GOSFANDI",2206131,2,179,70,249
"SAR-E-PUL","GOSFANDI",2206131,1,240,94,334
"SAR-E-PUL","GOSFANDI",2206129,1,94,16,110
"SAR-E-PUL","GOSFANDI",2206129,2,171,65,236
"SAR-E-PUL","GOSFANDI",2206127,2,123,106,229
"SAR-E-PUL","GOSFANDI",2206127,3,207,155,362
"SAR-E-PUL","GOSFANDI",2206136,1,64,230,294
"SAR-E-PUL","GOSFANDI",2206133,2,39,109,148
"SAR-E-PUL","GOSFANDI",2206133,3,218,244,462
"SAR-E-PUL","GOSFANDI",2206123,5,50,343,393
"SAR-E-PUL","GOSFANDI",2206133,1,159,63,222
"SAR-E-PUL","GOSFANDI",2206129,3,318,44,362
"SAR-E-PUL","BALKHAB",2207098,1,147,51,198
"SAR-E-PUL","BALKHAB",2207098,2,114,18,132
"SAR-E-PUL","BALKHAB",2207096,3,261,162,423
"SAR-E-PUL","BALKHAB",2207090,5,107,206,313
"SAR-E-PUL","BALKHAB",2207096,1,484,112,596
"SAR-E-PUL","BALKHAB",2207100,4,115,141,256
"SAR-E-PUL","BALKHAB",2207097,4,381,155,536
"SAR-E-PUL","BALKHAB",2207100,1,215,95,310
"SAR-E-PUL","BALKHAB",2207097,3,208,31,239
"SAR-E-PUL","BALKHAB",2207096,4,500,98,598
"SAR-E-PUL","BALKHAB",2207097,1,364,171,535
"SAR-E-PUL","BALKHAB",2207097,2,318,84,402
"SAR-E-PUL","BALKHAB",2207098,3,44,7,51
"SAR-E-PUL","BALKHAB",2207087,1,227,21,248
"SAR-E-PUL","BALKHAB",2207091,1,366,233,599
"SAR-E-PUL","BALKHAB",2207087,2,183,101,284
"SAR-E-PUL","BALKHAB",2207088,1,273,165,438
"SAR-E-PUL","BALKHAB",2207100,2,85,38,123
"SAR-E-PUL","BALKHAB",2207100,3,142,43,185
"SAR-E-PUL","BALKHAB",2207090,2,112,150,262
"SAR-E-PUL","BALKHAB",2207090,3,113,269,382
"SAR-E-PUL","BALKHAB",2207090,4,103,156,259
"SAR-E-PUL","BALKHAB",2207093,3,303,45,348
"SAR-E-PUL","BALKHAB",2207093,4,274,64,338
"SAR-E-PUL","BALKHAB",2207096,2,404,126,530
"SAR-E-PUL","BALKHAB",2207093,6,550,45,595
"SAR-E-PUL","BALKHAB",2207098,4,185,61,246
"SAR-E-PUL","BALKHAB",2207099,1,327,82,409
"SAR-E-PUL","BALKHAB",2207089,5,156,424,580
"SAR-E-PUL","BALKHAB",2207099,3,539,60,599
"SAR-E-PUL","BALKHAB",2207088,2,243,106,349
"SAR-E-PUL","BALKHAB",2207088,3,257,85,342
"SAR-E-PUL","BALKHAB",2207089,4,133,432,565
"SAR-E-PUL","BALKHAB",2207093,1,271,88,359
"SAR-E-PUL","BALKHAB",2207093,2,165,48,213
"SAR-E-PUL","BALKHAB",2207094,1,456,139,595
"SAR-E-PUL","BALKHAB",2207091,3,136,79,215
"SAR-E-PUL","BALKHAB",2207093,5,482,54,536
"SAR-E-PUL","BALKHAB",2207089,1,211,341,552
"SAR-E-PUL","BALKHAB",2207092,5,300,93,393
"SAR-E-PUL","BALKHAB",2207090,1,147,173,320
"SAR-E-PUL","BALKHAB",2207099,2,283,79,362
"SAR-E-PUL","BALKHAB",2207095,3,498,88,586
"SAR-E-PUL","BALKHAB",2207092,2,169,70,239
"SAR-E-PUL","BALKHAB",2207087,3,235,3,238
"SAR-E-PUL","BALKHAB",2207095,4,476,121,597
"SAR-E-PUL","BALKHAB",2207092,1,264,126,390
"SAR-E-PUL","BALKHAB",2207095,1,367,224,591
"SAR-E-PUL","BALKHAB",2207089,2,188,357,545
"SAR-E-PUL","BALKHAB",2207087,4,145,40,185
"SAR-E-PUL","BALKHAB",2207095,2,432,167,599
"SAR-E-PUL","BALKHAB",2207094,2,487,102,589
"SAR-E-PUL","BALKHAB",2207091,4,194,136,330
"SAR-E-PUL","BALKHAB",2207089,3,278,215,493
"SAR-E-PUL","BALKHAB",2207092,4,314,103,417
"SAR-E-PUL","BALKHAB",2207094,5,515,77,592
"SAR-E-PUL","BALKHAB",2207092,3,142,40,182
"SAR-E-PUL","BALKHAB",2207091,2,193,166,359
"SAR-E-PUL","BALKHAB",2207094,4,479,120,599
"SAR-E-PUL","BALKHAB",2207094,3,486,111,597
"GHOR","CHIGHCHERAN",2301003,3,492,108,600
"GHOR","CHIGHCHERAN",2301003,2,531,66,597
"GHOR","CHIGHCHERAN",2301003,5,472,127,599
"GHOR","CHIGHCHERAN",2301003,1,512,85,597
"GHOR","CHIGHCHERAN",2301003,6,494,100,594
"GHOR","CHIGHCHERAN",2301013,4,320,268,588
"GHOR","CHIGHCHERAN",2301003,4,524,70,594
"GHOR","CHIGHCHERAN",2301008,1,486,102,588
"GHOR","CHIGHCHERAN",2301005,5,359,224,583
"GHOR","CHIGHCHERAN",2301005,6,585,10,595
"GHOR","CHIGHCHERAN",2301019,1,397,202,599
"GHOR","CHIGHCHERAN",2301019,2,558,40,598
"GHOR","CHIGHCHERAN",2301019,3,550,37,587
"GHOR","CHIGHCHERAN",2301008,2,347,245,592
"GHOR","CHIGHCHERAN",2301007,1,550,50,600
"GHOR","CHIGHCHERAN",2301007,2,528,72,600
"GHOR","CHIGHCHERAN",2301008,5,389,181,570
"GHOR","CHIGHCHERAN",2301005,1,306,250,556
"GHOR","CHIGHCHERAN",2301005,2,518,81,599
"GHOR","CHIGHCHERAN",2301005,3,455,143,598
"GHOR","CHIGHCHERAN",2301005,4,423,177,600
"GHOR","CHIGHCHERAN",2301024,3,205,389,594
"GHOR","CHIGHCHERAN",2301024,4,33,566,599
"GHOR","CHIGHCHERAN",2301025,1,569,22,591
"GHOR","CHIGHCHERAN",2301025,2,574,24,598
"GHOR","CHIGHCHERAN",2301025,3,580,19,599
"GHOR","CHIGHCHERAN",2301025,4,566,31,597
"GHOR","CHIGHCHERAN",2301235,1,570,28,598
"GHOR","CHIGHCHERAN",2301235,2,586,13,599
"GHOR","CHIGHCHERAN",2301235,3,582,15,597
"GHOR","CHIGHCHERAN",2301007,3,559,41,600
"GHOR","CHIGHCHERAN",2301007,4,327,269,596
"GHOR","CHIGHCHERAN",2301007,5,481,114,595
"GHOR","CHIGHCHERAN",2301007,6,476,122,598
"GHOR","CHIGHCHERAN",2301013,1,239,107,346
"GHOR","CHIGHCHERAN",2301013,2,421,173,594
"GHOR","CHIGHCHERAN",2301013,3,397,196,593
"GHOR","CHIGHCHERAN",2301239,2,535,65,600
"GHOR","CHIGHCHERAN",2301013,5,320,169,489
"GHOR","CHIGHCHERAN",2301022,2,595,5,600
"GHOR","CHIGHCHERAN",2301022,3,583,17,600
"GHOR","CHIGHCHERAN",2301022,4,583,17,600
"GHOR","CHIGHCHERAN",2301041,1,581,18,599
"GHOR","CHIGHCHERAN",2301041,2,543,52,595
"GHOR","CHIGHCHERAN",2301008,3,507,86,593
"GHOR","CHIGHCHERAN",2301008,4,314,180,494
"GHOR","CHIGHCHERAN",2301021,2,552,47,599
"GHOR","CHIGHCHERAN",2301021,3,580,18,598
"GHOR","CHIGHCHERAN",2301021,4,576,22,598
"GHOR","CHIGHCHERAN",2301021,5,578,16,594
"GHOR","CHIGHCHERAN",2301042,1,348,252,600
"GHOR","CHIGHCHERAN",2301042,2,448,151,599
"GHOR","CHIGHCHERAN",2301042,3,293,284,577
"GHOR","CHIGHCHERAN",2301026,1,489,103,592
"GHOR","CHIGHCHERAN",2301019,4,427,171,598
"GHOR","CHIGHCHERAN",2301019,5,567,31,598
"GHOR","CHIGHCHERAN",2301019,6,420,180,600
"GHOR","CHIGHCHERAN",2301032,1,345,251,596
"GHOR","CHIGHCHERAN",2301032,2,241,322,563
"GHOR","CHIGHCHERAN",2301032,3,400,182,582
"GHOR","CHIGHCHERAN",2301032,4,206,354,560
"GHOR","CHIGHCHERAN",2301015,1,569,29,598
"GHOR","CHIGHCHERAN",2301015,2,551,47,598
"GHOR","CHIGHCHERAN",2301015,3,474,124,598
"GHOR","CHIGHCHERAN",2301015,4,576,22,598
"GHOR","CHIGHCHERAN",2301015,5,510,84,594
"GHOR","CHIGHCHERAN",2301034,1,539,60,599
"GHOR","CHIGHCHERAN",2301034,2,564,35,599
"GHOR","CHIGHCHERAN",2301034,3,557,40,597
"GHOR","CHIGHCHERAN",2301006,1,197,398,595
"GHOR","CHIGHCHERAN",2301235,4,577,21,598
"GHOR","CHIGHCHERAN",2301236,1,153,66,219
"GHOR","CHIGHCHERAN",2301236,2,221,78,299
"GHOR","CHIGHCHERAN",2301236,3,140,43,183
"GHOR","CHIGHCHERAN",2301236,4,103,49,152
"GHOR","CHIGHCHERAN",2301236,5,114,39,153
"GHOR","CHIGHCHERAN",2301239,1,513,87,600
"GHOR","CHIGHCHERAN",2301028,3,513,74,587
"GHOR","CHIGHCHERAN",2301239,3,466,132,598
"GHOR","CHIGHCHERAN",2301028,4,558,27,585
"GHOR","CHIGHCHERAN",2301012,1,538,51,589
"GHOR","CHIGHCHERAN",2301012,2,503,92,595
"GHOR","CHIGHCHERAN",2301012,3,512,87,599
"GHOR","CHIGHCHERAN",2301012,4,443,155,598
"GHOR","CHIGHCHERAN",2301041,3,560,39,599
"GHOR","CHIGHCHERAN",2301021,1,588,10,598
"GHOR","CHIGHCHERAN",2301001,1,436,159,595
"GHOR","CHIGHCHERAN",2301001,2,284,82,366
"GHOR","CHIGHCHERAN",2301001,3,341,92,433
"GHOR","CHIGHCHERAN",2301001,4,353,87,440
"GHOR","CHIGHCHERAN",2301001,5,320,84,404
"GHOR","CHIGHCHERAN",2301001,6,327,83,410
"GHOR","CHIGHCHERAN",2301001,7,84,33,117
"GHOR","CHIGHCHERAN",2301001,8,140,47,187
"GHOR","CHIGHCHERAN",2301026,2,530,66,596
"GHOR","CHIGHCHERAN",2301026,3,429,169,598
"GHOR","CHIGHCHERAN",2301026,4,506,87,593
"GHOR","CHIGHCHERAN",2301023,1,578,12,590
"GHOR","CHIGHCHERAN",2301023,2,491,106,597
"GHOR","CHIGHCHERAN",2301023,3,593,5,598
"GHOR","CHIGHCHERAN",2301023,4,540,53,593
"GHOR","CHIGHCHERAN",2301024,1,273,314,587
"GHOR","CHIGHCHERAN",2301024,2,202,380,582
"GHOR","CHIGHCHERAN",2301002,8,319,69,388
"GHOR","CHIGHCHERAN",2301002,9,306,76,382
"GHOR","CHIGHCHERAN",2301009,1,461,131,592
"GHOR","CHIGHCHERAN",2301009,2,491,108,599
"GHOR","CHIGHCHERAN",2301009,3,450,148,598
"GHOR","CHIGHCHERAN",2301009,4,426,169,595
"GHOR","CHIGHCHERAN",2301009,5,403,184,587
"GHOR","CHIGHCHERAN",2301009,6,417,183,600
"GHOR","CHIGHCHERAN",2301027,1,533,67,600
"GHOR","CHIGHCHERAN",2301006,2,252,345,597
"GHOR","CHIGHCHERAN",2301006,3,348,252,600
"GHOR","CHIGHCHERAN",2301006,4,296,302,598
"GHOR","CHIGHCHERAN",2301006,5,257,340,597
"GHOR","CHIGHCHERAN",2301010,1,464,127,591
"GHOR","CHIGHCHERAN",2301010,2,423,167,590
"GHOR","CHIGHCHERAN",2301010,3,476,116,592
"GHOR","CHIGHCHERAN",2301022,1,578,22,600
"GHOR","CHIGHCHERAN",2301010,4,448,136,584
"GHOR","CHIGHCHERAN",2301010,5,543,53,596
"GHOR","CHIGHCHERAN",2301030,1,582,15,597
"GHOR","CHIGHCHERAN",2301030,2,569,31,600
"GHOR","CHIGHCHERAN",2301012,5,380,218,598
"GHOR","CHIGHCHERAN",2301012,6,518,82,600
"GHOR","CHIGHCHERAN",2301016,1,538,54,592
"GHOR","CHIGHCHERAN",2301016,2,516,83,599
"GHOR","CHIGHCHERAN",2301016,3,554,43,597
"GHOR","CHIGHCHERAN",2301016,4,490,110,600
"GHOR","CHIGHCHERAN",2301016,5,543,55,598
"GHOR","CHIGHCHERAN",2301016,6,548,32,580
"GHOR","CHIGHCHERAN",2301017,1,477,123,600
"GHOR","CHIGHCHERAN",2301017,2,518,18,536
"GHOR","CHIGHCHERAN",2301001,9,87,18,105
"GHOR","CHIGHCHERAN",2301001,10,88,27,115
"GHOR","CHIGHCHERAN",2301002,1,440,147,587
"GHOR","CHIGHCHERAN",2301002,2,279,85,364
"GHOR","CHIGHCHERAN",2301002,3,228,40,268
"GHOR","CHIGHCHERAN",2301002,4,220,50,270
"GHOR","CHIGHCHERAN",2301002,5,353,88,441
"GHOR","CHIGHCHERAN",2301002,6,372,95,467
"GHOR","CHIGHCHERAN",2301002,7,278,104,382
"GHOR","CHIGHCHERAN",2301014,1,528,67,595
"GHOR","CHIGHCHERAN",2301014,2,523,75,598
"GHOR","CHIGHCHERAN",2301004,1,262,265,527
"GHOR","CHIGHCHERAN",2301004,2,262,309,571
"GHOR","CHIGHCHERAN",2301004,3,246,96,342
"GHOR","CHIGHCHERAN",2301004,4,206,182,388
"GHOR","CHIGHCHERAN",2301004,5,219,174,393
"GHOR","CHIGHCHERAN",2301020,2,400,198,598
"GHOR","CHIGHCHERAN",2301020,3,492,105,597
"GHOR","CHIGHCHERAN",2301020,4,433,134,567
"GHOR","CHIGHCHERAN",2301020,5,304,294,598
"GHOR","CHIGHCHERAN",2301035,1,449,145,594
"GHOR","CHIGHCHERAN",2301035,2,493,105,598
"GHOR","CHIGHCHERAN",2301035,3,328,272,600
"GHOR","CHIGHCHERAN",2301035,4,374,224,598
"GHOR","CHIGHCHERAN",2301035,5,372,224,596
"GHOR","CHIGHCHERAN",2301028,2,460,131,591
"GHOR","CHIGHCHERAN",2301014,4,537,58,595
"GHOR","CHIGHCHERAN",2301017,3,392,207,599
"GHOR","CHIGHCHERAN",2301017,4,590,8,598
"GHOR","CHIGHCHERAN",2301017,5,391,39,430
"GHOR","CHIGHCHERAN",2301030,3,548,50,598
"GHOR","CHIGHCHERAN",2301030,4,567,21,588
"GHOR","CHIGHCHERAN",2301031,4,350,250,600
"GHOR","CHIGHCHERAN",2301033,1,434,164,598
"GHOR","CHIGHCHERAN",2301033,2,485,109,594
"GHOR","CHIGHCHERAN",2301033,3,474,125,599
"GHOR","CHIGHCHERAN",2301027,5,108,26,134
"GHOR","CHIGHCHERAN",2301027,6,73,9,82
"GHOR","CHIGHCHERAN",2301014,3,541,55,596
"GHOR","CHIGHCHERAN",2301031,2,175,369,544
"GHOR","CHIGHCHERAN",2301014,5,445,154,599
"GHOR","CHIGHCHERAN",2301014,6,522,73,595
"GHOR","CHIGHCHERAN",2301014,7,491,104,595
"GHOR","CHIGHCHERAN",2301027,3,464,129,593
"GHOR","CHIGHCHERAN",2301031,3,358,213,571
"GHOR","CHIGHCHERAN",2301027,2,534,61,595
"GHOR","CHIGHCHERAN",2301028,1,452,141,593
"GHOR","CHIGHCHERAN",2301027,4,556,40,596
"GHOR","CHIGHCHERAN",2301020,1,398,198,596
"GHOR","DULEENA",2302099,2,143,457,600
"GHOR","DULEENA",2302238,1,13,569,582
"GHOR","DULEENA",2302238,2,2,535,537
"GHOR","DULEENA",2302108,2,579,19,598
"GHOR","DULEENA",2302108,3,594,4,598
"GHOR","DULEENA",2302110,1,509,91,600
"GHOR","DULEENA",2302110,2,300,300,600
"GHOR","DULEENA",2302101,2,349,251,600
"GHOR","DULEENA",2302106,3,540,55,595
"GHOR","DULEENA",2302105,1,597,3,600
"GHOR","DULEENA",2302098,1,550,49,599
"GHOR","DULEENA",2302098,2,338,251,589
"GHOR","DULEENA",2302098,3,516,82,598
"GHOR","DULEENA",2302103,2,200,400,600
"GHOR","DULEENA",2302103,3,383,216,599
"GHOR","DULEENA",2302101,1,255,345,600
"GHOR","DULEENA",2302108,1,565,30,595
"GHOR","DULEENA",2302101,3,213,383,596
"GHOR","DULEENA",2302100,1,200,398,598
"GHOR","DULEENA",2302100,2,246,352,598
"GHOR","DULEENA",2302106,1,414,180,594
"GHOR","DULEENA",2302104,4,595,2,597
"GHOR","DULEENA",2302110,3,490,110,600
"GHOR","DULEENA",2302099,1,60,540,600
"GHOR","DULEENA",2302104,3,583,14,597
"GHOR","DULEENA",2302102,3,180,56,236
"GHOR","DULEENA",2302103,1,350,244,594
"GHOR","DULEENA",2302102,1,108,414,522
"GHOR","DULEENA",2302102,2,294,120,414
"GHOR","DULEENA",2302106,2,527,73,600
"GHOR","DULEENA",2302104,1,571,29,600
"GHOR","DULEENA",2302104,2,571,28,599
"GHOR","DULEENA",2302105,2,589,7,596
"GHOR","DULEENA",2302105,3,600,0,600
"GHOR","DAWLATYAR",2303056,2,573,27,600
"GHOR","DAWLATYAR",2303050,1,540,50,590
"GHOR","DAWLATYAR",2303047,4,485,115,600
"GHOR","DAWLATYAR",2303046,2,72,526,598
"GHOR","DAWLATYAR",2303051,1,118,480,598
"GHOR","DAWLATYAR",2303047,3,540,58,598
"GHOR","DAWLATYAR",2303058,1,598,1,599
"GHOR","DAWLATYAR",2303058,2,600,0,600
"GHOR","DAWLATYAR",2303058,3,598,2,600
"GHOR","DAWLATYAR",2303054,2,75,513,588
"GHOR","DAWLATYAR",2303051,2,47,552,599
"GHOR","DAWLATYAR",2303051,3,27,546,573
"GHOR","DAWLATYAR",2303051,4,49,540,589
"GHOR","DAWLATYAR",2303050,2,550,47,597
"GHOR","DAWLATYAR",2303237,2,122,478,600
"GHOR","DAWLATYAR",2303237,1,108,492,600
"GHOR","DAWLATYAR",2303046,1,122,463,585
"GHOR","DAWLATYAR",2303046,3,132,461,593
"GHOR","DAWLATYAR",2303046,4,48,546,594
"GHOR","DAWLATYAR",2303053,1,112,487,599
"GHOR","DAWLATYAR",2303053,2,9,584,593
"GHOR","DAWLATYAR",2303054,1,122,474,596
"GHOR","DAWLATYAR",2303056,1,571,26,597
"GHOR","DAWLATYAR",2303049,1,390,191,581
"GHOR","DAWLATYAR",2303048,1,90,504,594
"GHOR","DAWLATYAR",2303047,1,418,182,600
"GHOR","DAWLATYAR",2303047,2,531,68,599
"GHOR","DAWLATYAR",2303055,2,59,540,599
"GHOR","DAWLATYAR",2303050,3,553,0,553
"GHOR","DAWLATYAR",2303049,3,369,151,520
"GHOR","DAWLATYAR",2303055,1,55,545,600
"GHOR","DAWLATYAR",2303057,1,505,95,600
"GHOR","DAWLATYAR",2303055,3,53,545,598
"GHOR","DAWLATYAR",2303049,2,399,183,582
"GHOR","DAWLATYAR",2303048,2,9,585,594
"GHOR","DAWLATYAR",2303057,2,495,105,600
"GHOR","DAWLATYAR",2303057,3,460,140,600
"GHOR","CHAR SADA",2304060,4,0,600,600
"GHOR","CHAR SADA",2304059,4,216,384,600
"GHOR","CHAR SADA",2304070,2,238,357,595
"GHOR","CHAR SADA",2304060,2,0,600,600
"GHOR","CHAR SADA",2304060,3,0,600,600
"GHOR","CHAR SADA",2304062,2,500,100,600
"GHOR","CHAR SADA",2304062,3,450,150,600
"GHOR","CHAR SADA",2304061,1,22,578,600
"GHOR","CHAR SADA",2304061,2,153,447,600
"GHOR","CHAR SADA",2304070,1,598,1,599
"GHOR","CHAR SADA",2304069,3,468,130,598
"GHOR","CHAR SADA",2304070,3,582,13,595
"GHOR","CHAR SADA",2304070,4,530,67,597
"GHOR","CHAR SADA",2304071,1,275,325,600
"GHOR","CHAR SADA",2304066,1,217,381,598
"GHOR","CHAR SADA",2304066,2,472,128,600
"GHOR","CHAR SADA",2304064,1,367,232,599
"GHOR","CHAR SADA",2304071,2,424,150,574
"GHOR","CHAR SADA",2304066,3,350,248,598
"GHOR","CHAR SADA",2304062,1,390,210,600
"GHOR","CHAR SADA",2304059,1,246,353,599
"GHOR","CHAR SADA",2304064,2,405,195,600
"GHOR","CHAR SADA",2304064,3,318,282,600
"GHOR","CHAR SADA",2304064,4,413,186,599
"GHOR","CHAR SADA",2304067,1,600,0,600
"GHOR","CHAR SADA",2304059,2,205,395,600
"GHOR","CHAR SADA",2304059,3,126,473,599
"GHOR","CHAR SADA",2304071,3,498,62,560
"GHOR","CHAR SADA",2304069,2,443,81,524
"GHOR","CHAR SADA",2304067,2,541,9,550
"GHOR","CHAR SADA",2304067,3,600,0,600
"GHOR","CHAR SADA",2304069,1,420,134,554
"GHOR","PASABAND",2305116,4,55,52,107
"GHOR","PASABAND",2305111,1,554,46,600
"GHOR","PASABAND",2305116,3,92,82,174
"GHOR","PASABAND",2305126,1,550,0,550
"GHOR","PASABAND",2305126,2,448,152,600
"GHOR","PASABAND",2305116,1,106,128,234
"GHOR","PASABAND",2305116,2,65,37,102
"GHOR","PASABAND",2305114,4,3,0,3
"GHOR","PASABAND",2305131,1,230,367,597
"GHOR","PASABAND",2305131,2,526,65,591
"GHOR","PASABAND",2305111,2,535,65,600
"GHOR","PASABAND",2305129,3,123,477,600
"GHOR","PASABAND",2305115,1,549,50,599
"GHOR","PASABAND",2305115,2,459,140,599
"GHOR","PASABAND",2305115,3,500,97,597
"GHOR","PASABAND",2305117,1,163,433,596
"GHOR","PASABAND",2305117,2,184,416,600
"GHOR","PASABAND",2305117,3,203,394,597
"GHOR","PASABAND",2305129,1,229,371,600
"GHOR","PASABAND",2305131,3,267,129,396
"GHOR","PASABAND",2305111,3,591,9,600
"GHOR","PASABAND",2305118,1,545,50,595
"GHOR","PASABAND",2305113,3,215,379,594
"GHOR","PASABAND",2305129,2,177,420,597
"GHOR","PASABAND",2305133,1,441,158,599
"GHOR","PASABAND",2305133,2,65,191,256
"GHOR","PASABAND",2305119,1,551,47,598
"GHOR","PASABAND",2305114,1,43,557,600
"GHOR","PASABAND",2305114,2,53,546,599
"GHOR","PASABAND",2305114,3,22,578,600
"GHOR","PASABAND",2305113,2,26,363,389
"GHOR","PASABAND",2305119,2,480,118,598
"GHOR","PASABAND",2305118,2,432,154,586
"GHOR","PASABAND",2305113,1,39,558,597
"GHOR","SHAHRAK",2306079,2,11,339,350
"GHOR","SHAHRAK",2306072,4,522,74,596
"GHOR","SHAHRAK",2306079,1,3,597,600
"GHOR","SHAHRAK",2306086,2,387,213,600
"GHOR","SHAHRAK",2306088,1,9,591,600
"GHOR","SHAHRAK",2306083,1,15,575,590
"GHOR","SHAHRAK",2306089,2,15,585,600
"GHOR","SHAHRAK",2306072,1,424,172,596
"GHOR","SHAHRAK",2306072,2,565,29,594
"GHOR","SHAHRAK",2306072,3,543,51,594
"GHOR","SHAHRAK",2306080,1,600,0,600
"GHOR","SHAHRAK",2306080,2,600,0,600
"GHOR","SHAHRAK",2306080,3,500,100,600
"GHOR","SHAHRAK",2306078,1,120,480,600
"GHOR","SHAHRAK",2306078,2,40,250,290
"GHOR","SHAHRAK",2306078,3,9,591,600
"GHOR","SHAHRAK",2306073,1,504,93,597
"GHOR","SHAHRAK",2306073,2,407,191,598
"GHOR","SHAHRAK",2306073,3,460,137,597
"GHOR","SHAHRAK",2306075,2,287,310,597
"GHOR","SHAHRAK",2306083,2,67,530,597
"GHOR","SHAHRAK",2306087,1,0,600,600
"GHOR","SHAHRAK",2306087,2,6,594,600
"GHOR","SHAHRAK",2306090,1,407,192,599
"GHOR","SHAHRAK",2306090,2,379,220,599
"GHOR","SHAHRAK",2306093,1,567,30,597
"GHOR","SHAHRAK",2306093,2,546,50,596
"GHOR","SHAHRAK",2306085,2,27,557,584
"GHOR","SHAHRAK",2306088,2,1,599,600
"GHOR","SHAHRAK",2306086,1,388,209,597
"GHOR","SHAHRAK",2306084,2,231,361,592
"GHOR","SHAHRAK",2306084,3,139,460,599
"GHOR","SHAHRAK",2306086,3,522,78,600
"GHOR","SHAHRAK",2306089,1,3,589,592
"GHOR","SHAHRAK",2306094,2,555,0,555
"GHOR","SHAHRAK",2306074,1,0,597,597
"GHOR","SHAHRAK",2306074,3,0,600,600
"GHOR","SHAHRAK",2306095,2,580,14,594
"GHOR","SHAHRAK",2306077,1,392,184,576
"GHOR","SHAHRAK",2306077,2,478,84,562
"GHOR","SHAHRAK",2306085,1,36,564,600
"GHOR","SHAHRAK",2306097,1,101,499,600
"GHOR","SHAHRAK",2306097,2,103,496,599
"GHOR","SHAHRAK",2306076,1,0,600,600
"GHOR","SHAHRAK",2306091,1,0,400,400
"GHOR","SHAHRAK",2306091,2,0,221,221
"GHOR","SHAHRAK",2306094,1,563,31,594
"GHOR","SHAHRAK",2306075,3,263,330,593
"GHOR","SHAHRAK",2306095,1,556,36,592
"GHOR","SHAHRAK",2306075,1,327,272,599
"GHOR","SHAHRAK",2306084,1,213,372,585
"GHOR","SHAHRAK",2306076,3,0,600,600
"GHOR","LAL WA SARJAN",2307157,2,222,82,304
"GHOR","LAL WA SARJAN",2307155,5,329,115,444
"GHOR","LAL WA SARJAN",2307157,1,151,111,262
"GHOR","LAL WA SARJAN",2307162,2,349,15,364
"GHOR","LAL WA SARJAN",2307158,1,432,168,600
"GHOR","LAL WA SARJAN",2307161,1,484,113,597
"GHOR","LAL WA SARJAN",2307163,2,404,25,429
"GHOR","LAL WA SARJAN",2307161,2,412,185,597
"GHOR","LAL WA SARJAN",2307161,3,454,50,504
"GHOR","LAL WA SARJAN",2307152,1,207,40,247
"GHOR","LAL WA SARJAN",2307158,2,454,141,595
"GHOR","LAL WA SARJAN",2307162,1,507,91,598
"GHOR","LAL WA SARJAN",2307153,2,133,172,305
"GHOR","LAL WA SARJAN",2307167,1,248,60,308
"GHOR","LAL WA SARJAN",2307167,2,210,32,242
"GHOR","LAL WA SARJAN",2307166,1,345,255,600
"GHOR","LAL WA SARJAN",2307155,1,404,187,591
"GHOR","LAL WA SARJAN",2307155,2,386,209,595
"GHOR","LAL WA SARJAN",2307163,1,421,47,468
"GHOR","LAL WA SARJAN",2307138,1,348,84,432
"GHOR","LAL WA SARJAN",2307155,3,116,41,157
"GHOR","LAL WA SARJAN",2307155,4,135,51,186
"GHOR","LAL WA SARJAN",2307138,4,199,71,270
"GHOR","LAL WA SARJAN",2307146,1,263,45,308
"GHOR","LAL WA SARJAN",2307146,2,264,33,297
"GHOR","LAL WA SARJAN",2307146,3,376,87,463
"GHOR","LAL WA SARJAN",2307150,1,419,179,598
"GHOR","LAL WA SARJAN",2307150,2,396,189,585
"GHOR","LAL WA SARJAN",2307150,3,478,110,588
"GHOR","LAL WA SARJAN",2307137,1,355,36,391
"GHOR","LAL WA SARJAN",2307137,2,199,51,250
"GHOR","LAL WA SARJAN",2307166,2,400,200,600
"GHOR","LAL WA SARJAN",2307164,1,452,140,592
"GHOR","LAL WA SARJAN",2307164,2,395,201,596
"GHOR","LAL WA SARJAN",2307168,1,314,97,411
"GHOR","LAL WA SARJAN",2307168,2,272,123,395
"GHOR","LAL WA SARJAN",2307165,1,108,25,133
"GHOR","LAL WA SARJAN",2307165,2,169,26,195
"GHOR","LAL WA SARJAN",2307165,3,354,71,425
"GHOR","LAL WA SARJAN",2307144,1,282,37,319
"GHOR","LAL WA SARJAN",2307153,3,195,76,271
"GHOR","LAL WA SARJAN",2307153,4,487,98,585
"GHOR","LAL WA SARJAN",2307160,1,319,90,409
"GHOR","LAL WA SARJAN",2307160,2,217,110,327
"GHOR","LAL WA SARJAN",2307160,3,494,97,591
"GHOR","LAL WA SARJAN",2307171,3,541,53,594
"GHOR","LAL WA SARJAN",2307173,1,493,74,567
"GHOR","LAL WA SARJAN",2307173,2,419,53,472
"GHOR","LAL WA SARJAN",2307172,1,529,70,599
"GHOR","LAL WA SARJAN",2307172,2,481,99,580
"GHOR","LAL WA SARJAN",2307152,2,115,25,140
"GHOR","LAL WA SARJAN",2307152,3,372,49,421
"GHOR","LAL WA SARJAN",2307147,1,493,103,596
"GHOR","LAL WA SARJAN",2307147,2,552,43,595
"GHOR","LAL WA SARJAN",2307154,1,290,66,356
"GHOR","LAL WA SARJAN",2307154,2,355,100,455
"GHOR","LAL WA SARJAN",2307145,1,438,160,598
"GHOR","LAL WA SARJAN",2307145,2,464,133,597
"GHOR","LAL WA SARJAN",2307145,3,415,178,593
"GHOR","LAL WA SARJAN",2307145,4,430,155,585
"GHOR","LAL WA SARJAN",2307138,2,186,53,239
"GHOR","LAL WA SARJAN",2307138,3,477,94,571
"GHOR","LAL WA SARJAN",2307149,2,321,261,582
"GHOR","LAL WA SARJAN",2307149,3,363,236,599
"GHOR","LAL WA SARJAN",2307140,1,120,71,191
"GHOR","LAL WA SARJAN",2307140,2,75,41,116
"GHOR","LAL WA SARJAN",2307140,3,71,62,133
"GHOR","LAL WA SARJAN",2307143,1,209,51,260
"GHOR","LAL WA SARJAN",2307143,2,131,27,158
"GHOR","LAL WA SARJAN",2307143,3,286,78,364
"GHOR","LAL WA SARJAN",2307169,1,292,48,340
"GHOR","LAL WA SARJAN",2307137,3,258,45,303
"GHOR","LAL WA SARJAN",2307137,4,513,84,597
"GHOR","LAL WA SARJAN",2307148,1,497,98,595
"GHOR","LAL WA SARJAN",2307148,2,506,90,596
"GHOR","LAL WA SARJAN",2307148,3,540,46,586
"GHOR","LAL WA SARJAN",2307151,1,225,55,280
"GHOR","LAL WA SARJAN",2307151,2,169,23,192
"GHOR","LAL WA SARJAN",2307151,3,121,40,161
"GHOR","LAL WA SARJAN",2307153,1,203,34,237
"GHOR","LAL WA SARJAN",2307175,1,395,204,599
"GHOR","LAL WA SARJAN",2307144,2,289,28,317
"GHOR","LAL WA SARJAN",2307139,1,365,234,599
"GHOR","LAL WA SARJAN",2307139,2,362,215,577
"GHOR","LAL WA SARJAN",2307142,1,424,168,592
"GHOR","LAL WA SARJAN",2307142,2,382,210,592
"GHOR","LAL WA SARJAN",2307142,3,515,75,590
"GHOR","LAL WA SARJAN",2307145,5,479,108,587
"GHOR","LAL WA SARJAN",2307149,1,272,302,574
"GHOR","LAL WA SARJAN",2307170,3,251,49,300
"GHOR","LAL WA SARJAN",2307159,1,407,190,597
"GHOR","LAL WA SARJAN",2307159,2,391,202,593
"GHOR","LAL WA SARJAN",2307156,1,412,186,598
"GHOR","LAL WA SARJAN",2307156,2,399,198,597
"GHOR","LAL WA SARJAN",2307141,1,132,24,156
"GHOR","LAL WA SARJAN",2307141,2,131,31,162
"GHOR","LAL WA SARJAN",2307141,3,306,48,354
"GHOR","LAL WA SARJAN",2307177,2,454,139,593
"GHOR","LAL WA SARJAN",2307169,2,203,30,233
"GHOR","LAL WA SARJAN",2307169,3,409,79,488
"GHOR","LAL WA SARJAN",2307170,1,276,48,324
"GHOR","LAL WA SARJAN",2307170,2,314,73,387
"GHOR","LAL WA SARJAN",2307174,2,336,55,391
"GHOR","LAL WA SARJAN",2307176,1,167,45,212
"GHOR","LAL WA SARJAN",2307176,2,147,52,199
"GHOR","LAL WA SARJAN",2307174,1,365,94,459
"GHOR","LAL WA SARJAN",2307171,1,457,139,596
"GHOR","LAL WA SARJAN",2307175,2,467,131,598
"GHOR","LAL WA SARJAN",2307177,1,408,182,590
"GHOR","LAL WA SARJAN",2307171,2,508,91,599
"GHOR","TAYWARA",2308225,3,529,25,554
"GHOR","TAYWARA",2308223,1,561,35,596
"GHOR","TAYWARA",2308228,3,533,60,593
"GHOR","TAYWARA",2308215,2,456,31,487
"GHOR","TAYWARA",2308223,2,537,54,591
"GHOR","TAYWARA",2308223,3,528,62,590
"GHOR","TAYWARA",2308215,1,369,32,401
"GHOR","TAYWARA",2308212,3,586,14,600
"GHOR","TAYWARA",2308225,2,535,41,576
"GHOR","TAYWARA",2308228,1,550,48,598
"GHOR","TAYWARA",2308228,2,524,50,574
"GHOR","TAYWARA",2308211,1,592,8,600
"GHOR","TAYWARA",2308211,2,579,18,597
"GHOR","TAYWARA",2308211,3,280,9,289
"GHOR","TAYWARA",2308216,1,400,0,400
"GHOR","TAYWARA",2308232,1,578,21,599
"GHOR","TAYWARA",2308232,2,582,13,595
"GHOR","TAYWARA",2308215,3,488,16,504
"GHOR","TAYWARA",2308224,1,575,10,585
"GHOR","TAYWARA",2308224,2,541,16,557
"GHOR","TAYWARA",2308225,1,500,8,508
"GHOR","TAYWARA",2308209,1,549,50,599
"GHOR","TAYWARA",2308209,2,579,20,599
"GHOR","TAYWARA",2308209,3,581,17,598
"GHOR","TAYWARA",2308209,4,389,71,460
"GHOR","TAYWARA",2308213,1,599,0,599
"GHOR","TAYWARA",2308213,2,596,0,596
"GHOR","TAYWARA",2308213,3,585,4,589
"GHOR","TAYWARA",2308227,3,583,10,593
"GHOR","TAYWARA",2308216,2,600,0,600
"GHOR","TAYWARA",2308218,1,569,27,596
"GHOR","TAYWARA",2308218,2,567,26,593
"GHOR","TAYWARA",2308215,4,383,30,413
"GHOR","TAYWARA",2308215,5,448,118,566
"GHOR","TAYWARA",2308224,3,588,6,594
"GHOR","TAYWARA",2308227,1,564,7,571
"GHOR","TAYWARA",2308227,2,585,15,600
"GHOR","TAYWARA",2308212,1,585,13,598
"GHOR","TAYWARA",2308229,1,540,54,594
"GHOR","TAYWARA",2308229,2,551,49,600
"GHOR","TAYWARA",2308229,3,560,38,598
"GHOR","TAYWARA",2308212,2,568,8,576
"GHOR","TULAK",2309184,1,593,7,600
"GHOR","TULAK",2309193,2,407,159,566
"GHOR","TULAK",2309193,3,428,139,567
"GHOR","TULAK",2309194,1,593,0,593
"GHOR","TULAK",2309193,1,398,196,594
"GHOR","TULAK",2309179,3,577,23,600
"GHOR","TULAK",2309179,4,568,32,600
"GHOR","TULAK",2309183,2,108,492,600
"GHOR","TULAK",2309183,3,207,392,599
"GHOR","TULAK",2309185,2,580,18,598
"GHOR","TULAK",2309180,1,578,15,593
"GHOR","TULAK",2309180,2,584,14,598
"GHOR","TULAK",2309180,3,587,11,598
"GHOR","TULAK",2309194,2,586,14,600
"GHOR","TULAK",2309194,3,598,2,600
"GHOR","TULAK",2309188,3,552,48,600
"GHOR","TULAK",2309190,1,588,8,596
"GHOR","TULAK",2309190,2,592,3,595
"GHOR","TULAK",2309190,3,543,3,546
"GHOR","TULAK",2309190,4,483,1,484
"GHOR","TULAK",2309191,1,518,67,585
"GHOR","TULAK",2309191,2,561,10,571
"GHOR","TULAK",2309192,1,554,42,596
"GHOR","TULAK",2309192,2,553,41,594
"GHOR","TULAK",2309187,1,591,8,599
"GHOR","TULAK",2309184,2,600,0,600
"GHOR","TULAK",2309184,3,573,19,592
"GHOR","TULAK",2309178,1,305,295,600
"GHOR","TULAK",2309178,2,245,352,597
"GHOR","TULAK",2309178,3,330,247,577
"GHOR","TULAK",2309178,4,253,339,592
"GHOR","TULAK",2309179,1,585,13,598
"GHOR","TULAK",2309179,2,564,35,599
"GHOR","TULAK",2309183,1,37,563,600
"GHOR","TULAK",2309189,3,507,92,599
"GHOR","TULAK",2309185,1,516,69,585
"GHOR","TULAK",2309188,1,565,35,600
"GHOR","TULAK",2309185,3,579,11,590
"GHOR","TULAK",2309195,1,550,50,600
"GHOR","TULAK",2309187,2,512,78,590
"GHOR","TULAK",2309195,3,300,300,600
"GHOR","TULAK",2309188,2,326,271,597
"GHOR","TULAK",2309189,2,574,26,600
"GHOR","TULAK",2309195,2,450,150,600
"GHOR","TULAK",2309186,3,568,29,597
"GHOR","TULAK",2309189,1,533,67,600
"GHOR","TULAK",2309186,1,548,45,593
"GHOR","TULAK",2309186,2,556,44,600
"GHOR","TULAK",2309187,3,252,344,596
"GHOR","TULAK",2309181,1,450,150,600
"GHOR","TULAK",2309181,2,577,21,598
"GHOR","TULAK",2309186,4,559,35,594
"GHOR","SAGHAR",2310201,3,167,50,217
"GHOR","SAGHAR",2310203,1,570,28,598
"GHOR","SAGHAR",2310207,1,591,5,596
"GHOR","SAGHAR",2310207,2,586,11,597
"GHOR","SAGHAR",2310204,1,556,42,598
"GHOR","SAGHAR",2310203,2,557,31,588
"GHOR","SAGHAR",2310202,1,583,16,599
"GHOR","SAGHAR",2310202,2,579,21,600
"GHOR","SAGHAR",2310202,3,600,0,600
"GHOR","SAGHAR",2310240,2,585,0,585
"GHOR","SAGHAR",2310197,4,305,74,379
"GHOR","SAGHAR",2310198,1,468,92,560
"GHOR","SAGHAR",2310198,2,331,170,501
"GHOR","SAGHAR",2310197,3,297,57,354
"GHOR","SAGHAR",2310196,1,152,13,165
"GHOR","SAGHAR",2310196,2,169,28,197
"GHOR","SAGHAR",2310204,4,564,36,600
"GHOR","SAGHAR",2310207,3,552,47,599
"GHOR","SAGHAR",2310240,1,576,0,576
"GHOR","SAGHAR",2310206,2,590,6,596
"GHOR","SAGHAR",2310240,3,584,0,584
"GHOR","SAGHAR",2310205,1,572,28,600
"GHOR","SAGHAR",2310205,2,518,82,600
"GHOR","SAGHAR",2310208,1,400,98,498
"GHOR","SAGHAR",2310208,2,232,28,260
"GHOR","SAGHAR",2310201,1,154,14,168
"GHOR","SAGHAR",2310201,2,248,22,270
"GHOR","SAGHAR",2310198,3,467,130,597
"GHOR","SAGHAR",2310204,2,548,50,598
"GHOR","SAGHAR",2310204,3,570,30,600
"GHOR","SAGHAR",2310196,3,176,11,187
"GHOR","SAGHAR",2310206,1,592,8,600
"GHOR","SAGHAR",2310199,1,525,70,595
"GHOR","SAGHAR",2310199,2,576,22,598
"GHOR","SAGHAR",2310199,3,474,121,595
"GHOR","SAGHAR",2310197,1,214,29,243
"GHOR","SAGHAR",2310197,2,224,39,263
"GHOR","SAGHAR",2310200,1,586,13,599
"GHOR","SAGHAR",2310200,2,574,0,574
"GHOR","SAGHAR",2310196,4,177,36,213
"DAYKUNDI","NILI",2401004,2,131,16,147
"DAYKUNDI","NILI",2401004,3,145,7,152
"DAYKUNDI","NILI",2401009,3,137,33,170
"DAYKUNDI","NILI",2401009,4,149,16,165
"DAYKUNDI","NILI",2401004,4,156,4,160
"DAYKUNDI","NILI",2401009,2,139,26,165
"DAYKUNDI","NILI",2401003,2,211,42,253
"DAYKUNDI","NILI",2401003,3,284,48,332
"DAYKUNDI","NILI",2401003,4,430,30,460
"DAYKUNDI","NILI",2401006,1,102,5,107
"DAYKUNDI","NILI",2401008,1,458,132,590
"DAYKUNDI","NILI",2401008,2,480,97,577
"DAYKUNDI","NILI",2401008,3,325,47,372
"DAYKUNDI","NILI",2401008,4,127,24,151
"DAYKUNDI","NILI",2401008,5,303,27,330
"DAYKUNDI","NILI",2401008,6,295,25,320
"DAYKUNDI","NILI",2401008,7,138,36,174
"DAYKUNDI","NILI",2401008,8,323,50,373
"DAYKUNDI","NILI",2401003,1,443,34,477
"DAYKUNDI","NILI",2401005,2,215,5,220
"DAYKUNDI","NILI",2401005,3,404,3,407
"DAYKUNDI","NILI",2401005,4,422,10,432
"DAYKUNDI","NILI",2401002,1,78,8,86
"DAYKUNDI","NILI",2401006,2,93,4,97
"DAYKUNDI","NILI",2401006,3,177,7,184
"DAYKUNDI","NILI",2401006,4,132,5,137
"DAYKUNDI","NILI",2401012,1,150,6,156
"DAYKUNDI","NILI",2401012,2,179,26,205
"DAYKUNDI","NILI",2401012,3,117,27,144
"DAYKUNDI","NILI",2401012,4,420,47,467
"DAYKUNDI","NILI",2401012,5,147,8,155
"DAYKUNDI","NILI",2401005,1,241,9,250
"DAYKUNDI","NILI",2401007,5,206,18,224
"DAYKUNDI","NILI",2401004,1,104,12,116
"DAYKUNDI","NILI",2401001,7,299,55,354
"DAYKUNDI","NILI",2401001,8,364,38,402
"DAYKUNDI","NILI",2401001,9,301,38,339
"DAYKUNDI","NILI",2401001,10,151,31,182
"DAYKUNDI","NILI",2401170,1,50,18,68
"DAYKUNDI","NILI",2401170,2,52,15,67
"DAYKUNDI","NILI",2401170,3,85,20,105
"DAYKUNDI","NILI",2401170,4,61,7,68
"DAYKUNDI","NILI",2401009,1,191,23,214
"DAYKUNDI","NILI",2401169,3,172,7,179
"DAYKUNDI","NILI",2401169,4,190,6,196
"DAYKUNDI","NILI",2401007,4,548,39,587
"DAYKUNDI","NILI",2401011,1,122,4,126
"DAYKUNDI","NILI",2401011,2,98,5,103
"DAYKUNDI","NILI",2401011,3,161,2,163
"DAYKUNDI","NILI",2401011,4,123,5,128
"DAYKUNDI","NILI",2401010,1,118,15,133
"DAYKUNDI","NILI",2401010,2,119,9,128
"DAYKUNDI","NILI",2401010,3,199,9,208
"DAYKUNDI","NILI",2401010,4,194,20,214
"DAYKUNDI","NILI",2401169,1,171,11,182
"DAYKUNDI","NILI",2401169,2,150,2,152
"DAYKUNDI","NILI",2401007,2,282,38,320
"DAYKUNDI","NILI",2401007,3,119,17,136
"DAYKUNDI","NILI",2401001,4,174,26,200
"DAYKUNDI","NILI",2401001,1,446,75,521
"DAYKUNDI","NILI",2401001,2,416,80,496
"DAYKUNDI","NILI",2401001,3,216,25,241
"DAYKUNDI","NILI",2401002,5,234,12,246
"DAYKUNDI","NILI",2401002,2,116,8,124
"DAYKUNDI","NILI",2401002,3,104,11,115
"DAYKUNDI","NILI",2401002,4,67,7,74
"DAYKUNDI","NILI",2401002,6,195,12,207
"DAYKUNDI","NILI",2401007,1,171,15,186
"DAYKUNDI","NILI",2401001,6,324,44,368
"DAYKUNDI","NILI",2401001,5,108,27,135
"DAYKUNDI","SHAHRISTAN",2402016,1,400,63,463
"DAYKUNDI","SHAHRISTAN",2402013,5,261,37,298
"DAYKUNDI","SHAHRISTAN",2402033,1,223,65,288
"DAYKUNDI","SHAHRISTAN",2402033,2,298,107,405
"DAYKUNDI","SHAHRISTAN",2402015,1,336,136,472
"DAYKUNDI","SHAHRISTAN",2402021,2,211,39,250
"DAYKUNDI","SHAHRISTAN",2402021,3,425,35,460
"DAYKUNDI","SHAHRISTAN",2402028,1,225,70,295
"DAYKUNDI","SHAHRISTAN",2402028,2,258,62,320
"DAYKUNDI","SHAHRISTAN",2402026,1,156,232,388
"DAYKUNDI","SHAHRISTAN",2402026,2,193,384,577
"DAYKUNDI","SHAHRISTAN",2402035,1,90,29,119
"DAYKUNDI","SHAHRISTAN",2402016,2,387,82,469
"DAYKUNDI","SHAHRISTAN",2402034,1,422,53,475
"DAYKUNDI","SHAHRISTAN",2402034,2,496,36,532
"DAYKUNDI","SHAHRISTAN",2402027,2,353,109,462
"DAYKUNDI","SHAHRISTAN",2402029,1,183,41,224
"DAYKUNDI","SHAHRISTAN",2402029,2,137,20,157
"DAYKUNDI","SHAHRISTAN",2402029,3,187,13,200
"DAYKUNDI","SHAHRISTAN",2402029,4,161,13,174
"DAYKUNDI","SHAHRISTAN",2402025,1,130,85,215
"DAYKUNDI","SHAHRISTAN",2402025,2,233,67,300
"DAYKUNDI","SHAHRISTAN",2402030,1,382,49,431
"DAYKUNDI","SHAHRISTAN",2402030,2,534,55,589
"DAYKUNDI","SHAHRISTAN",2402032,1,126,63,189
"DAYKUNDI","SHAHRISTAN",2402035,2,96,45,141
"DAYKUNDI","SHAHRISTAN",2402035,3,99,54,153
"DAYKUNDI","SHAHRISTAN",2402027,1,256,117,373
"DAYKUNDI","SHAHRISTAN",2402171,1,154,41,195
"DAYKUNDI","SHAHRISTAN",2402171,2,128,15,143
"DAYKUNDI","SHAHRISTAN",2402171,3,313,30,343
"DAYKUNDI","SHAHRISTAN",2402017,4,249,49,298
"DAYKUNDI","SHAHRISTAN",2402017,5,82,5,87
"DAYKUNDI","SHAHRISTAN",2402013,1,95,32,127
"DAYKUNDI","SHAHRISTAN",2402013,2,117,48,165
"DAYKUNDI","SHAHRISTAN",2402013,3,176,29,205
"DAYKUNDI","SHAHRISTAN",2402013,4,236,90,326
"DAYKUNDI","SHAHRISTAN",2402022,3,313,134,447
"DAYKUNDI","SHAHRISTAN",2402022,4,205,58,263
"DAYKUNDI","SHAHRISTAN",2402022,5,303,87,390
"DAYKUNDI","SHAHRISTAN",2402023,1,312,67,379
"DAYKUNDI","SHAHRISTAN",2402023,2,151,25,176
"DAYKUNDI","SHAHRISTAN",2402023,3,66,16,82
"DAYKUNDI","SHAHRISTAN",2402023,4,322,35,357
"DAYKUNDI","SHAHRISTAN",2402023,5,503,22,525
"DAYKUNDI","SHAHRISTAN",2402015,2,344,89,433
"DAYKUNDI","SHAHRISTAN",2402015,3,316,38,354
"DAYKUNDI","SHAHRISTAN",2402015,4,310,83,393
"DAYKUNDI","SHAHRISTAN",2402175,1,137,25,162
"DAYKUNDI","SHAHRISTAN",2402175,2,77,11,88
"DAYKUNDI","SHAHRISTAN",2402175,3,255,15,270
"DAYKUNDI","SHAHRISTAN",2402172,1,98,14,112
"DAYKUNDI","SHAHRISTAN",2402172,2,64,4,68
"DAYKUNDI","SHAHRISTAN",2402172,3,183,19,202
"DAYKUNDI","SHAHRISTAN",2402174,1,141,40,181
"DAYKUNDI","SHAHRISTAN",2402174,2,149,21,170
"DAYKUNDI","SHAHRISTAN",2402174,3,332,41,373
"DAYKUNDI","SHAHRISTAN",2402173,1,193,66,259
"DAYKUNDI","SHAHRISTAN",2402173,2,145,52,197
"DAYKUNDI","SHAHRISTAN",2402173,3,272,43,315
"DAYKUNDI","SHAHRISTAN",2402019,1,274,71,345
"DAYKUNDI","SHAHRISTAN",2402019,2,253,54,307
"DAYKUNDI","SHAHRISTAN",2402019,3,289,60,349
"DAYKUNDI","SHAHRISTAN",2402019,4,240,50,290
"DAYKUNDI","SHAHRISTAN",2402020,1,383,211,594
"DAYKUNDI","SHAHRISTAN",2402032,2,188,78,266
"DAYKUNDI","SHAHRISTAN",2402031,1,257,39,296
"DAYKUNDI","SHAHRISTAN",2402031,2,302,50,352
"DAYKUNDI","SHAHRISTAN",2402017,1,408,57,465
"DAYKUNDI","SHAHRISTAN",2402017,2,180,52,232
"DAYKUNDI","SHAHRISTAN",2402017,3,556,40,596
"DAYKUNDI","SHAHRISTAN",2402024,3,537,62,599
"DAYKUNDI","SHAHRISTAN",2402024,4,401,104,505
"DAYKUNDI","SHAHRISTAN",2402024,5,177,98,275
"DAYKUNDI","SHAHRISTAN",2402018,1,310,148,458
"DAYKUNDI","SHAHRISTAN",2402018,2,383,195,578
"DAYKUNDI","SHAHRISTAN",2402022,1,170,82,252
"DAYKUNDI","SHAHRISTAN",2402022,2,262,64,326
"DAYKUNDI","SHAHRISTAN",2402014,2,151,73,224
"DAYKUNDI","SHAHRISTAN",2402024,1,306,111,417
"DAYKUNDI","SHAHRISTAN",2402020,2,518,70,588
"DAYKUNDI","SHAHRISTAN",2402014,1,167,66,233
"DAYKUNDI","SHAHRISTAN",2402024,2,366,134,500
"DAYKUNDI","SHAHRISTAN",2402021,1,213,24,237
"DAYKUNDI","GIZAB",2403117,1,22,43,65
"DAYKUNDI","ISHTERLAI",2404040,3,356,236,592
"DAYKUNDI","ISHTERLAI",2404047,1,161,41,202
"DAYKUNDI","ISHTERLAI",2404047,2,154,57,211
"DAYKUNDI","ISHTERLAI",2404047,3,359,39,398
"DAYKUNDI","ISHTERLAI",2404041,1,183,372,555
"DAYKUNDI","ISHTERLAI",2404041,2,265,268,533
"DAYKUNDI","ISHTERLAI",2404041,3,222,309,531
"DAYKUNDI","ISHTERLAI",2404036,1,99,44,143
"DAYKUNDI","ISHTERLAI",2404048,1,435,162,597
"DAYKUNDI","ISHTERLAI",2404048,2,394,201,595
"DAYKUNDI","ISHTERLAI",2404048,3,387,88,475
"DAYKUNDI","ISHTERLAI",2404048,4,225,233,458
"DAYKUNDI","ISHTERLAI",2404051,1,129,18,147
"DAYKUNDI","ISHTERLAI",2404051,2,107,26,133
"DAYKUNDI","ISHTERLAI",2404051,3,108,37,145
"DAYKUNDI","ISHTERLAI",2404051,4,102,15,117
"DAYKUNDI","ISHTERLAI",2404051,5,346,58,404
"DAYKUNDI","ISHTERLAI",2404051,6,400,26,426
"DAYKUNDI","ISHTERLAI",2404049,1,131,38,169
"DAYKUNDI","ISHTERLAI",2404049,2,176,100,276
"DAYKUNDI","ISHTERLAI",2404049,3,184,17,201
"DAYKUNDI","ISHTERLAI",2404040,1,299,300,599
"DAYKUNDI","ISHTERLAI",2404040,2,401,48,449
"DAYKUNDI","ISHTERLAI",2404177,1,203,11,214
"DAYKUNDI","ISHTERLAI",2404177,2,148,9,157
"DAYKUNDI","ISHTERLAI",2404177,3,273,9,282
"DAYKUNDI","ISHTERLAI",2404179,1,81,25,106
"DAYKUNDI","ISHTERLAI",2404179,2,106,31,137
"DAYKUNDI","ISHTERLAI",2404179,3,296,83,379
"DAYKUNDI","ISHTERLAI",2404050,1,195,75,270
"DAYKUNDI","ISHTERLAI",2404050,2,210,97,307
"DAYKUNDI","ISHTERLAI",2404050,3,218,69,287
"DAYKUNDI","ISHTERLAI",2404036,2,177,109,286
"DAYKUNDI","ISHTERLAI",2404036,3,220,246,466
"DAYKUNDI","ISHTERLAI",2404036,4,207,87,294
"DAYKUNDI","ISHTERLAI",2404037,1,384,52,436
"DAYKUNDI","ISHTERLAI",2404037,2,372,92,464
"DAYKUNDI","ISHTERLAI",2404037,3,505,78,583
"DAYKUNDI","ISHTERLAI",2404039,1,283,57,340
"DAYKUNDI","ISHTERLAI",2404039,2,66,18,84
"DAYKUNDI","ISHTERLAI",2404039,3,281,66,347
"DAYKUNDI","ISHTERLAI",2404046,1,450,109,559
"DAYKUNDI","ISHTERLAI",2404046,2,507,55,562
"DAYKUNDI","ISHTERLAI",2404038,1,376,71,447
"DAYKUNDI","ISHTERLAI",2404038,2,360,83,443
"DAYKUNDI","ISHTERLAI",2404042,1,308,107,415
"DAYKUNDI","ISHTERLAI",2404042,2,439,94,533
"DAYKUNDI","ISHTERLAI",2404043,1,188,11,199
"DAYKUNDI","ISHTERLAI",2404043,2,261,54,315
"DAYKUNDI","ISHTERLAI",2404043,3,269,36,305
"DAYKUNDI","ISHTERLAI",2404052,1,195,45,240
"DAYKUNDI","ISHTERLAI",2404052,2,255,56,311
"DAYKUNDI","ISHTERLAI",2404176,1,131,72,203
"DAYKUNDI","ISHTERLAI",2404176,2,88,49,137
"DAYKUNDI","ISHTERLAI",2404176,3,246,17,263
"DAYKUNDI","ISHTERLAI",2404053,1,73,29,102
"DAYKUNDI","ISHTERLAI",2404053,2,30,9,39
"DAYKUNDI","ISHTERLAI",2404053,3,170,50,220
"DAYKUNDI","ISHTERLAI",2404045,1,364,104,468
"DAYKUNDI","ISHTERLAI",2404045,2,419,119,538
"DAYKUNDI","ISHTERLAI",2404044,1,300,63,363
"DAYKUNDI","ISHTERLAI",2404044,2,522,40,562
"DAYKUNDI","ISHTERLAI",2404044,3,269,62,331
"DAYKUNDI","ISHTERLAI",2404044,4,261,31,292
"DAYKUNDI","ISHTERLAI",2404178,3,115,18,133
"DAYKUNDI","ISHTERLAI",2404178,1,114,23,137
"DAYKUNDI","ISHTERLAI",2404178,2,373,61,434
"DAYKUNDI","KHEDIR",2405097,1,307,84,391
"DAYKUNDI","KHEDIR",2405097,2,365,38,403
"DAYKUNDI","KHEDIR",2405086,1,256,27,283
"DAYKUNDI","KHEDIR",2405096,1,308,67,375
"DAYKUNDI","KHEDIR",2405096,2,345,59,404
"DAYKUNDI","KHEDIR",2405096,3,491,92,583
"DAYKUNDI","KHEDIR",2405095,1,298,81,379
"DAYKUNDI","KHEDIR",2405095,2,214,220,434
"DAYKUNDI","KHEDIR",2405086,2,280,14,294
"DAYKUNDI","KHEDIR",2405089,1,334,121,455
"DAYKUNDI","KHEDIR",2405089,2,458,140,598
"DAYKUNDI","KHEDIR",2405089,3,219,178,397
"DAYKUNDI","KHEDIR",2405087,1,146,20,166
"DAYKUNDI","KHEDIR",2405099,1,355,241,596
"DAYKUNDI","KHEDIR",2405099,2,309,235,544
"DAYKUNDI","KHEDIR",2405099,3,352,169,521
"DAYKUNDI","KHEDIR",2405085,2,174,14,188
"DAYKUNDI","KHEDIR",2405085,3,359,42,401
"DAYKUNDI","KHEDIR",2405088,1,105,16,121
"DAYKUNDI","KHEDIR",2405088,2,118,11,129
"DAYKUNDI","KHEDIR",2405088,3,284,19,303
"DAYKUNDI","KHEDIR",2405102,1,239,250,489
"DAYKUNDI","KHEDIR",2405102,2,294,231,525
"DAYKUNDI","KHEDIR",2405091,1,388,29,417
"DAYKUNDI","KHEDIR",2405091,2,165,35,200
"DAYKUNDI","KHEDIR",2405091,3,182,37,219
"DAYKUNDI","KHEDIR",2405087,2,135,25,160
"DAYKUNDI","KHEDIR",2405087,3,341,29,370
"DAYKUNDI","KHEDIR",2405085,1,164,19,183
"DAYKUNDI","KHEDIR",2405183,1,331,141,472
"DAYKUNDI","KHEDIR",2405183,2,315,244,559
"DAYKUNDI","KHEDIR",2405183,3,289,129,418
"DAYKUNDI","KHEDIR",2405181,1,79,19,98
"DAYKUNDI","KHEDIR",2405181,2,93,25,118
"DAYKUNDI","KHEDIR",2405181,3,144,17,161
"DAYKUNDI","KHEDIR",2405180,1,200,223,423
"DAYKUNDI","KHEDIR",2405180,2,378,124,502
"DAYKUNDI","KHEDIR",2405180,3,434,139,573
"DAYKUNDI","KHEDIR",2405101,1,220,369,589
"DAYKUNDI","KHEDIR",2405101,2,307,233,540
"DAYKUNDI","KHEDIR",2405101,3,279,213,492
"DAYKUNDI","KHEDIR",2405094,3,437,56,493
"DAYKUNDI","KHEDIR",2405098,1,328,52,380
"DAYKUNDI","KHEDIR",2405098,2,405,34,439
"DAYKUNDI","KHEDIR",2405100,1,263,308,571
"DAYKUNDI","KHEDIR",2405100,2,292,227,519
"DAYKUNDI","KHEDIR",2405100,3,371,213,584
"DAYKUNDI","KHEDIR",2405182,1,379,197,576
"DAYKUNDI","KHEDIR",2405095,3,372,221,593
"DAYKUNDI","KHEDIR",2405092,1,329,139,468
"DAYKUNDI","KHEDIR",2405092,2,162,332,494
"DAYKUNDI","KHEDIR",2405092,3,107,471,578
"DAYKUNDI","KHEDIR",2405094,1,169,27,196
"DAYKUNDI","KHEDIR",2405094,2,145,16,161
"DAYKUNDI","KHEDIR",2405090,2,467,132,599
"DAYKUNDI","KHEDIR",2405090,3,398,169,567
"DAYKUNDI","KHEDIR",2405103,2,251,18,269
"DAYKUNDI","KHEDIR",2405182,2,311,250,561
"DAYKUNDI","KHEDIR",2405182,3,514,65,579
"DAYKUNDI","KHEDIR",2405103,1,253,52,305
"DAYKUNDI","KHEDIR",2405093,3,502,52,554
"DAYKUNDI","KHEDIR",2405090,1,432,166,598
"DAYKUNDI","KHEDIR",2405093,1,370,148,518
"DAYKUNDI","KHEDIR",2405093,2,375,131,506
"DAYKUNDI","GETI",2406124,3,267,68,335
"DAYKUNDI","GETI",2406132,2,381,59,440
"DAYKUNDI","GETI",2406132,3,268,32,300
"DAYKUNDI","GETI",2406124,1,176,27,203
"DAYKUNDI","GETI",2406124,2,129,33,162
"DAYKUNDI","GETI",2406124,4,174,27,201
"DAYKUNDI","GETI",2406132,1,173,20,193
"DAYKUNDI","GETI",2406184,3,265,37,302
"DAYKUNDI","GETI",2406187,1,68,498,566
"DAYKUNDI","GETI",2406184,1,96,29,125
"DAYKUNDI","GETI",2406184,2,234,25,259
"DAYKUNDI","GETI",2406186,1,225,30,255
"DAYKUNDI","GETI",2406186,2,335,18,353
"DAYKUNDI","GETI",2406187,2,539,23,562
"DAYKUNDI","GETI",2406187,3,259,159,418
"DAYKUNDI","GETI",2406185,2,114,12,126
"DAYKUNDI","GETI",2406185,3,178,45,223
"DAYKUNDI","GETI",2406141,3,322,149,471
"DAYKUNDI","GETI",2406135,1,233,68,301
"DAYKUNDI","GETI",2406135,2,145,39,184
"DAYKUNDI","GETI",2406135,3,221,90,311
"DAYKUNDI","GETI",2406136,1,376,23,399
"DAYKUNDI","GETI",2406136,2,295,11,306
"DAYKUNDI","GETI",2406136,3,455,24,479
"DAYKUNDI","GETI",2406138,1,358,111,469
"DAYKUNDI","GETI",2406131,1,225,105,330
"DAYKUNDI","GETI",2406186,3,281,12,293
"DAYKUNDI","GETI",2406185,1,120,14,134
"DAYKUNDI","GETI",2406129,1,332,28,360
"DAYKUNDI","GETI",2406129,2,136,184,320
"DAYKUNDI","GETI",2406129,3,442,105,547
"DAYKUNDI","GETI",2406130,1,232,35,267
"DAYKUNDI","GETI",2406130,2,342,16,358
"DAYKUNDI","GETI",2406130,3,436,47,483
"DAYKUNDI","GETI",2406128,1,129,70,199
"DAYKUNDI","GETI",2406128,2,88,47,135
"DAYKUNDI","GETI",2406128,3,186,97,283
"DAYKUNDI","GETI",2406126,1,296,31,327
"DAYKUNDI","GETI",2406126,2,178,36,214
"DAYKUNDI","GETI",2406131,2,119,311,430
"DAYKUNDI","GETI",2406131,3,313,280,593
"DAYKUNDI","GETI",2406127,2,237,185,422
"DAYKUNDI","GETI",2406127,3,222,45,267
"DAYKUNDI","GETI",2406125,1,148,33,181
"DAYKUNDI","GETI",2406125,2,142,44,186
"DAYKUNDI","GETI",2406125,3,103,1,104
"DAYKUNDI","GETI",2406134,1,158,71,229
"DAYKUNDI","GETI",2406134,2,413,61,474
"DAYKUNDI","GETI",2406134,3,275,94,369
"DAYKUNDI","GETI",2406133,1,239,22,261
"DAYKUNDI","GETI",2406133,2,250,31,281
"DAYKUNDI","GETI",2406133,3,241,20,261
"DAYKUNDI","GETI",2406137,1,223,41,264
"DAYKUNDI","GETI",2406137,2,222,33,255
"DAYKUNDI","GETI",2406137,3,333,45,378
"DAYKUNDI","GETI",2406141,1,108,41,149
"DAYKUNDI","GETI",2406141,2,142,45,187
"DAYKUNDI","GETI",2406142,1,106,53,159
"DAYKUNDI","GETI",2406142,2,119,61,180
"DAYKUNDI","GETI",2406142,3,133,83,216
"DAYKUNDI","GETI",2406143,1,124,197,321
"DAYKUNDI","GETI",2406143,2,136,293,429
"DAYKUNDI","GETI",2406143,3,147,398,545
"DAYKUNDI","GETI",2406140,1,70,99,169
"DAYKUNDI","GETI",2406140,2,80,85,165
"DAYKUNDI","GETI",2406138,2,230,127,357
"DAYKUNDI","GETI",2406138,3,358,102,460
"DAYKUNDI","GETI",2406139,1,78,30,108
"DAYKUNDI","GETI",2406139,2,107,30,137
"DAYKUNDI","GETI",2406139,3,227,48,275
"DAYKUNDI","GETI",2406140,3,264,207,471
"DAYKUNDI","GETI",2406126,3,428,57,485
"DAYKUNDI","GETI",2406127,1,121,28,149
"DAYKUNDI","MIRAMOR",2407165,1,328,46,374
"DAYKUNDI","MIRAMOR",2407167,2,238,163,401
"DAYKUNDI","MIRAMOR",2407147,2,181,31,212
"DAYKUNDI","MIRAMOR",2407147,3,239,24,263
"DAYKUNDI","MIRAMOR",2407163,2,233,62,295
"DAYKUNDI","MIRAMOR",2407147,1,239,41,280
"DAYKUNDI","MIRAMOR",2407161,2,213,101,314
"DAYKUNDI","MIRAMOR",2407162,1,281,18,299
"DAYKUNDI","MIRAMOR",2407165,2,510,47,557
"DAYKUNDI","MIRAMOR",2407161,1,305,133,438
"DAYKUNDI","MIRAMOR",2407166,1,229,26,255
"DAYKUNDI","MIRAMOR",2407166,2,348,19,367
"DAYKUNDI","MIRAMOR",2407163,1,128,54,182
"DAYKUNDI","MIRAMOR",2407165,3,537,59,596
"DAYKUNDI","MIRAMOR",2407164,1,340,219,559
"DAYKUNDI","MIRAMOR",2407164,2,450,148,598
"DAYKUNDI","MIRAMOR",2407192,1,404,104,508
"DAYKUNDI","MIRAMOR",2407192,2,326,200,526
"DAYKUNDI","MIRAMOR",2407192,3,156,44,200
"DAYKUNDI","MIRAMOR",2407189,1,319,167,486
"DAYKUNDI","MIRAMOR",2407189,2,297,294,591
"DAYKUNDI","MIRAMOR",2407162,2,281,53,334
"DAYKUNDI","MIRAMOR",2407159,1,334,97,431
"DAYKUNDI","MIRAMOR",2407159,2,301,123,424
"DAYKUNDI","MIRAMOR",2407157,1,372,209,581
"DAYKUNDI","MIRAMOR",2407157,2,347,70,417
"DAYKUNDI","MIRAMOR",2407157,3,511,75,586
"DAYKUNDI","MIRAMOR",2407156,1,57,14,71
"DAYKUNDI","MIRAMOR",2407156,2,52,21,73
"DAYKUNDI","MIRAMOR",2407156,3,107,27,134
"DAYKUNDI","MIRAMOR",2407160,1,63,33,96
"DAYKUNDI","MIRAMOR",2407160,2,82,16,98
"DAYKUNDI","MIRAMOR",2407167,1,208,112,320
"DAYKUNDI","MIRAMOR",2407144,1,130,22,152
"DAYKUNDI","MIRAMOR",2407144,2,144,20,164
"DAYKUNDI","MIRAMOR",2407144,3,138,32,170
"DAYKUNDI","MIRAMOR",2407144,4,289,18,307
"DAYKUNDI","MIRAMOR",2407145,1,340,88,428
"DAYKUNDI","MIRAMOR",2407145,2,353,66,419
"DAYKUNDI","MIRAMOR",2407145,3,383,72,455
"DAYKUNDI","MIRAMOR",2407145,4,480,61,541
"DAYKUNDI","MIRAMOR",2407149,4,102,11,113
"DAYKUNDI","MIRAMOR",2407148,1,328,44,372
"DAYKUNDI","MIRAMOR",2407148,2,502,55,557
"DAYKUNDI","MIRAMOR",2407147,4,287,22,309
"DAYKUNDI","MIRAMOR",2407146,1,125,9,134
"DAYKUNDI","MIRAMOR",2407146,2,350,46,396
"DAYKUNDI","MIRAMOR",2407146,3,243,26,269
"DAYKUNDI","MIRAMOR",2407146,4,449,39,488
"DAYKUNDI","MIRAMOR",2407151,1,250,87,337
"DAYKUNDI","MIRAMOR",2407151,2,374,74,448
"DAYKUNDI","MIRAMOR",2407149,1,515,71,586
"DAYKUNDI","MIRAMOR",2407149,2,511,69,580
"DAYKUNDI","MIRAMOR",2407149,3,515,53,568
"DAYKUNDI","MIRAMOR",2407188,1,184,84,268
"DAYKUNDI","MIRAMOR",2407188,2,112,50,162
"DAYKUNDI","MIRAMOR",2407188,3,254,70,324
"DAYKUNDI","MIRAMOR",2407153,1,419,172,591
"DAYKUNDI","MIRAMOR",2407153,2,407,182,589
"DAYKUNDI","MIRAMOR",2407153,3,472,117,589
"DAYKUNDI","MIRAMOR",2407150,1,199,32,231
"DAYKUNDI","MIRAMOR",2407189,3,361,223,584
"DAYKUNDI","MIRAMOR",2407191,1,202,8,210
"DAYKUNDI","MIRAMOR",2407191,2,223,24,247
"DAYKUNDI","MIRAMOR",2407191,3,227,13,240
"DAYKUNDI","MIRAMOR",2407158,1,383,164,547
"DAYKUNDI","MIRAMOR",2407158,2,355,211,566
"DAYKUNDI","MIRAMOR",2407152,3,463,123,586
"DAYKUNDI","MIRAMOR",2407154,1,281,62,343
"DAYKUNDI","MIRAMOR",2407154,2,252,66,318
"DAYKUNDI","MIRAMOR",2407190,1,232,89,321
"DAYKUNDI","MIRAMOR",2407190,2,137,67,204
"DAYKUNDI","MIRAMOR",2407190,3,363,51,414
"DAYKUNDI","MIRAMOR",2407150,3,529,42,571
"DAYKUNDI","MIRAMOR",2407152,1,531,65,596
"DAYKUNDI","MIRAMOR",2407152,2,408,158,566
"DAYKUNDI","MIRAMOR",2407150,2,203,19,222
"DAYKUNDI","MIRAMOR",2407155,1,393,194,587
"DAYKUNDI","MIRAMOR",2407155,2,461,130,591
"DAYKUNDI","SANG-E-TAKHT",2408079,2,470,126,596
"DAYKUNDI","SANG-E-TAKHT",2408076,2,247,98,345
"DAYKUNDI","SANG-E-TAKHT",2408076,3,472,115,587
"DAYKUNDI","SANG-E-TAKHT",2408079,1,505,87,592
"DAYKUNDI","SANG-E-TAKHT",2408081,2,374,98,472
"DAYKUNDI","SANG-E-TAKHT",2408079,3,489,79,568
"DAYKUNDI","SANG-E-TAKHT",2408079,4,469,102,571
"DAYKUNDI","SANG-E-TAKHT",2408081,1,440,59,499
"DAYKUNDI","SANG-E-TAKHT",2408071,1,246,156,402
"DAYKUNDI","SANG-E-TAKHT",2408071,2,353,91,444
"DAYKUNDI","SANG-E-TAKHT",2408071,3,301,88,389
"DAYKUNDI","SANG-E-TAKHT",2408071,4,326,112,438
"DAYKUNDI","SANG-E-TAKHT",2408071,5,364,106,470
"DAYKUNDI","SANG-E-TAKHT",2408073,1,380,217,597
"DAYKUNDI","SANG-E-TAKHT",2408073,2,418,150,568
"DAYKUNDI","SANG-E-TAKHT",2408077,1,473,116,589
"DAYKUNDI","SANG-E-TAKHT",2408077,2,469,123,592
"DAYKUNDI","SANG-E-TAKHT",2408077,3,502,75,577
"DAYKUNDI","SANG-E-TAKHT",2408077,4,440,152,592
"DAYKUNDI","SANG-E-TAKHT",2408072,1,406,94,500
"DAYKUNDI","SANG-E-TAKHT",2408072,2,400,112,512
"DAYKUNDI","SANG-E-TAKHT",2408072,3,361,43,404
"DAYKUNDI","SANG-E-TAKHT",2408072,4,410,39,449
"DAYKUNDI","SANG-E-TAKHT",2408076,1,308,78,386
"DAYKUNDI","SANG-E-TAKHT",2408082,1,368,107,475
"DAYKUNDI","SANG-E-TAKHT",2408082,2,132,105,237
"DAYKUNDI","SANG-E-TAKHT",2408082,3,384,145,529
"DAYKUNDI","SANG-E-TAKHT",2408083,1,217,80,297
"DAYKUNDI","SANG-E-TAKHT",2408083,2,174,68,242
"DAYKUNDI","SANG-E-TAKHT",2408083,3,478,115,593
"DAYKUNDI","SANG-E-TAKHT",2408078,1,218,65,283
"DAYKUNDI","SANG-E-TAKHT",2408078,2,237,52,289
"DAYKUNDI","SANG-E-TAKHT",2408078,3,350,85,435
"DAYKUNDI","SANG-E-TAKHT",2408193,1,209,123,332
"DAYKUNDI","SANG-E-TAKHT",2408081,3,453,71,524
"DAYKUNDI","SANG-E-TAKHT",2408080,1,233,96,329
"DAYKUNDI","SANG-E-TAKHT",2408080,2,361,114,475
"DAYKUNDI","SANG-E-TAKHT",2408074,2,338,146,484
"DAYKUNDI","SANG-E-TAKHT",2408074,3,321,77,398
"DAYKUNDI","SANG-E-TAKHT",2408084,1,115,70,185
"DAYKUNDI","SANG-E-TAKHT",2408084,2,119,49,168
"DAYKUNDI","SANG-E-TAKHT",2408084,3,154,108,262
"DAYKUNDI","SANG-E-TAKHT",2408075,1,383,62,445
"DAYKUNDI","SANG-E-TAKHT",2408075,2,523,59,582
"DAYKUNDI","SANG-E-TAKHT",2408075,3,421,59,480
"DAYKUNDI","SANG-E-TAKHT",2408074,1,200,85,285
"DAYKUNDI","SANG-E-TAKHT",2408193,2,205,192,397
"DAYKUNDI","SANG-E-TAKHT",2408193,3,424,176,600
"DAYKUNDI","KEJRAN",2409056,2,129,22,151
"DAYKUNDI","KEJRAN",2409056,1,91,15,106
"DAYKUNDI","KEJRAN",2409066,1,26,22,48
"DAYKUNDI","KEJRAN",2409055,3,416,68,484
"DAYKUNDI","KEJRAN",2409068,2,142,24,166
"DAYKUNDI","KEJRAN",2409054,1,300,15,315
"DAYKUNDI","KEJRAN",2409066,2,55,31,86
"DAYKUNDI","KEJRAN",2409068,1,85,23,108
"DAYKUNDI","KEJRAN",2409057,1,173,35,208
"DAYKUNDI","KEJRAN",2409057,2,110,109,219
"DAYKUNDI","KEJRAN",2409057,3,438,60,498
"DAYKUNDI","KEJRAN",2409055,1,343,100,443
"DAYKUNDI","KEJRAN",2409055,2,107,84,191
"DAYKUNDI","KEJRAN",2409065,2,189,58,247
"DAYKUNDI","KEJRAN",2409069,1,99,25,124
"DAYKUNDI","KEJRAN",2409069,2,155,11,166
"DAYKUNDI","KEJRAN",2409056,3,96,15,111
"DAYKUNDI","KEJRAN",2409067,1,73,10,83
"DAYKUNDI","KEJRAN",2409067,2,346,27,373
"DAYKUNDI","KEJRAN",2409067,3,149,27,176
"DAYKUNDI","KEJRAN",2409064,1,103,40,143
"DAYKUNDI","KEJRAN",2409064,2,75,11,86
"DAYKUNDI","KEJRAN",2409064,3,219,67,286
"DAYKUNDI","KEJRAN",2409063,1,103,120,223
"DAYKUNDI","KEJRAN",2409063,2,249,93,342
"DAYKUNDI","KEJRAN",2409065,1,195,66,261
"DAYKUNDI","KEJRAN",2409062,1,161,20,181
"DAYKUNDI","KEJRAN",2409062,2,164,18,182
"DAYKUNDI","KEJRAN",2409062,3,354,33,387
"DAYKUNDI","KEJRAN",2409168,1,179,29,208
"DAYKUNDI","KEJRAN",2409168,2,140,63,203
"DAYKUNDI","KEJRAN",2409070,1,154,51,205
"DAYKUNDI","KEJRAN",2409070,2,282,37,319
"DAYKUNDI","KEJRAN",2409054,2,174,53,227
"DAYKUNDI","KEJRAN",2409061,1,115,13,128
"DAYKUNDI","KEJRAN",2409061,2,85,10,95
"DAYKUNDI","KEJRAN",2409061,3,258,25,283
"DAYKUNDI","KEJRAN",2409194,2,56,76,132
"DAYKUNDI","KEJRAN",2409194,3,72,231,303
"DAYKUNDI","KEJRAN",2409059,2,189,23,212
"DAYKUNDI","KEJRAN",2409060,1,172,31,203
"DAYKUNDI","KEJRAN",2409060,2,220,39,259
"DAYKUNDI","KEJRAN",2409059,1,296,24,320
"DAYKUNDI","KEJRAN",2409058,2,173,182,355
"DAYKUNDI","KEJRAN",2409054,3,232,21,253
"DAYKUNDI","KEJRAN",2409054,4,150,34,184
"DAYKUNDI","KEJRAN",2409058,1,114,77,191
"DAYKUNDI","KEJRAN",2409194,1,52,93,145
"UROZGAN","TIRINKOT",2501003,4,5,17,22
"UROZGAN","TIRINKOT",2501008,3,8,25,33
"UROZGAN","TIRINKOT",2501003,5,7,4,11
"UROZGAN","TIRINKOT",2501004,3,16,18,34
"UROZGAN","TIRINKOT",2501003,7,0,12,12
"UROZGAN","TIRINKOT",2501008,4,56,50,106
"UROZGAN","TIRINKOT",2501003,6,0,23,23
"UROZGAN","TIRINKOT",2501006,1,20,48,68
"UROZGAN","TIRINKOT",2501001,1,0,3,3
"UROZGAN","TIRINKOT",2501003,8,1,2,3
"UROZGAN","TIRINKOT",2501008,5,1,0,1
"UROZGAN","TIRINKOT",2501008,1,55,98,153
"UROZGAN","TIRINKOT",2501008,2,20,41,61
"UROZGAN","TIRINKOT",2501002,1,43,41,84
"UROZGAN","TIRINKOT",2501002,2,39,27,66
"UROZGAN","TIRINKOT",2501002,3,89,66,155
"UROZGAN","TIRINKOT",2501002,5,53,58,111
"UROZGAN","TIRINKOT",2501005,1,2,95,97
"UROZGAN","TIRINKOT",2501005,2,21,37,58
"UROZGAN","TIRINKOT",2501005,3,8,21,29
"UROZGAN","TIRINKOT",2501005,4,93,191,284
"UROZGAN","TIRINKOT",2501005,5,22,53,75
"UROZGAN","TIRINKOT",2501004,5,2,5,7
"UROZGAN","TIRINKOT",2501004,7,9,25,34
"UROZGAN","TIRINKOT",2501001,6,0,2,2
"UROZGAN","TIRINKOT",2501001,7,1,2,3
"UROZGAN","TIRINKOT",2501003,2,2,4,6
"UROZGAN","TIRINKOT",2501003,3,3,3,6
"UROZGAN","TIRINKOT",2501050,1,103,9,112
"UROZGAN","TIRINKOT",2501050,2,84,15,99
"UROZGAN","TIRINKOT",2501050,3,24,3,27
"UROZGAN","TIRINKOT",2501050,4,64,11,75
"UROZGAN","TIRINKOT",2501050,5,70,13,83
"UROZGAN","TIRINKOT",2501050,6,2,2,4
"UROZGAN","TIRINKOT",2501004,1,43,97,140
"UROZGAN","TIRINKOT",2501004,2,25,87,112
"UROZGAN","TIRINKOT",2501007,3,30,33,63
"UROZGAN","TIRINKOT",2501011,1,18,50,68
"UROZGAN","TIRINKOT",2501013,1,5,12,17
"UROZGAN","TIRINKOT",2501013,2,17,39,56
"UROZGAN","TIRINKOT",2501013,3,28,11,39
"UROZGAN","TIRINKOT",2501013,4,19,27,46
"UROZGAN","TIRINKOT",2501013,5,4,11,15
"UROZGAN","TIRINKOT",2501015,1,32,114,146
"UROZGAN","TIRINKOT",2501015,2,59,135,194
"UROZGAN","TIRINKOT",2501015,4,37,68,105
"UROZGAN","TIRINKOT",2501006,2,15,57,72
"UROZGAN","TIRINKOT",2501006,3,19,75,94
"UROZGAN","TIRINKOT",2501006,4,37,181,218
"UROZGAN","TIRINKOT",2501001,2,18,15,33
"UROZGAN","TIRINKOT",2501001,3,8,15,23
"UROZGAN","TIRINKOT",2501001,4,18,22,40
"UROZGAN","TIRINKOT",2501001,5,28,30,58
"UROZGAN","TIRINKOT",2501010,5,6,5,11
"UROZGAN","TIRINKOT",2501010,6,13,18,31
"UROZGAN","TIRINKOT",2501010,7,93,229,322
"UROZGAN","TIRINKOT",2501010,8,199,376,575
"UROZGAN","TIRINKOT",2501010,9,8,14,22
"UROZGAN","TIRINKOT",2501012,1,88,53,141
"UROZGAN","TIRINKOT",2501012,2,37,42,79
"UROZGAN","TIRINKOT",2501012,3,15,14,29
"UROZGAN","TIRINKOT",2501012,4,5,4,9
"UROZGAN","TIRINKOT",2501005,6,25,61,86
"UROZGAN","TIRINKOT",2501005,7,47,105,152
"UROZGAN","TIRINKOT",2501005,8,14,37,51
"UROZGAN","TIRINKOT",2501003,1,2,6,8
"UROZGAN","TIRINKOT",2501014,2,12,32,44
"UROZGAN","TIRINKOT",2501014,3,11,50,61
"UROZGAN","TIRINKOT",2501014,4,3,0,3
"UROZGAN","TIRINKOT",2501014,5,2,0,2
"UROZGAN","TIRINKOT",2501007,1,37,75,112
"UROZGAN","TIRINKOT",2501007,2,48,11,59
"UROZGAN","TIRINKOT",2501010,1,190,378,568
"UROZGAN","TIRINKOT",2501052,1,43,63,106
"UROZGAN","TIRINKOT",2501010,3,11,12,23
"UROZGAN","TIRINKOT",2501010,4,7,7,14
"UROZGAN","TIRINKOT",2501052,3,8,26,34
"UROZGAN","TIRINKOT",2501010,2,92,215,307
"UROZGAN","TIRINKOT",2501012,5,2,3,5
"UROZGAN","TIRINKOT",2501052,2,48,73,121
"UROZGAN","TIRINKOT",2501014,1,14,48,62
"UROZGAN","TIRINKOT",2501012,6,1,3,4
"UROZGAN","DEHRAOUD",2502038,1,3,19,22
"UROZGAN","DEHRAOUD",2502036,5,3,20,23
"UROZGAN","DEHRAOUD",2502038,5,8,75,83
"UROZGAN","DEHRAOUD",2502038,2,7,13,20
"UROZGAN","DEHRAOUD",2502036,6,2,43,45
"UROZGAN","DEHRAOUD",2502036,7,0,4,4
"UROZGAN","DEHRAOUD",2502039,4,1,3,4
"UROZGAN","DEHRAOUD",2502039,1,6,14,20
"UROZGAN","DEHRAOUD",2502038,3,0,1,1
"UROZGAN","DEHRAOUD",2502038,4,8,38,46
"UROZGAN","DEHRAOUD",2502040,5,2,1,3
"UROZGAN","DEHRAOUD",2502042,6,0,1,1
"UROZGAN","DEHRAOUD",2502037,1,31,176,207
"UROZGAN","DEHRAOUD",2502037,2,40,228,268
"UROZGAN","DEHRAOUD",2502037,3,34,187,221
"UROZGAN","DEHRAOUD",2502037,4,28,157,185
"UROZGAN","DEHRAOUD",2502037,5,69,327,396
"UROZGAN","DEHRAOUD",2502043,1,11,44,55
"UROZGAN","DEHRAOUD",2502043,2,1,18,19
"UROZGAN","DEHRAOUD",2502043,3,5,13,18
"UROZGAN","DEHRAOUD",2502040,1,1,1,2
"UROZGAN","DEHRAOUD",2502040,2,0,1,1
"UROZGAN","DEHRAOUD",2502040,4,0,1,1
"UROZGAN","DEHRAOUD",2502036,1,9,100,109
"UROZGAN","DEHRAOUD",2502036,2,9,93,102
"UROZGAN","DEHRAOUD",2502036,3,6,92,98
"UROZGAN","DEHRAOUD",2502036,4,5,28,33
"UROZGAN","DEHRAOUD",2502054,1,6,39,45
"UROZGAN","DEHRAOUD",2502054,2,9,44,53
"UROZGAN","DEHRAOUD",2502054,3,2,51,53
"UROZGAN","DEHRAOUD",2502054,4,15,74,89
"UROZGAN","DEHRAOUD",2502054,5,31,107,138
"UROZGAN","DEHRAOUD",2502039,2,92,16,108
"UROZGAN","DEHRAOUD",2502039,3,2,46,48
"UROZGAN","DEHRAOUD",2502042,2,1,18,19
"UROZGAN","DEHRAOUD",2502042,3,0,26,26
"UROZGAN","DEHRAOUD",2502042,4,2,2,4
"UROZGAN","DEHRAOUD",2502042,5,0,1,1
"UROZGAN","DEHRAOUD",2502044,2,8,35,43
"UROZGAN","DEHRAOUD",2502044,3,2,32,34
"UROZGAN","DEHRAOUD",2502044,4,6,13,19
"UROZGAN","DEHRAOUD",2502044,5,1,13,14
"UROZGAN","DEHRAOUD",2502042,1,17,42,59
"UROZGAN","DEHRAOUD",2502038,6,4,16,20
"UROZGAN","DEHRAOUD",2502038,7,6,29,35
"UROZGAN","DEHRAOUD",2502044,1,9,43,52
"UROZGAN","DEHRAOUD",2502043,4,10,20,30
"UROZGAN","DEHRAOUD",2502043,5,1,14,15
"UROZGAN","CHORA",2503016,2,110,104,214
"UROZGAN","CHORA",2503019,1,171,124,295
"UROZGAN","CHORA",2503021,2,56,25,81
"UROZGAN","CHORA",2503020,4,101,17,118
"UROZGAN","CHORA",2503016,3,103,55,158
"UROZGAN","CHORA",2503021,1,44,16,60
"UROZGAN","CHORA",2503016,1,97,79,176
"UROZGAN","CHORA",2503018,1,77,13,90
"UROZGAN","CHORA",2503021,3,54,34,88
"UROZGAN","CHORA",2503016,4,38,42,80
"UROZGAN","CHORA",2503016,5,55,58,113
"UROZGAN","CHORA",2503020,1,66,33,99
"UROZGAN","CHORA",2503018,2,87,20,107
"UROZGAN","CHORA",2503018,3,67,24,91
"UROZGAN","CHORA",2503017,1,35,46,81
"UROZGAN","CHORA",2503022,1,50,180,230
"UROZGAN","CHORA",2503020,3,55,36,91
"UROZGAN","CHORA",2503023,1,129,40,169
"UROZGAN","CHORA",2503023,2,72,68,140
"UROZGAN","SHAHID-E-HASS",2504034,2,14,52,66
"UROZGAN","SHAHID-E-HASS",2504033,3,10,179,189
"UROZGAN","SHAHID-E-HASS",2504034,1,27,95,122
"UROZGAN","SHAHID-E-HASS",2504030,3,11,25,36
"UROZGAN","SHAHID-E-HASS",2504030,4,14,38,52
"UROZGAN","SHAHID-E-HASS",2504030,5,14,32,46
"UROZGAN","SHAHID-E-HASS",2504030,6,7,215,222
"UROZGAN","SHAHID-E-HASS",2504033,1,11,171,182
"UROZGAN","SHAHID-E-HASS",2504033,2,16,177,193
"UROZGAN","SHAHID-E-HASS",2504033,4,5,181,186
"UROZGAN","SHAHID-E-HASS",2504034,3,13,44,57
"UROZGAN","SHAHID-E-HASS",2504030,2,20,95,115
"UROZGAN","SHAHID-E-HASS",2504032,1,9,10,19
"UROZGAN","SHAHID-E-HASS",2504032,2,3,7,10
"UROZGAN","SHAHID-E-HASS",2504030,1,34,46,80
"UROZGAN","SHAHID-E-HASS",2504032,4,4,5,9
"UROZGAN","SHAHID-E-HASS",2504032,3,4,4,8
"UROZGAN","KHAS UROZGAN",2505029,1,47,67,114
"UROZGAN","KHAS UROZGAN",2505024,7,7,1,8
"UROZGAN","KHAS UROZGAN",2505024,8,157,189,346
"UROZGAN","KHAS UROZGAN",2505028,1,69,218,287
"UROZGAN","KHAS UROZGAN",2505024,6,54,495,549
"UROZGAN","KHAS UROZGAN",2505024,2,139,96,235
"UROZGAN","KHAS UROZGAN",2505024,3,81,96,177
"UROZGAN","KHAS UROZGAN",2505024,4,66,102,168
"UROZGAN","KHAS UROZGAN",2505024,5,45,300,345
"UROZGAN","KHAS UROZGAN",2505028,2,63,248,311
"UROZGAN","KHAS UROZGAN",2505028,3,76,198,274
"UROZGAN","KHAS UROZGAN",2505029,5,82,456,538
"UROZGAN","KHAS UROZGAN",2505029,2,18,129,147
"UROZGAN","KHAS UROZGAN",2505029,9,88,400,488
"UROZGAN","KHAS UROZGAN",2505029,10,48,451,499
"UROZGAN","KHAS UROZGAN",2505024,1,92,191,283
"UROZGAN","KHAS UROZGAN",2505029,6,54,413,467
"UROZGAN","KHAS UROZGAN",2505028,4,32,124,156
"UROZGAN","KHAS UROZGAN",2505029,3,25,94,119
"UROZGAN","KHAS UROZGAN",2505029,4,16,85,101
"UROZGAN","KHAS UROZGAN",2505027,1,24,108,132
"UROZGAN","KHAS UROZGAN",2505027,2,13,65,78
NA,NA,2506048,5,11,13,24
NA,NA,2506049,1,18,48,66
NA,NA,2506049,2,15,30,45
NA,NA,2506045,1,35,26,61
NA,NA,2506045,2,104,35,139
NA,NA,2506045,3,142,54,196
NA,NA,2506045,4,41,88,129
NA,NA,2506045,5,91,59,150
NA,NA,2506045,6,220,141,361
NA,NA,2506046,1,2,2,4
NA,NA,2506046,2,2,3,5
NA,NA,2506046,3,3,0,3
NA,NA,2506046,5,3,0,3
NA,NA,2506048,1,6,6,12
NA,NA,2506048,2,6,17,23
NA,NA,2506048,3,18,9,27
NA,NA,2506048,4,36,33,69
"ZABUL","QALAT",2601046,2,48,23,71
"ZABUL","QALAT",2601001,6,25,92,117
"ZABUL","QALAT",2601001,7,30,69,99
"ZABUL","QALAT",2601049,1,48,512,560
"ZABUL","QALAT",2601049,2,23,483,506
"ZABUL","QALAT",2601007,3,24,518,542
"ZABUL","QALAT",2601049,3,14,558,572
"ZABUL","QALAT",2601007,1,13,506,519
"ZABUL","QALAT",2601007,2,11,406,417
"ZABUL","QALAT",2601001,5,34,78,112
"ZABUL","QALAT",2601003,3,20,63,83
"ZABUL","QALAT",2601003,4,2,14,16
"ZABUL","QALAT",2601003,5,3,10,13
"ZABUL","QALAT",2601050,1,37,144,181
"ZABUL","QALAT",2601050,2,42,156,198
"ZABUL","QALAT",2601050,3,9,35,44
"ZABUL","QALAT",2601047,1,16,554,570
"ZABUL","QALAT",2601047,2,12,533,545
"ZABUL","QALAT",2601001,1,49,118,167
"ZABUL","QALAT",2601001,2,50,132,182
"ZABUL","QALAT",2601001,3,58,133,191
"ZABUL","QALAT",2601001,4,29,116,145
"ZABUL","QALAT",2601003,2,39,130,169
"ZABUL","QALAT",2601008,1,73,50,123
"ZABUL","QALAT",2601008,2,36,49,85
"ZABUL","QALAT",2601046,1,64,41,105
"ZABUL","QALAT",2601002,8,8,332,340
"ZABUL","QALAT",2601004,1,100,449,549
"ZABUL","QALAT",2601004,2,68,435,503
"ZABUL","QALAT",2601004,3,84,446,530
"ZABUL","QALAT",2601004,4,32,523,555
"ZABUL","QALAT",2601004,5,45,424,469
"ZABUL","QALAT",2601045,2,8,465,473
"ZABUL","QALAT",2601045,3,65,380,445
"ZABUL","QALAT",2601003,1,41,113,154
"ZABUL","QALAT",2601048,2,2,20,22
"ZABUL","QALAT",2601006,2,23,490,513
"ZABUL","QALAT",2601006,3,26,510,536
"ZABUL","QALAT",2601006,4,16,530,546
"ZABUL","QALAT",2601006,5,18,133,151
"ZABUL","QALAT",2601006,6,18,420,438
"ZABUL","QALAT",2601005,1,71,400,471
"ZABUL","QALAT",2601007,4,23,431,454
"ZABUL","QALAT",2601007,5,90,317,407
"ZABUL","QALAT",2601045,1,28,526,554
"ZABUL","QALAT",2601047,3,11,530,541
"ZABUL","QALAT",2601009,1,43,421,464
"ZABUL","QALAT",2601009,2,46,486,532
"ZABUL","QALAT",2601009,3,29,404,433
"ZABUL","QALAT",2601009,5,3,88,91
"ZABUL","QALAT",2601002,5,28,122,150
"ZABUL","QALAT",2601002,6,38,374,412
"ZABUL","QALAT",2601002,7,1,450,451
"ZABUL","QALAT",2601005,4,5,404,409
"ZABUL","QALAT",2601006,1,13,138,151
"ZABUL","QALAT",2601005,2,94,429,523
"ZABUL","QALAT",2601005,3,63,467,530
"ZABUL","QALAT",2601048,1,3,30,33
"ZABUL","QALAT",2601002,1,46,183,229
"ZABUL","QALAT",2601005,5,9,108,117
"ZABUL","QALAT",2601005,6,21,422,443
"ZABUL","QALAT",2601002,3,34,510,544
"ZABUL","QALAT",2601002,4,29,286,315
"ZABUL","QALAT",2601002,2,58,173,231
"ZABUL","TARANK WA JA",2602030,1,26,25,51
"ZABUL","TARANK WA JA",2602030,2,19,39,58
"ZABUL","TARANK WA JA",2602029,5,9,505,514
"ZABUL","TARANK WA JA",2602027,3,36,485,521
"ZABUL","TARANK WA JA",2602027,2,7,504,511
"ZABUL","TARANK WA JA",2602028,1,18,24,42
"ZABUL","TARANK WA JA",2602030,3,4,14,18
"ZABUL","TARANK WA JA",2602027,1,4,514,518
"ZABUL","TARANK WA JA",2602029,2,23,514,537
"ZABUL","TARANK WA JA",2602029,3,15,316,331
"ZABUL","TARANK WA JA",2602028,2,15,25,40
"ZABUL","TARANK WA JA",2602052,2,6,5,11
"ZABUL","TARANK WA JA",2602026,1,10,23,33
"ZABUL","TARANK WA JA",2602026,2,17,30,47
"ZABUL","TARANK WA JA",2602029,4,5,510,515
"ZABUL","TARANK WA JA",2602026,4,7,40,47
"ZABUL","TARANK WA JA",2602029,1,19,228,247
"ZABUL","TARANK WA JA",2602051,1,18,15,33
"ZABUL","TARANK WA JA",2602026,3,67,85,152
"ZABUL","TARANK WA JA",2602052,1,35,15,50
"ZABUL","TARANK WA JA",2602051,2,14,4,18
"ZABUL","TARANK WA JA",2602026,6,10,29,39
"ZABUL","TARANK WA JA",2602026,5,17,51,68
"ZABUL","SHINKAI",2603033,1,20,493,513
"ZABUL","SHINKAI",2603031,4,8,212,220
"ZABUL","SHINKAI",2603033,2,7,524,531
"ZABUL","SHINKAI",2603031,1,21,205,226
"ZABUL","SHINKAI",2603031,3,19,147,166
"ZABUL","SHINKAI",2603033,5,40,537,577
"ZABUL","SHINKAI",2603033,4,20,459,479
"ZABUL","SHINKAI",2603033,6,12,467,479
"ZABUL","SHINKAI",2603031,2,22,327,349
"ZABUL","SHINKAI",2603033,3,59,472,531
"ZABUL","SHINKAI",2603033,9,19,493,512
"ZABUL","SHINKAI",2603033,10,4,360,364
"ZABUL","SHINKAI",2603056,1,7,32,39
"ZABUL","SHINKAI",2603033,7,6,413,419
"ZABUL","SHINKAI",2603056,2,3,23,26
"ZABUL","SHINKAI",2603053,1,4,85,89
"ZABUL","SHINKAI",2603053,2,7,60,67
"ZABUL","SHINKAI",2603033,8,11,510,521
"ZABUL","SHINKAI",2603053,3,2,37,39
"ZABUL","MIZAN",2604025,5,18,491,509
"ZABUL","MIZAN",2604025,3,33,526,559
"ZABUL","MIZAN",2604025,1,42,62,104
"ZABUL","MIZAN",2604025,2,20,45,65
"ZABUL","MIZAN",2604025,4,28,511,539
"ZABUL","MIZAN",2604025,6,17,316,333
"ZABUL","MIZAN",2604025,8,14,320,334
"ZABUL","MIZAN",2604025,7,21,382,403
"ZABUL","ARGHANDAB",2605018,6,9,585,594
"ZABUL","ARGHANDAB",2605018,4,10,571,581
"ZABUL","ARGHANDAB",2605018,7,0,589,589
"ZABUL","ARGHANDAB",2605018,9,15,565,580
"ZABUL","ARGHANDAB",2605018,3,8,572,580
"ZABUL","ARGHANDAB",2605018,11,10,580,590
"ZABUL","ARGHANDAB",2605018,5,5,581,586
"ZABUL","ARGHANDAB",2605018,2,45,216,261
"ZABUL","ARGHANDAB",2605018,1,34,65,99
"ZABUL","SHAH JOI",2606010,5,19,296,315
"ZABUL","SHAH JOI",2606010,6,11,229,240
"ZABUL","SHAH JOI",2606010,4,13,293,306
"ZABUL","SHAH JOI",2606013,1,30,280,310
"ZABUL","SHAH JOI",2606013,2,19,186,205
"ZABUL","SHAH JOI",2606013,3,12,564,576
"ZABUL","SHAH JOI",2606014,4,1,410,411
"ZABUL","SHAH JOI",2606010,2,9,63,72
"ZABUL","SHAH JOI",2606010,3,16,181,197
"ZABUL","SHAH JOI",2606012,2,75,511,586
"ZABUL","SHAH JOI",2606010,7,8,226,234
"ZABUL","SHAH JOI",2606012,3,30,540,570
"ZABUL","SHAH JOI",2606012,4,37,553,590
"ZABUL","SHAH JOI",2606015,2,38,211,249
"ZABUL","SHAH JOI",2606015,3,20,86,106
"ZABUL","SHAH JOI",2606014,3,13,5,18
"ZABUL","SHAH JOI",2606070,2,40,145,185
"ZABUL","SHAH JOI",2606013,4,6,569,575
"ZABUL","SHAH JOI",2606010,8,2,3,5
"ZABUL","SHAH JOI",2606013,5,17,155,172
"ZABUL","SHAH JOI",2606012,1,75,512,587
"ZABUL","SHAH JOI",2606015,1,50,195,245
"ZABUL","SHAH JOI",2606014,1,11,357,368
"ZABUL","SHAH JOI",2606014,2,7,491,498
"ZABUL","SHAH JOI",2606070,1,23,104,127
"ZABUL","SHAH JOI",2606011,2,22,152,174
"ZABUL","SHAH JOI",2606011,3,14,70,84
"ZABUL","SHAH JOI",2606010,1,12,108,120
"ZABUL","SHAH JOI",2606011,1,19,59,78
"ZABUL","SHAH JOI",2606011,4,8,33,41
"ZABUL","DAICHOPAN",2607024,2,0,353,353
"ZABUL","DAICHOPAN",2607024,3,0,550,550
"ZABUL","DAICHOPAN",2607022,1,7,519,526
"ZABUL","DAICHOPAN",2607023,1,11,488,499
"ZABUL","DAICHOPAN",2607024,1,16,38,54
"ZABUL","DAICHOPAN",2607022,5,0,330,330
"ZABUL","DAICHOPAN",2607022,2,0,600,600
"ZABUL","DAICHOPAN",2607023,2,0,600,600
"ZABUL","DAICHOPAN",2607024,4,0,600,600
"ZABUL","DAICHOPAN",2607022,4,3,216,219
"ZABUL","DAICHOPAN",2607022,3,4,490,494
"ZABUL","ATGHAR",2608035,1,14,565,579
"ZABUL","ATGHAR",2608035,2,5,575,580
"ZABUL","ATGHAR",2608035,5,0,580,580
"ZABUL","ATGHAR",2608035,3,6,570,576
"ZABUL","ATGHAR",2608073,3,0,500,500
"ZABUL","ATGHAR",2608073,2,1,510,511
"ZABUL","ATGHAR",2608035,6,0,550,550
"ZABUL","ATGHAR",2608035,4,0,560,560
"ZABUL","ATGHAR",2608073,1,6,500,506
"ZABUL","NAW BAHAR",2609042,3,16,320,336
"ZABUL","NAW BAHAR",2609043,1,17,26,43
"ZABUL","NAW BAHAR",2609042,2,22,523,545
"ZABUL","NAW BAHAR",2609042,1,22,523,545
"ZABUL","SHEMEL ZAYI",2610040,1,197,363,560
"ZABUL","SHEMEL ZAYI",2610038,1,25,31,56
"ZABUL","SHEMEL ZAYI",2610036,3,6,29,35
"ZABUL","SHEMEL ZAYI",2610040,2,204,381,585
"ZABUL","SHEMEL ZAYI",2610036,2,7,27,34
"ZABUL","SHEMEL ZAYI",2610041,4,3,12,15
"ZABUL","SHEMEL ZAYI",2610039,1,3,22,25
"ZABUL","SHEMEL ZAYI",2610036,1,5,30,35
"ZABUL","SHEMEL ZAYI",2610041,2,8,10,18
"ZABUL","SHEMEL ZAYI",2610036,5,0,10,10
"ZABUL","SHEMEL ZAYI",2610039,2,2,33,35
"ZABUL","SHEMEL ZAYI",2610036,6,1,10,11
"ZABUL","SHEMEL ZAYI",2610041,1,2,22,24
"ZABUL","SHEMEL ZAYI",2610041,3,4,14,18
"ZABUL","SHEMEL ZAYI",2610036,4,2,16,18
"KANDAHAR","KANDAHAR",2701036,1,158,249,407
"KANDAHAR","KANDAHAR",2701040,8,21,122,143
"KANDAHAR","KANDAHAR",2701023,8,16,126,142
"KANDAHAR","KANDAHAR",2701023,9,59,473,532
"KANDAHAR","KANDAHAR",2701023,6,28,157,185
"KANDAHAR","KANDAHAR",2701023,7,32,157,189
"KANDAHAR","KANDAHAR",2701040,2,25,155,180
"KANDAHAR","KANDAHAR",2701040,3,10,73,83
"KANDAHAR","KANDAHAR",2701022,4,237,323,560
"KANDAHAR","KANDAHAR",2701022,5,239,48,287
"KANDAHAR","KANDAHAR",2701040,6,34,257,291
"KANDAHAR","KANDAHAR",2701040,7,22,159,181
"KANDAHAR","KANDAHAR",2701023,4,62,521,583
"KANDAHAR","KANDAHAR",2701040,9,29,77,106
"KANDAHAR","KANDAHAR",2701040,10,9,61,70
"KANDAHAR","KANDAHAR",2701040,11,5,8,13
"KANDAHAR","KANDAHAR",2701040,12,10,7,17
"KANDAHAR","KANDAHAR",2701045,6,74,195,269
"KANDAHAR","KANDAHAR",2701045,7,130,416,546
"KANDAHAR","KANDAHAR",2701045,8,14,45,59
"KANDAHAR","KANDAHAR",2701045,9,11,25,36
"KANDAHAR","KANDAHAR",2701040,4,32,154,186
"KANDAHAR","KANDAHAR",2701040,5,53,226,279
"KANDAHAR","KANDAHAR",2701023,2,71,507,578
"KANDAHAR","KANDAHAR",2701023,3,72,522,594
"KANDAHAR","KANDAHAR",2701062,3,8,27,35
"KANDAHAR","KANDAHAR",2701023,5,83,408,491
"KANDAHAR","KANDAHAR",2701045,3,44,161,205
"KANDAHAR","KANDAHAR",2701045,4,15,68,83
"KANDAHAR","KANDAHAR",2701045,5,46,188,234
"KANDAHAR","KANDAHAR",2701062,8,12,6,18
"KANDAHAR","KANDAHAR",2701038,1,339,240,579
"KANDAHAR","KANDAHAR",2701038,2,350,229,579
"KANDAHAR","KANDAHAR",2701038,3,227,200,427
"KANDAHAR","KANDAHAR",2701045,10,11,19,30
"KANDAHAR","KANDAHAR",2701045,11,7,10,17
"KANDAHAR","KANDAHAR",2701062,1,22,50,72
"KANDAHAR","KANDAHAR",2701062,2,10,23,33
"KANDAHAR","KANDAHAR",2701034,5,86,30,116
"KANDAHAR","KANDAHAR",2701062,4,10,24,34
"KANDAHAR","KANDAHAR",2701062,5,35,63,98
"KANDAHAR","KANDAHAR",2701062,6,10,5,15
"KANDAHAR","KANDAHAR",2701062,7,9,3,12
"KANDAHAR","KANDAHAR",2701022,3,223,335,558
"KANDAHAR","KANDAHAR",2701056,5,1,7,8
"KANDAHAR","KANDAHAR",2701056,6,2,6,8
"KANDAHAR","KANDAHAR",2701022,6,225,64,289
"KANDAHAR","KANDAHAR",2701022,7,94,122,216
"KANDAHAR","KANDAHAR",2701022,8,12,20,32
"KANDAHAR","KANDAHAR",2701023,1,93,488,581
"KANDAHAR","KANDAHAR",2701029,2,51,209,260
"KANDAHAR","KANDAHAR",2701029,3,15,88,103
"KANDAHAR","KANDAHAR",2701029,4,27,134,161
"KANDAHAR","KANDAHAR",2701029,5,6,45,51
"KANDAHAR","KANDAHAR",2701029,6,7,21,28
"KANDAHAR","KANDAHAR",2701029,7,0,8,8
"KANDAHAR","KANDAHAR",2701029,8,4,1,5
"KANDAHAR","KANDAHAR",2701029,9,2,12,14
"KANDAHAR","KANDAHAR",2701029,10,4,3,7
"KANDAHAR","KANDAHAR",2701029,11,15,20,35
"KANDAHAR","KANDAHAR",2701029,12,8,8,16
"KANDAHAR","KANDAHAR",2701029,13,1,4,5
"KANDAHAR","KANDAHAR",2701018,1,34,309,343
"KANDAHAR","KANDAHAR",2701018,2,32,177,209
"KANDAHAR","KANDAHAR",2701018,3,20,96,116
"KANDAHAR","KANDAHAR",2701018,4,12,87,99
"KANDAHAR","KANDAHAR",2701018,5,10,247,257
"KANDAHAR","KANDAHAR",2701018,6,14,128,142
"KANDAHAR","KANDAHAR",2701018,7,44,182,226
"KANDAHAR","KANDAHAR",2701018,8,36,206,242
"KANDAHAR","KANDAHAR",2701018,9,17,17,34
"KANDAHAR","KANDAHAR",2701018,10,10,22,32
"KANDAHAR","KANDAHAR",2701018,11,5,20,25
"KANDAHAR","KANDAHAR",2701018,12,2,47,49
"KANDAHAR","KANDAHAR",2701018,13,5,15,20
"KANDAHAR","KANDAHAR",2701034,1,4,21,25
"KANDAHAR","KANDAHAR",2701034,2,163,44,207
"KANDAHAR","KANDAHAR",2701034,3,167,49,216
"KANDAHAR","KANDAHAR",2701034,4,121,39,160
"KANDAHAR","KANDAHAR",2701034,6,68,15,83
"KANDAHAR","KANDAHAR",2701034,7,272,310,582
"KANDAHAR","KANDAHAR",2701022,1,295,268,563
"KANDAHAR","KANDAHAR",2701022,2,241,309,550
"KANDAHAR","KANDAHAR",2701050,2,16,11,27
"KANDAHAR","KANDAHAR",2701050,3,18,8,26
"KANDAHAR","KANDAHAR",2701050,4,11,16,27
"KANDAHAR","KANDAHAR",2701050,5,14,6,20
"KANDAHAR","KANDAHAR",2701059,1,12,115,127
"KANDAHAR","KANDAHAR",2701059,2,24,164,188
"KANDAHAR","KANDAHAR",2701059,3,14,104,118
"KANDAHAR","KANDAHAR",2701059,4,11,51,62
"KANDAHAR","KANDAHAR",2701059,5,8,63,71
"KANDAHAR","KANDAHAR",2701059,6,3,14,17
"KANDAHAR","KANDAHAR",2701058,1,33,329,362
"KANDAHAR","KANDAHAR",2701058,2,32,205,237
"KANDAHAR","KANDAHAR",2701058,3,21,125,146
"KANDAHAR","KANDAHAR",2701058,4,6,24,30
"KANDAHAR","KANDAHAR",2701058,5,6,12,18
"KANDAHAR","KANDAHAR",2701058,6,7,13,20
"KANDAHAR","KANDAHAR",2701023,10,52,403,455
"KANDAHAR","KANDAHAR",2701040,1,33,103,136
"KANDAHAR","KANDAHAR",2701005,3,38,124,162
"KANDAHAR","KANDAHAR",2701005,4,32,110,142
"KANDAHAR","KANDAHAR",2701005,5,18,59,77
"KANDAHAR","KANDAHAR",2701005,6,22,75,97
"KANDAHAR","KANDAHAR",2701003,1,185,384,569
"KANDAHAR","KANDAHAR",2701003,2,135,182,317
"KANDAHAR","KANDAHAR",2701003,3,84,183,267
"KANDAHAR","KANDAHAR",2701003,4,74,122,196
"KANDAHAR","KANDAHAR",2701003,5,31,59,90
"KANDAHAR","KANDAHAR",2701003,6,25,48,73
"KANDAHAR","KANDAHAR",2701003,7,39,39,78
"KANDAHAR","KANDAHAR",2701003,8,29,24,53
"KANDAHAR","KANDAHAR",2701036,2,175,307,482
"KANDAHAR","KANDAHAR",2701036,3,164,307,471
"KANDAHAR","KANDAHAR",2701036,4,52,129,181
"KANDAHAR","KANDAHAR",2701036,5,55,70,125
"KANDAHAR","KANDAHAR",2701036,6,44,63,107
"KANDAHAR","KANDAHAR",2701036,7,49,20,69
"KANDAHAR","KANDAHAR",2701042,8,20,530,550
"KANDAHAR","KANDAHAR",2701042,9,75,105,180
"KANDAHAR","KANDAHAR",2701042,10,40,560,600
"KANDAHAR","KANDAHAR",2701050,1,31,19,50
"KANDAHAR","KANDAHAR",2701056,3,20,118,138
"KANDAHAR","KANDAHAR",2701056,4,5,9,14
"KANDAHAR","KANDAHAR",2701030,4,23,84,107
"KANDAHAR","KANDAHAR",2701030,5,4,18,22
"KANDAHAR","KANDAHAR",2701056,7,4,16,20
"KANDAHAR","KANDAHAR",2701056,8,2,2,4
"KANDAHAR","KANDAHAR",2701056,9,2,3,5
"KANDAHAR","KANDAHAR",2701056,10,5,5,10
"KANDAHAR","KANDAHAR",2701056,11,6,12,18
"KANDAHAR","KANDAHAR",2701056,12,1,4,5
"KANDAHAR","KANDAHAR",2701045,1,119,427,546
"KANDAHAR","KANDAHAR",2701045,2,29,182,211
"KANDAHAR","KANDAHAR",2701060,2,93,396,489
"KANDAHAR","KANDAHAR",2701060,3,113,432,545
"KANDAHAR","KANDAHAR",2701060,4,19,81,100
"KANDAHAR","KANDAHAR",2701060,5,19,255,274
"KANDAHAR","KANDAHAR",2701060,6,14,80,94
"KANDAHAR","KANDAHAR",2701006,1,99,295,394
"KANDAHAR","KANDAHAR",2701006,2,57,244,301
"KANDAHAR","KANDAHAR",2701006,3,45,141,186
"KANDAHAR","KANDAHAR",2701006,4,33,127,160
"KANDAHAR","KANDAHAR",2701006,5,1,6,7
"KANDAHAR","KANDAHAR",2701006,6,0,3,3
"KANDAHAR","KANDAHAR",2701006,7,4,7,11
"KANDAHAR","KANDAHAR",2701010,1,296,297,593
"KANDAHAR","KANDAHAR",2701010,2,67,42,109
"KANDAHAR","KANDAHAR",2701010,3,79,65,144
"KANDAHAR","KANDAHAR",2701010,4,106,62,168
"KANDAHAR","KANDAHAR",2701010,5,70,32,102
"KANDAHAR","KANDAHAR",2701010,6,37,59,96
"KANDAHAR","KANDAHAR",2701010,7,16,17,33
"KANDAHAR","KANDAHAR",2701010,8,44,120,164
"KANDAHAR","KANDAHAR",2701038,4,222,173,395
"KANDAHAR","KANDAHAR",2701038,5,183,84,267
"KANDAHAR","KANDAHAR",2701038,6,49,32,81
"KANDAHAR","KANDAHAR",2701038,7,172,38,210
"KANDAHAR","KANDAHAR",2701036,8,36,43,79
"KANDAHAR","KANDAHAR",2701036,9,24,6,30
"KANDAHAR","KANDAHAR",2701056,1,30,253,283
"KANDAHAR","KANDAHAR",2701056,2,33,194,227
"KANDAHAR","KANDAHAR",2701037,2,18,9,27
"KANDAHAR","KANDAHAR",2701037,3,25,15,40
"KANDAHAR","KANDAHAR",2701037,4,6,6,12
"KANDAHAR","KANDAHAR",2701037,5,9,6,15
"KANDAHAR","KANDAHAR",2701037,6,8,5,13
"KANDAHAR","KANDAHAR",2701037,7,45,31,76
"KANDAHAR","KANDAHAR",2701054,1,17,89,106
"KANDAHAR","KANDAHAR",2701054,2,16,55,71
"KANDAHAR","KANDAHAR",2701054,3,10,37,47
"KANDAHAR","KANDAHAR",2701054,4,3,26,29
"KANDAHAR","KANDAHAR",2701054,5,9,22,31
"KANDAHAR","KANDAHAR",2701054,6,9,19,28
"KANDAHAR","KANDAHAR",2701054,7,1,10,11
"KANDAHAR","KANDAHAR",2701054,8,4,4,8
"KANDAHAR","KANDAHAR",2701054,9,4,6,10
"KANDAHAR","KANDAHAR",2701054,10,7,28,35
"KANDAHAR","KANDAHAR",2701054,11,0,45,45
"KANDAHAR","KANDAHAR",2701061,1,33,97,130
"KANDAHAR","KANDAHAR",2701061,2,44,124,168
"KANDAHAR","KANDAHAR",2701061,3,31,72,103
"KANDAHAR","KANDAHAR",2701061,4,12,22,34
"KANDAHAR","KANDAHAR",2701061,5,5,1,6
"KANDAHAR","KANDAHAR",2701063,1,31,111,142
"KANDAHAR","KANDAHAR",2701063,2,48,142,190
"KANDAHAR","KANDAHAR",2701063,3,28,20,48
"KANDAHAR","KANDAHAR",2701063,4,2,582,584
"KANDAHAR","KANDAHAR",2701063,5,9,99,108
"KANDAHAR","KANDAHAR",2701063,6,14,542,556
"KANDAHAR","KANDAHAR",2701063,7,18,440,458
"KANDAHAR","KANDAHAR",2701063,8,121,51,172
"KANDAHAR","KANDAHAR",2701042,1,175,381,556
"KANDAHAR","KANDAHAR",2701042,2,235,323,558
"KANDAHAR","KANDAHAR",2701042,3,213,348,561
"KANDAHAR","KANDAHAR",2701042,4,164,201,365
"KANDAHAR","KANDAHAR",2701042,5,107,187,294
"KANDAHAR","KANDAHAR",2701042,6,88,129,217
"KANDAHAR","KANDAHAR",2701042,7,15,570,585
"KANDAHAR","KANDAHAR",2701033,5,29,64,93
"KANDAHAR","KANDAHAR",2701033,6,16,43,59
"KANDAHAR","KANDAHAR",2701033,7,13,35,48
"KANDAHAR","KANDAHAR",2701030,1,72,218,290
"KANDAHAR","KANDAHAR",2701030,2,27,70,97
"KANDAHAR","KANDAHAR",2701030,3,13,41,54
"KANDAHAR","KANDAHAR",2701007,1,8,181,189
"KANDAHAR","KANDAHAR",2701007,2,49,75,124
"KANDAHAR","KANDAHAR",2701007,3,2,229,231
"KANDAHAR","KANDAHAR",2701030,6,24,63,87
"KANDAHAR","KANDAHAR",2701030,7,45,143,188
"KANDAHAR","KANDAHAR",2701030,8,33,94,127
"KANDAHAR","KANDAHAR",2701030,9,54,204,258
"KANDAHAR","KANDAHAR",2701030,10,128,402,530
"KANDAHAR","KANDAHAR",2701012,1,2,20,22
"KANDAHAR","KANDAHAR",2701012,2,3,11,14
"KANDAHAR","KANDAHAR",2701012,3,3,33,36
"KANDAHAR","KANDAHAR",2701012,4,3,16,19
"KANDAHAR","KANDAHAR",2701012,5,7,20,27
"KANDAHAR","KANDAHAR",2701012,6,18,54,72
"KANDAHAR","KANDAHAR",2701012,7,4,5,9
"KANDAHAR","KANDAHAR",2701014,1,85,451,536
"KANDAHAR","KANDAHAR",2701005,1,23,84,107
"KANDAHAR","KANDAHAR",2701005,2,28,138,166
"KANDAHAR","KANDAHAR",2701014,4,115,196,311
"KANDAHAR","KANDAHAR",2701014,5,58,198,256
"KANDAHAR","KANDAHAR",2701014,6,46,135,181
"KANDAHAR","KANDAHAR",2701035,1,113,55,168
"KANDAHAR","KANDAHAR",2701035,2,117,54,171
"KANDAHAR","KANDAHAR",2701035,3,36,72,108
"KANDAHAR","KANDAHAR",2701035,4,101,83,184
"KANDAHAR","KANDAHAR",2701035,5,301,125,426
"KANDAHAR","KANDAHAR",2701035,6,104,76,180
"KANDAHAR","KANDAHAR",2701035,7,323,262,585
"KANDAHAR","KANDAHAR",2701003,9,25,31,56
"KANDAHAR","KANDAHAR",2701003,10,12,19,31
"KANDAHAR","KANDAHAR",2701033,1,34,89,123
"KANDAHAR","KANDAHAR",2701033,2,44,127,171
"KANDAHAR","KANDAHAR",2701033,3,99,224,323
"KANDAHAR","KANDAHAR",2701033,4,33,92,125
"KANDAHAR","KANDAHAR",2701038,8,188,18,206
"KANDAHAR","KANDAHAR",2701038,9,160,33,193
"KANDAHAR","KANDAHAR",2701038,10,175,34,209
"KANDAHAR","KANDAHAR",2701037,1,294,275,569
"KANDAHAR","KANDAHAR",2701009,8,90,234,324
"KANDAHAR","KANDAHAR",2701025,1,91,488,579
"KANDAHAR","KANDAHAR",2701025,2,12,27,39
"KANDAHAR","KANDAHAR",2701025,3,18,37,55
"KANDAHAR","KANDAHAR",2701025,4,2,44,46
"KANDAHAR","KANDAHAR",2701025,5,9,21,30
"KANDAHAR","KANDAHAR",2701025,6,8,32,40
"KANDAHAR","KANDAHAR",2701025,7,7,12,19
"KANDAHAR","KANDAHAR",2701025,8,2,30,32
"KANDAHAR","KANDAHAR",2701029,1,64,253,317
"KANDAHAR","KANDAHAR",2701007,8,1,11,12
"KANDAHAR","KANDAHAR",2701007,9,4,24,28
"KANDAHAR","KANDAHAR",2701007,10,17,11,28
"KANDAHAR","KANDAHAR",2701060,1,131,407,538
"KANDAHAR","KANDAHAR",2701009,6,9,39,48
"KANDAHAR","KANDAHAR",2701009,7,21,32,53
"KANDAHAR","KANDAHAR",2701048,4,28,171,199
"KANDAHAR","KANDAHAR",2701048,1,20,59,79
"KANDAHAR","KANDAHAR",2701014,2,112,149,261
"KANDAHAR","KANDAHAR",2701014,3,17,313,330
"KANDAHAR","KANDAHAR",2701009,3,26,57,83
"KANDAHAR","KANDAHAR",2701048,5,35,191,226
"KANDAHAR","KANDAHAR",2701048,6,65,320,385
"KANDAHAR","KANDAHAR",2701009,2,32,61,93
"KANDAHAR","KANDAHAR",2701048,3,14,108,122
"KANDAHAR","KANDAHAR",2701009,4,21,49,70
"KANDAHAR","KANDAHAR",2701009,5,27,42,69
"KANDAHAR","KANDAHAR",2701048,2,3,49,52
"KANDAHAR","KANDAHAR",2701007,7,9,8,17
"KANDAHAR","KANDAHAR",2701007,4,10,2,12
"KANDAHAR","KANDAHAR",2701007,5,20,500,520
"KANDAHAR","KANDAHAR",2701007,6,10,324,334
"KANDAHAR","KANDAHAR",2701009,1,189,381,570
"KANDAHAR","ARGHANDAB",2702099,4,1,0,1
"KANDAHAR","ARGHANDAB",2702107,1,76,15,91
"KANDAHAR","ARGHANDAB",2702107,3,52,38,90
"KANDAHAR","ARGHANDAB",2702111,2,46,72,118
"KANDAHAR","ARGHANDAB",2702107,2,56,16,72
"KANDAHAR","ARGHANDAB",2702112,2,70,42,112
"KANDAHAR","ARGHANDAB",2702111,1,40,162,202
"KANDAHAR","ARGHANDAB",2702100,2,90,350,440
"KANDAHAR","ARGHANDAB",2702112,1,114,63,177
"KANDAHAR","ARGHANDAB",2702111,3,12,18,30
"KANDAHAR","ARGHANDAB",2702100,1,101,350,451
"KANDAHAR","ARGHANDAB",2702101,1,53,102,155
"KANDAHAR","ARGHANDAB",2702100,3,3,16,19
"KANDAHAR","ARGHANDAB",2702115,2,55,270,325
"KANDAHAR","ARGHANDAB",2702115,3,60,190,250
"KANDAHAR","ARGHANDAB",2702114,1,19,46,65
"KANDAHAR","ARGHANDAB",2702099,1,64,91,155
"KANDAHAR","ARGHANDAB",2702104,1,26,12,38
"KANDAHAR","ARGHANDAB",2702109,1,45,41,86
"KANDAHAR","ARGHANDAB",2702105,2,57,220,277
"KANDAHAR","ARGHANDAB",2702109,3,1,3,4
"KANDAHAR","ARGHANDAB",2702105,1,80,270,350
"KANDAHAR","ARGHANDAB",2702101,2,47,86,133
"KANDAHAR","ARGHANDAB",2702101,3,0,4,4
"KANDAHAR","ARGHANDAB",2702103,2,42,79,121
"KANDAHAR","ARGHANDAB",2702103,3,25,62,87
"KANDAHAR","ARGHANDAB",2702110,2,51,336,387
"KANDAHAR","ARGHANDAB",2702110,3,37,220,257
"KANDAHAR","ARGHANDAB",2702113,5,2,4,6
"KANDAHAR","ARGHANDAB",2702114,2,15,38,53
"KANDAHAR","ARGHANDAB",2702102,2,17,24,41
"KANDAHAR","ARGHANDAB",2702104,2,73,10,83
"KANDAHAR","ARGHANDAB",2702104,3,30,2,32
"KANDAHAR","ARGHANDAB",2702102,1,44,30,74
"KANDAHAR","ARGHANDAB",2702115,1,87,290,377
"KANDAHAR","ARGHANDAB",2702102,3,9,5,14
"KANDAHAR","ARGHANDAB",2702108,1,268,39,307
"KANDAHAR","ARGHANDAB",2702103,1,34,39,73
"KANDAHAR","ARGHANDAB",2702109,2,54,49,103
"KANDAHAR","ARGHANDAB",2702108,3,208,150,358
"KANDAHAR","ARGHANDAB",2702110,1,53,334,387
"KANDAHAR","ARGHANDAB",2702113,4,3,4,7
"KANDAHAR","ARGHANDAB",2702113,1,10,44,54
"KANDAHAR","ARGHANDAB",2702106,1,45,191,236
"KANDAHAR","ARGHANDAB",2702106,2,32,228,260
"KANDAHAR","ARGHANDAB",2702106,3,13,251,264
"KANDAHAR","ARGHANDAB",2702113,3,36,80,116
"KANDAHAR","ARGHANDAB",2702108,2,262,322,584
"KANDAHAR","ARGHANDAB",2702113,2,45,61,106
"KANDAHAR","DAMAN",2703086,1,85,214,299
"KANDAHAR","DAMAN",2703068,4,7,492,499
"KANDAHAR","DAMAN",2703075,2,4,3,7
"KANDAHAR","DAMAN",2703084,5,251,249,500
"KANDAHAR","DAMAN",2703068,3,21,553,574
"KANDAHAR","DAMAN",2703084,4,6,44,50
"KANDAHAR","DAMAN",2703079,1,31,503,534
"KANDAHAR","DAMAN",2703068,2,13,515,528
"KANDAHAR","DAMAN",2703082,2,24,120,144
"KANDAHAR","DAMAN",2703086,3,36,28,64
"KANDAHAR","DAMAN",2703084,1,18,31,49
"KANDAHAR","DAMAN",2703075,3,11,15,26
"KANDAHAR","DAMAN",2703086,2,76,259,335
"KANDAHAR","DAMAN",2703083,5,10,573,583
"KANDAHAR","DAMAN",2703078,1,61,457,518
"KANDAHAR","DAMAN",2703078,2,26,99,125
"KANDAHAR","DAMAN",2703078,3,17,27,44
"KANDAHAR","DAMAN",2703078,4,24,35,59
"KANDAHAR","DAMAN",2703077,3,41,340,381
"KANDAHAR","DAMAN",2703081,1,0,2,2
"KANDAHAR","DAMAN",2703079,2,23,533,556
"KANDAHAR","DAMAN",2703079,3,17,513,530
"KANDAHAR","DAMAN",2703079,4,18,551,569
"KANDAHAR","DAMAN",2703079,5,9,493,502
"KANDAHAR","DAMAN",2703084,2,23,6,29
"KANDAHAR","DAMAN",2703084,3,11,16,27
"KANDAHAR","DAMAN",2703085,2,9,49,58
"KANDAHAR","DAMAN",2703085,3,7,10,17
"KANDAHAR","DAMAN",2703068,1,13,537,550
"KANDAHAR","DAMAN",2703074,1,14,531,545
"KANDAHAR","DAMAN",2703074,2,21,534,555
"KANDAHAR","DAMAN",2703070,5,101,260,361
"KANDAHAR","DAMAN",2703077,1,73,343,416
"KANDAHAR","DAMAN",2703077,2,49,349,398
"KANDAHAR","DAMAN",2703087,1,114,424,538
"KANDAHAR","DAMAN",2703074,3,13,310,323
"KANDAHAR","DAMAN",2703076,1,6,591,597
"KANDAHAR","DAMAN",2703076,3,6,583,589
"KANDAHAR","DAMAN",2703082,1,28,137,165
"KANDAHAR","DAMAN",2703083,4,6,563,569
"KANDAHAR","DAMAN",2703070,1,6,27,33
"KANDAHAR","DAMAN",2703082,3,52,105,157
"KANDAHAR","DAMAN",2703075,1,16,22,38
"KANDAHAR","DAMAN",2703070,4,11,56,67
"KANDAHAR","DAMAN",2703081,3,3,17,20
"KANDAHAR","DAMAN",2703070,6,240,299,539
"KANDAHAR","DAMAN",2703078,5,14,12,26
"KANDAHAR","DAMAN",2703070,7,228,302,530
"KANDAHAR","DAMAN",2703072,3,157,437,594
"KANDAHAR","DAMAN",2703083,1,21,35,56
"KANDAHAR","DAMAN",2703076,2,79,401,480
"KANDAHAR","DAMAN",2703083,3,9,577,586
"KANDAHAR","DAMAN",2703088,2,30,530,560
"KANDAHAR","DAMAN",2703085,1,13,56,69
"KANDAHAR","DAMAN",2703070,2,8,37,45
"KANDAHAR","DAMAN",2703070,3,18,31,49
"KANDAHAR","DAMAN",2703080,4,23,517,540
"KANDAHAR","DAMAN",2703087,2,119,481,600
"KANDAHAR","DAMAN",2703088,1,19,529,548
"KANDAHAR","DAMAN",2703083,2,5,537,542
"KANDAHAR","DAMAN",2703073,3,9,531,540
"KANDAHAR","DAMAN",2703088,3,18,18,36
"KANDAHAR","DAMAN",2703080,1,24,511,535
"KANDAHAR","DAMAN",2703080,3,31,537,568
"KANDAHAR","DAMAN",2703080,2,12,549,561
"KANDAHAR","DAMAN",2703072,2,84,505,589
"KANDAHAR","DAMAN",2703073,1,17,512,529
"KANDAHAR","DAMAN",2703073,2,21,497,518
"KANDAHAR","DAMAN",2703066,1,29,49,78
"KANDAHAR","DAMAN",2703072,1,11,559,570
"KANDAHAR","PANJWAYEE",2704174,2,0,3,3
"KANDAHAR","PANJWAYEE",2704188,3,27,70,97
"KANDAHAR","PANJWAYEE",2704193,5,5,583,588
"KANDAHAR","PANJWAYEE",2704188,4,47,51,98
"KANDAHAR","PANJWAYEE",2704175,2,9,39,48
"KANDAHAR","PANJWAYEE",2704193,4,5,579,584
"KANDAHAR","PANJWAYEE",2704192,6,70,233,303
"KANDAHAR","PANJWAYEE",2704188,1,36,125,161
"KANDAHAR","PANJWAYEE",2704193,6,0,312,312
"KANDAHAR","PANJWAYEE",2704174,1,76,66,142
"KANDAHAR","PANJWAYEE",2704187,2,69,80,149
"KANDAHAR","PANJWAYEE",2704187,3,25,49,74
"KANDAHAR","PANJWAYEE",2704175,1,41,435,476
"KANDAHAR","PANJWAYEE",2704185,2,121,144,265
"KANDAHAR","PANJWAYEE",2704185,3,23,90,113
"KANDAHAR","PANJWAYEE",2704177,1,39,509,548
"KANDAHAR","PANJWAYEE",2704177,2,33,526,559
"KANDAHAR","PANJWAYEE",2704188,2,53,97,150
"KANDAHAR","PANJWAYEE",2704195,2,8,424,432
"KANDAHAR","PANJWAYEE",2704195,3,12,511,523
"KANDAHAR","PANJWAYEE",2704191,1,66,288,354
"KANDAHAR","PANJWAYEE",2704191,2,63,242,305
"KANDAHAR","PANJWAYEE",2704187,1,40,99,139
"KANDAHAR","PANJWAYEE",2704191,4,71,311,382
"KANDAHAR","PANJWAYEE",2704191,5,57,262,319
"KANDAHAR","PANJWAYEE",2704185,1,132,141,273
"KANDAHAR","PANJWAYEE",2704193,1,34,545,579
"KANDAHAR","PANJWAYEE",2704193,2,15,511,526
"KANDAHAR","PANJWAYEE",2704193,3,3,578,581
"KANDAHAR","PANJWAYEE",2704179,4,49,36,85
"KANDAHAR","PANJWAYEE",2704184,1,50,104,154
"KANDAHAR","PANJWAYEE",2704184,2,66,150,216
"KANDAHAR","PANJWAYEE",2704193,7,1,553,554
"KANDAHAR","PANJWAYEE",2704193,8,10,575,585
"KANDAHAR","PANJWAYEE",2704176,1,18,494,512
"KANDAHAR","PANJWAYEE",2704191,3,98,213,311
"KANDAHAR","PANJWAYEE",2704190,2,14,535,549
"KANDAHAR","PANJWAYEE",2704194,1,114,90,204
"KANDAHAR","PANJWAYEE",2704194,2,75,44,119
"KANDAHAR","PANJWAYEE",2704194,3,49,27,76
"KANDAHAR","PANJWAYEE",2704194,4,65,30,95
"KANDAHAR","PANJWAYEE",2704192,5,68,372,440
"KANDAHAR","PANJWAYEE",2704179,3,47,36,83
"KANDAHAR","PANJWAYEE",2704192,7,180,320,500
"KANDAHAR","PANJWAYEE",2704195,1,21,534,555
"KANDAHAR","PANJWAYEE",2704183,1,15,56,71
"KANDAHAR","PANJWAYEE",2704183,2,15,100,115
"KANDAHAR","PANJWAYEE",2704180,1,44,64,108
"KANDAHAR","PANJWAYEE",2704176,2,8,386,394
"KANDAHAR","PANJWAYEE",2704186,1,41,26,67
"KANDAHAR","PANJWAYEE",2704186,2,31,8,39
"KANDAHAR","PANJWAYEE",2704186,3,37,22,59
"KANDAHAR","PANJWAYEE",2704186,4,14,2,16
"KANDAHAR","PANJWAYEE",2704179,1,72,46,118
"KANDAHAR","PANJWAYEE",2704179,2,82,56,138
"KANDAHAR","PANJWAYEE",2704178,3,11,405,416
"KANDAHAR","PANJWAYEE",2704181,2,22,506,528
"KANDAHAR","PANJWAYEE",2704177,3,17,122,139
"KANDAHAR","PANJWAYEE",2704173,1,69,439,508
"KANDAHAR","PANJWAYEE",2704184,3,52,72,124
"KANDAHAR","PANJWAYEE",2704182,1,110,335,445
"KANDAHAR","PANJWAYEE",2704182,2,121,412,533
"KANDAHAR","PANJWAYEE",2704190,1,4,401,405
"KANDAHAR","PANJWAYEE",2704189,4,67,123,190
"KANDAHAR","PANJWAYEE",2704192,1,31,548,579
"KANDAHAR","PANJWAYEE",2704192,2,112,340,452
"KANDAHAR","PANJWAYEE",2704192,3,25,342,367
"KANDAHAR","PANJWAYEE",2704192,4,41,488,529
"KANDAHAR","PANJWAYEE",2704180,3,66,47,113
"KANDAHAR","PANJWAYEE",2704178,4,16,221,237
"KANDAHAR","PANJWAYEE",2704181,3,29,159,188
"KANDAHAR","PANJWAYEE",2704180,2,31,58,89
"KANDAHAR","PANJWAYEE",2704178,2,14,431,445
"KANDAHAR","PANJWAYEE",2704173,2,26,466,492
"KANDAHAR","PANJWAYEE",2704173,3,32,409,441
"KANDAHAR","PANJWAYEE",2704178,1,11,525,536
"KANDAHAR","PANJWAYEE",2704173,4,40,110,150
"KANDAHAR","PANJWAYEE",2704180,4,62,61,123
"KANDAHAR","PANJWAYEE",2704189,2,26,381,407
"KANDAHAR","PANJWAYEE",2704181,1,78,400,478
"KANDAHAR","PANJWAYEE",2704189,1,30,473,503
"KANDAHAR","ZHIRE",2705168,6,8,165,173
"KANDAHAR","ZHIRE",2705172,3,4,94,98
"KANDAHAR","ZHIRE",2705168,5,38,372,410
"KANDAHAR","ZHIRE",2705159,1,106,112,218
"KANDAHAR","ZHIRE",2705159,2,140,151,291
"KANDAHAR","ZHIRE",2705168,7,11,193,204
"KANDAHAR","ZHIRE",2705168,8,6,172,178
"KANDAHAR","ZHIRE",2705161,3,32,21,53
"KANDAHAR","ZHIRE",2705153,1,15,421,436
"KANDAHAR","ZHIRE",2705153,2,19,469,488
"KANDAHAR","ZHIRE",2705172,1,10,27,37
"KANDAHAR","ZHIRE",2705172,2,9,15,24
"KANDAHAR","ZHIRE",2705156,1,27,57,84
"KANDAHAR","ZHIRE",2705165,1,99,210,309
"KANDAHAR","ZHIRE",2705172,4,37,193,230
"KANDAHAR","ZHIRE",2705149,3,13,138,151
"KANDAHAR","ZHIRE",2705149,4,24,137,161
"KANDAHAR","ZHIRE",2705157,1,6,10,16
"KANDAHAR","ZHIRE",2705170,4,13,153,166
"KANDAHAR","ZHIRE",2705170,5,18,145,163
"KANDAHAR","ZHIRE",2705170,6,14,135,149
"KANDAHAR","ZHIRE",2705168,4,12,494,506
"KANDAHAR","ZHIRE",2705161,2,49,46,95
"KANDAHAR","ZHIRE",2705167,2,59,73,132
"KANDAHAR","ZHIRE",2705159,3,50,548,598
"KANDAHAR","ZHIRE",2705155,1,7,34,41
"KANDAHAR","ZHIRE",2705153,3,11,488,499
"KANDAHAR","ZHIRE",2705149,1,23,475,498
"KANDAHAR","ZHIRE",2705170,1,73,195,268
"KANDAHAR","ZHIRE",2705170,2,45,219,264
"KANDAHAR","ZHIRE",2705170,3,8,116,124
"KANDAHAR","ZHIRE",2705163,3,81,115,196
"KANDAHAR","ZHIRE",2705157,2,3,4,7
"KANDAHAR","ZHIRE",2705158,1,39,103,142
"KANDAHAR","ZHIRE",2705161,1,62,50,112
"KANDAHAR","ZHIRE",2705167,1,30,102,132
"KANDAHAR","ZHIRE",2705153,4,4,495,499
"KANDAHAR","ZHIRE",2705164,1,93,455,548
"KANDAHAR","ZHIRE",2705164,2,7,202,209
"KANDAHAR","ZHIRE",2705163,2,57,162,219
"KANDAHAR","ZHIRE",2705153,8,18,139,157
"KANDAHAR","ZHIRE",2705149,2,27,464,491
"KANDAHAR","ZHIRE",2705163,1,93,115,208
"KANDAHAR","ZHIRE",2705150,2,15,44,59
"KANDAHAR","ZHIRE",2705153,6,23,498,521
"KANDAHAR","ZHIRE",2705162,1,258,234,492
"KANDAHAR","ZHIRE",2705150,1,14,33,47
"KANDAHAR","ZHIRE",2705153,5,8,124,132
"KANDAHAR","ZHIRE",2705168,3,15,519,534
"KANDAHAR","ZHIRE",2705166,1,22,22,44
"KANDAHAR","ZHIRE",2705165,2,84,139,223
"KANDAHAR","ZHIRE",2705168,2,6,497,503
"KANDAHAR","ZHIRE",2705160,1,112,415,527
"KANDAHAR","ZHIRE",2705153,7,32,143,175
"KANDAHAR","ZHIRE",2705168,1,20,486,506
"KANDAHAR","ZHIRE",2705166,2,12,6,18
"KANDAHAR","ZHIRE",2705154,1,10,13,23
"KANDAHAR","ZHIRE",2705160,2,121,408,529
"KANDAHAR","ZHIRE",2705154,2,7,10,17
"KANDAHAR","SHAH WALI KOT",2706094,1,32,74,106
"KANDAHAR","SHAH WALI KOT",2706089,5,11,589,600
"KANDAHAR","SHAH WALI KOT",2706094,4,45,550,595
"KANDAHAR","SHAH WALI KOT",2706092,1,42,558,600
"KANDAHAR","SHAH WALI KOT",2706098,2,25,575,600
"KANDAHAR","SHAH WALI KOT",2706098,3,37,563,600
"KANDAHAR","SHAH WALI KOT",2706089,1,16,584,600
"KANDAHAR","SHAH WALI KOT",2706089,6,80,280,360
"KANDAHAR","SHAH WALI KOT",2706094,2,31,66,97
"KANDAHAR","SHAH WALI KOT",2706092,4,52,548,600
"KANDAHAR","SHAH WALI KOT",2706091,1,11,589,600
"KANDAHAR","SHAH WALI KOT",2706097,1,59,541,600
"KANDAHAR","SHAH WALI KOT",2706098,1,24,53,77
"KANDAHAR","SHAH WALI KOT",2706095,1,1,593,594
"KANDAHAR","SHAH WALI KOT",2706094,3,60,540,600
"KANDAHAR","SHAH WALI KOT",2706090,2,3,597,600
"KANDAHAR","SHAH WALI KOT",2706089,2,81,519,600
"KANDAHAR","SHAH WALI KOT",2706089,3,12,588,600
"KANDAHAR","SHAH WALI KOT",2706089,4,35,565,600
"KANDAHAR","SHAH WALI KOT",2706095,2,2,595,597
"KANDAHAR","SHAH WALI KOT",2706091,2,7,592,599
"KANDAHAR","SHAH WALI KOT",2706097,2,64,536,600
"KANDAHAR","SHAH WALI KOT",2706090,1,0,589,589
"KANDAHAR","KHAKREZ",2707121,1,28,140,168
"KANDAHAR","KHAKREZ",2707122,1,10,12,22
"KANDAHAR","KHAKREZ",2707122,2,5,6,11
"KANDAHAR","KHAKREZ",2707124,1,36,29,65
"KANDAHAR","KHAKREZ",2707123,1,140,34,174
"KANDAHAR","KHAKREZ",2707123,2,11,2,13
"KANDAHAR","ARGHISTAN",2708250,4,193,347,540
"KANDAHAR","ARGHISTAN",2708253,1,87,415,502
"KANDAHAR","ARGHISTAN",2708246,3,29,524,553
"KANDAHAR","ARGHISTAN",2708249,3,45,55,100
"KANDAHAR","ARGHISTAN",2708246,1,47,546,593
"KANDAHAR","ARGHISTAN",2708246,2,184,408,592
"KANDAHAR","ARGHISTAN",2708252,1,200,400,600
"KANDAHAR","ARGHISTAN",2708246,4,14,530,544
"KANDAHAR","ARGHISTAN",2708248,2,11,30,41
"KANDAHAR","ARGHISTAN",2708250,1,253,289,542
"KANDAHAR","ARGHISTAN",2708250,2,367,191,558
"KANDAHAR","ARGHISTAN",2708250,3,169,359,528
"KANDAHAR","ARGHISTAN",2708245,2,11,575,586
"KANDAHAR","ARGHISTAN",2708252,2,95,500,595
"KANDAHAR","ARGHISTAN",2708252,3,158,440,598
"KANDAHAR","ARGHISTAN",2708245,1,18,552,570
"KANDAHAR","ARGHISTAN",2708246,5,37,495,532
"KANDAHAR","ARGHISTAN",2708249,2,254,244,498
"KANDAHAR","ARGHISTAN",2708245,3,21,542,563
"KANDAHAR","ARGHISTAN",2708253,3,20,576,596
"KANDAHAR","ARGHISTAN",2708252,4,100,390,490
"KANDAHAR","ARGHISTAN",2708251,1,268,312,580
"KANDAHAR","ARGHISTAN",2708248,1,56,78,134
"KANDAHAR","ARGHISTAN",2708245,4,18,495,513
"KANDAHAR","ARGHISTAN",2708251,3,256,324,580
"KANDAHAR","ARGHISTAN",2708247,2,229,269,498
"KANDAHAR","ARGHISTAN",2708245,5,15,540,555
"KANDAHAR","ARGHISTAN",2708251,2,241,269,510
"KANDAHAR","ARGHISTAN",2708253,2,150,450,600
"KANDAHAR","ARGHISTAN",2708249,1,284,251,535
"KANDAHAR","ARGHISTAN",2708247,1,5,15,20
"KANDAHAR","GHORAK",2709130,1,11,552,563
"KANDAHAR","GHORAK",2709131,2,25,468,493
"KANDAHAR","GHORAK",2709129,1,9,562,571
"KANDAHAR","GHORAK",2709128,1,25,473,498
"KANDAHAR","GHORAK",2709129,2,48,444,492
"KANDAHAR","GHORAK",2709127,1,78,509,587
"KANDAHAR","GHORAK",2709127,2,39,550,589
"KANDAHAR","GHORAK",2709131,1,16,573,589
"KANDAHAR","GHORAK",2709130,2,0,598,598
"KANDAHAR","MAIWAND",2710137,2,14,48,62
"KANDAHAR","MAIWAND",2710141,1,15,41,56
"KANDAHAR","MAIWAND",2710142,2,32,216,248
"KANDAHAR","MAIWAND",2710138,2,66,423,489
"KANDAHAR","MAIWAND",2710138,3,12,319,331
"KANDAHAR","MAIWAND",2710135,1,2,7,9
"KANDAHAR","MAIWAND",2710141,2,5,37,42
"KANDAHAR","MAIWAND",2710136,2,5,9,14
"KANDAHAR","MAIWAND",2710139,1,4,16,20
"KANDAHAR","MAIWAND",2710137,1,5,11,16
"KANDAHAR","MAIWAND",2710136,1,3,6,9
"KANDAHAR","MAIWAND",2710148,1,14,292,306
"KANDAHAR","MAIWAND",2710148,2,13,300,313
"KANDAHAR","MAIWAND",2710139,2,5,7,12
"KANDAHAR","MAIWAND",2710145,1,0,2,2
"KANDAHAR","MAIWAND",2710146,3,9,49,58
"KANDAHAR","MAIWAND",2710142,1,40,282,322
"KANDAHAR","MAIWAND",2710143,1,69,84,153
"KANDAHAR","MAIWAND",2710142,3,0,25,25
"KANDAHAR","MAIWAND",2710144,1,27,54,81
"KANDAHAR","MAIWAND",2710144,2,40,20,60
"KANDAHAR","MAIWAND",2710145,2,1,3,4
"KANDAHAR","MAIWAND",2710146,1,20,463,483
"KANDAHAR","MAIWAND",2710146,2,12,80,92
"KANDAHAR","MAIWAND",2710138,1,10,275,285
"KANDAHAR","MAIWAND",2710147,2,34,131,165
"KANDAHAR","MAIWAND",2710145,3,2,16,18
"KANDAHAR","MAIWAND",2710147,1,21,168,189
"KANDAHAR","SPIN BOLDAK",2711217,3,51,407,458
"KANDAHAR","SPIN BOLDAK",2711217,2,31,521,552
"KANDAHAR","SPIN BOLDAK",2711211,1,13,553,566
"KANDAHAR","SPIN BOLDAK",2711206,4,22,530,552
"KANDAHAR","SPIN BOLDAK",2711217,5,9,200,209
"KANDAHAR","SPIN BOLDAK",2711217,1,54,443,497
"KANDAHAR","SPIN BOLDAK",2711212,6,37,335,372
"KANDAHAR","SPIN BOLDAK",2711218,1,110,448,558
"KANDAHAR","SPIN BOLDAK",2711217,4,19,389,408
"KANDAHAR","SPIN BOLDAK",2711211,4,7,554,561
"KANDAHAR","SPIN BOLDAK",2711209,2,44,540,584
"KANDAHAR","SPIN BOLDAK",2711220,4,13,403,416
"KANDAHAR","SPIN BOLDAK",2711206,5,11,529,540
"KANDAHAR","SPIN BOLDAK",2711209,1,38,509,547
"KANDAHAR","SPIN BOLDAK",2711220,3,20,373,393
"KANDAHAR","SPIN BOLDAK",2711208,3,71,275,346
"KANDAHAR","SPIN BOLDAK",2711208,4,36,126,162
"KANDAHAR","SPIN BOLDAK",2711220,2,11,413,424
"KANDAHAR","SPIN BOLDAK",2711207,4,295,280,575
"KANDAHAR","SPIN BOLDAK",2711211,2,16,555,571
"KANDAHAR","SPIN BOLDAK",2711209,3,20,553,573
"KANDAHAR","SPIN BOLDAK",2711207,3,7,536,543
"KANDAHAR","SPIN BOLDAK",2711220,1,23,382,405
"KANDAHAR","SPIN BOLDAK",2711213,1,39,546,585
"KANDAHAR","SPIN BOLDAK",2711213,2,16,573,589
"KANDAHAR","SPIN BOLDAK",2711217,6,11,264,275
"KANDAHAR","SPIN BOLDAK",2711208,1,149,104,253
"KANDAHAR","SPIN BOLDAK",2711208,2,12,32,44
"KANDAHAR","SPIN BOLDAK",2711222,1,15,472,487
"KANDAHAR","SPIN BOLDAK",2711222,2,11,537,548
"KANDAHAR","SPIN BOLDAK",2711222,3,22,556,578
"KANDAHAR","SPIN BOLDAK",2711222,4,116,174,290
"KANDAHAR","SPIN BOLDAK",2711222,5,99,162,261
"KANDAHAR","SPIN BOLDAK",2711211,3,15,539,554
"KANDAHAR","SPIN BOLDAK",2711205,1,35,459,494
"KANDAHAR","SPIN BOLDAK",2711205,2,18,535,553
"KANDAHAR","SPIN BOLDAK",2711218,2,77,498,575
"KANDAHAR","SPIN BOLDAK",2711218,3,72,508,580
"KANDAHAR","SPIN BOLDAK",2711213,3,14,293,307
"KANDAHAR","SPIN BOLDAK",2711218,5,79,468,547
"KANDAHAR","SPIN BOLDAK",2711218,6,88,460,548
"KANDAHAR","SPIN BOLDAK",2711212,4,45,471,516
"KANDAHAR","SPIN BOLDAK",2711212,5,19,501,520
"KANDAHAR","SPIN BOLDAK",2711219,3,22,469,491
"KANDAHAR","SPIN BOLDAK",2711219,4,23,528,551
"KANDAHAR","SPIN BOLDAK",2711219,5,0,526,526
"KANDAHAR","SPIN BOLDAK",2711219,6,0,430,430
"KANDAHAR","SPIN BOLDAK",2711223,1,14,388,402
"KANDAHAR","SPIN BOLDAK",2711209,4,46,504,550
"KANDAHAR","SPIN BOLDAK",2711209,5,71,515,586
"KANDAHAR","SPIN BOLDAK",2711215,1,66,447,513
"KANDAHAR","SPIN BOLDAK",2711218,4,93,476,569
"KANDAHAR","SPIN BOLDAK",2711215,3,102,409,511
"KANDAHAR","SPIN BOLDAK",2711215,4,75,435,510
"KANDAHAR","SPIN BOLDAK",2711213,4,12,369,381
"KANDAHAR","SPIN BOLDAK",2711207,1,260,153,413
"KANDAHAR","SPIN BOLDAK",2711207,2,11,581,592
"KANDAHAR","SPIN BOLDAK",2711226,3,41,517,558
"KANDAHAR","SPIN BOLDAK",2711226,4,21,502,523
"KANDAHAR","SPIN BOLDAK",2711207,5,7,536,543
"KANDAHAR","SPIN BOLDAK",2711207,6,2,513,515
"KANDAHAR","SPIN BOLDAK",2711225,1,112,483,595
"KANDAHAR","SPIN BOLDAK",2711225,2,1,598,599
"KANDAHAR","SPIN BOLDAK",2711205,3,140,366,506
"KANDAHAR","SPIN BOLDAK",2711215,2,90,389,479
"KANDAHAR","SPIN BOLDAK",2711205,5,82,356,438
"KANDAHAR","SPIN BOLDAK",2711205,6,1,13,14
"KANDAHAR","SPIN BOLDAK",2711204,1,74,391,465
"KANDAHAR","SPIN BOLDAK",2711204,2,95,422,517
"KANDAHAR","SPIN BOLDAK",2711204,3,128,375,503
"KANDAHAR","SPIN BOLDAK",2711204,4,112,420,532
"KANDAHAR","SPIN BOLDAK",2711204,5,55,235,290
"KANDAHAR","SPIN BOLDAK",2711204,6,58,246,304
"KANDAHAR","SPIN BOLDAK",2711214,1,21,534,555
"KANDAHAR","SPIN BOLDAK",2711214,2,25,522,547
"KANDAHAR","SPIN BOLDAK",2711214,3,73,506,579
"KANDAHAR","SPIN BOLDAK",2711214,4,30,557,587
"KANDAHAR","SPIN BOLDAK",2711205,4,155,254,409
"KANDAHAR","SPIN BOLDAK",2711212,1,18,533,551
"KANDAHAR","SPIN BOLDAK",2711212,2,16,553,569
"KANDAHAR","SPIN BOLDAK",2711212,3,28,444,472
"KANDAHAR","SPIN BOLDAK",2711219,1,91,467,558
"KANDAHAR","SPIN BOLDAK",2711219,2,37,523,560
"KANDAHAR","SPIN BOLDAK",2711206,3,20,509,529
"KANDAHAR","SPIN BOLDAK",2711227,5,50,297,347
"KANDAHAR","SPIN BOLDAK",2711227,6,50,168,218
"KANDAHAR","SPIN BOLDAK",2711203,1,14,539,553
"KANDAHAR","SPIN BOLDAK",2711203,2,32,551,583
"KANDAHAR","SPIN BOLDAK",2711203,3,15,568,583
"KANDAHAR","SPIN BOLDAK",2711203,4,91,417,508
"KANDAHAR","SPIN BOLDAK",2711203,5,67,484,551
"KANDAHAR","SPIN BOLDAK",2711203,6,96,456,552
"KANDAHAR","SPIN BOLDAK",2711203,7,105,153,258
"KANDAHAR","SPIN BOLDAK",2711224,2,45,508,553
"KANDAHAR","SPIN BOLDAK",2711224,3,37,534,571
"KANDAHAR","SPIN BOLDAK",2711224,4,31,531,562
"KANDAHAR","SPIN BOLDAK",2711226,1,3,566,569
"KANDAHAR","SPIN BOLDAK",2711226,2,19,497,516
"KANDAHAR","SPIN BOLDAK",2711228,6,11,571,582
"KANDAHAR","SPIN BOLDAK",2711226,5,7,358,365
"KANDAHAR","SPIN BOLDAK",2711226,6,30,386,416
"KANDAHAR","SPIN BOLDAK",2711221,1,18,498,516
"KANDAHAR","SPIN BOLDAK",2711221,2,27,473,500
"KANDAHAR","SPIN BOLDAK",2711225,3,3,597,600
"KANDAHAR","SPIN BOLDAK",2711225,4,3,583,586
"KANDAHAR","SPIN BOLDAK",2711225,5,26,574,600
"KANDAHAR","SPIN BOLDAK",2711228,1,6,511,517
"KANDAHAR","SPIN BOLDAK",2711228,2,30,400,430
"KANDAHAR","SPIN BOLDAK",2711228,3,51,455,506
"KANDAHAR","SPIN BOLDAK",2711228,4,3,525,528
"KANDAHAR","SPIN BOLDAK",2711228,5,5,501,506
"KANDAHAR","SPIN BOLDAK",2711227,3,80,487,567
"KANDAHAR","SPIN BOLDAK",2711216,1,40,350,390
"KANDAHAR","SPIN BOLDAK",2711216,2,60,410,470
"KANDAHAR","SPIN BOLDAK",2711214,6,92,457,549
"KANDAHAR","SPIN BOLDAK",2711216,3,60,227,287
"KANDAHAR","SPIN BOLDAK",2711221,3,77,421,498
"KANDAHAR","SPIN BOLDAK",2711214,5,15,535,550
"KANDAHAR","SPIN BOLDAK",2711206,2,23,518,541
"KANDAHAR","SPIN BOLDAK",2711221,6,34,467,501
"KANDAHAR","SPIN BOLDAK",2711221,7,31,463,494
"KANDAHAR","SPIN BOLDAK",2711206,1,34,471,505
"KANDAHAR","SPIN BOLDAK",2711223,3,19,403,422
"KANDAHAR","SPIN BOLDAK",2711227,2,72,484,556
"KANDAHAR","SPIN BOLDAK",2711224,1,17,513,530
"KANDAHAR","SPIN BOLDAK",2711227,4,26,311,337
"KANDAHAR","SPIN BOLDAK",2711210,5,12,500,512
"KANDAHAR","SPIN BOLDAK",2711223,4,12,410,422
"KANDAHAR","SPIN BOLDAK",2711227,1,72,481,553
"KANDAHAR","SPIN BOLDAK",2711223,2,229,229,458
"KANDAHAR","SPIN BOLDAK",2711210,1,38,371,409
"KANDAHAR","SPIN BOLDAK",2711210,6,27,21,48
"KANDAHAR","SPIN BOLDAK",2711221,4,57,454,511
"KANDAHAR","SPIN BOLDAK",2711210,4,13,487,500
"KANDAHAR","SPIN BOLDAK",2711210,3,15,404,419
"KANDAHAR","SPIN BOLDAK",2711210,2,27,410,437
"KANDAHAR","SPIN BOLDAK",2711221,5,12,523,535
"KANDAHAR","NISH",2712265,3,48,549,597
"KANDAHAR","NISH",2712263,2,52,535,587
"KANDAHAR","NISH",2712264,1,50,536,586
"KANDAHAR","NISH",2712267,1,83,515,598
"KANDAHAR","NISH",2712267,2,202,398,600
"KANDAHAR","NISH",2712263,1,83,438,521
"KANDAHAR","NISH",2712265,1,45,483,528
"KANDAHAR","NISH",2712263,3,16,546,562
"KANDAHAR","NISH",2712264,2,48,551,599
"KANDAHAR","NISH",2712264,3,128,472,600
"KANDAHAR","NISH",2712268,2,43,554,597
"KANDAHAR","NISH",2712265,2,33,562,595
"KANDAHAR","NISH",2712268,1,58,539,597
"KANDAHAR","NISH",2712266,2,5,567,572
"KANDAHAR","NISH",2712266,3,81,513,594
"KANDAHAR","NISH",2712268,3,206,339,545
"KANDAHAR","NISH",2712266,1,70,403,473
"KANDAHAR","MIYANISHIN",2713259,2,102,496,598
"KANDAHAR","MIYANISHIN",2713259,3,79,423,502
"KANDAHAR","MIYANISHIN",2713259,1,258,332,590
"KANDAHAR","MIYANISHIN",2713261,1,60,524,584
"KANDAHAR","MIYANISHIN",2713261,2,450,51,501
"KANDAHAR","SHORABAK",2714199,5,5,250,255
"KANDAHAR","SHORABAK",2714202,4,15,220,235
"KANDAHAR","SHORABAK",2714201,4,30,460,490
"KANDAHAR","SHORABAK",2714201,5,10,90,100
"KANDAHAR","SHORABAK",2714200,1,100,500,600
"KANDAHAR","SHORABAK",2714199,3,40,539,579
"KANDAHAR","SHORABAK",2714199,4,20,580,600
"KANDAHAR","SHORABAK",2714201,2,97,397,494
"KANDAHAR","SHORABAK",2714201,6,22,89,111
"KANDAHAR","SHORABAK",2714200,4,16,184,200
"KANDAHAR","SHORABAK",2714200,5,5,87,92
"KANDAHAR","SHORABAK",2714199,6,8,191,199
"KANDAHAR","SHORABAK",2714201,3,119,402,521
"KANDAHAR","SHORABAK",2714202,3,38,551,589
"KANDAHAR","SHORABAK",2714269,5,33,162,195
"KANDAHAR","SHORABAK",2714202,5,14,215,229
"KANDAHAR","SHORABAK",2714199,1,105,464,569
"KANDAHAR","SHORABAK",2714199,2,20,493,513
"KANDAHAR","SHORABAK",2714200,3,27,500,527
"KANDAHAR","SHORABAK",2714269,3,125,368,493
"KANDAHAR","SHORABAK",2714202,1,25,547,572
"KANDAHAR","SHORABAK",2714200,2,23,493,516
"KANDAHAR","SHORABAK",2714269,4,60,120,180
"KANDAHAR","SHORABAK",2714201,1,91,397,488
"KANDAHAR","SHORABAK",2714202,2,29,546,575
"KANDAHAR","SHORABAK",2714269,2,105,378,483
"KANDAHAR","SHORABAK",2714269,1,126,406,532
"KANDAHAR","MARUF",2715255,5,13,587,600
"KANDAHAR","MARUF",2715255,4,12,588,600
"KANDAHAR","MARUF",2715271,1,235,365,600
"KANDAHAR","MARUF",2715255,3,70,529,599
"KANDAHAR","MARUF",2715258,3,97,499,596
"KANDAHAR","MARUF",2715257,1,47,553,600
"KANDAHAR","MARUF",2715257,2,50,549,599
"KANDAHAR","MARUF",2715257,3,99,490,589
"KANDAHAR","MARUF",2715258,7,97,502,599
"KANDAHAR","MARUF",2715257,5,34,556,590
"KANDAHAR","MARUF",2715254,1,137,463,600
"KANDAHAR","MARUF",2715254,2,165,435,600
"KANDAHAR","MARUF",2715257,4,82,493,575
"KANDAHAR","MARUF",2715254,4,187,386,573
"KANDAHAR","MARUF",2715258,4,86,507,593
"KANDAHAR","MARUF",2715258,5,55,542,597
"KANDAHAR","MARUF",2715254,3,150,448,598
"KANDAHAR","MARUF",2715270,1,160,440,600
"KANDAHAR","MARUF",2715256,4,52,548,600
"KANDAHAR","MARUF",2715256,5,140,441,581
"KANDAHAR","MARUF",2715255,1,64,491,555
"KANDAHAR","MARUF",2715255,2,48,502,550
"KANDAHAR","MARUF",2715270,3,150,448,598
"KANDAHAR","MARUF",2715270,4,190,408,598
"KANDAHAR","MARUF",2715270,5,226,369,595
"KANDAHAR","MARUF",2715258,1,62,533,595
"KANDAHAR","MARUF",2715258,2,90,504,594
"KANDAHAR","MARUF",2715271,4,51,449,500
"KANDAHAR","MARUF",2715271,5,78,318,396
"KANDAHAR","MARUF",2715258,6,59,538,597
"KANDAHAR","MARUF",2715256,3,61,535,596
"KANDAHAR","MARUF",2715256,2,68,527,595
"KANDAHAR","MARUF",2715254,5,122,352,474
"KANDAHAR","MARUF",2715270,2,150,450,600
"KANDAHAR","MARUF",2715271,3,50,478,528
"KANDAHAR","MARUF",2715271,2,129,471,600
"KANDAHAR","MARUF",2715256,1,93,500,593
"KANDAHAR","MARUF",2715254,6,169,361,530
"KANDAHAR","REG",2716198,6,49,399,448
"KANDAHAR","REG",2716197,6,51,415,466
"KANDAHAR","REG",2716197,5,67,395,462
"KANDAHAR","REG",2716198,4,52,503,555
"KANDAHAR","REG",2716196,1,46,506,552
"KANDAHAR","REG",2716196,2,52,510,562
"KANDAHAR","REG",2716196,3,51,499,550
"KANDAHAR","REG",2716196,7,38,392,430
"KANDAHAR","REG",2716198,5,43,412,455
"KANDAHAR","REG",2716198,3,35,482,517
"KANDAHAR","REG",2716196,4,58,520,578
"KANDAHAR","REG",2716197,3,58,483,541
"KANDAHAR","REG",2716197,4,37,498,535
"KANDAHAR","REG",2716197,1,159,425,584
"KANDAHAR","REG",2716197,2,52,503,555
"KANDAHAR","REG",2716196,5,45,444,489
"KANDAHAR","REG",2716196,6,55,406,461
"KANDAHAR","REG",2716198,2,70,498,568
"KANDAHAR","REG",2716198,1,63,508,571
NA,NA,2717064,5,1,1,2
NA,NA,2717064,6,2,3,5
NA,NA,2717017,1,1,2,3
NA,NA,2717017,2,9,7,16
NA,NA,2717017,3,15,7,22
NA,NA,2717017,4,30,20,50
NA,NA,2717017,5,2,3,5
NA,NA,2717017,6,0,3,3
NA,NA,2717004,1,148,36,184
NA,NA,2717004,2,173,62,235
NA,NA,2717004,3,97,27,124
NA,NA,2717011,1,94,54,148
NA,NA,2717011,2,17,517,534
NA,NA,2717011,3,22,442,464
NA,NA,2717011,4,2,322,324
NA,NA,2717011,5,8,242,250
NA,NA,2717011,6,20,321,341
NA,NA,2717021,1,30,99,129
NA,NA,2717021,2,19,68,87
NA,NA,2717021,3,17,47,64
NA,NA,2717021,4,10,32,42
NA,NA,2717021,5,13,27,40
NA,NA,2717021,6,7,6,13
NA,NA,2717051,1,58,58,116
NA,NA,2717051,2,31,48,79
NA,NA,2717051,3,5,5,10
NA,NA,2717051,4,5,49,54
NA,NA,2717051,5,2,1,3
NA,NA,2717001,1,66,476,542
NA,NA,2717001,2,28,465,493
NA,NA,2717001,3,37,460,497
NA,NA,2717001,4,36,522,558
NA,NA,2717001,5,15,335,350
NA,NA,2717001,6,10,340,350
NA,NA,2717015,1,58,222,280
NA,NA,2717015,4,1,12,13
NA,NA,2717015,5,0,8,8
NA,NA,2717016,5,2,10,12
NA,NA,2717016,6,3,13,16
NA,NA,2717065,1,74,58,132
NA,NA,2717065,2,91,53,144
NA,NA,2717015,2,39,138,177
NA,NA,2717015,3,32,101,133
NA,NA,2717015,6,5,20,25
NA,NA,2717052,1,3,506,509
NA,NA,2717016,4,9,93,102
NA,NA,2717052,2,37,492,529
NA,NA,2717052,3,38,520,558
NA,NA,2717052,4,22,509,531
NA,NA,2717052,5,7,328,335
NA,NA,2717052,6,6,331,337
NA,NA,2717052,7,5,325,330
NA,NA,2717013,1,216,41,257
NA,NA,2717013,2,24,190,214
NA,NA,2717013,3,53,272,325
NA,NA,2717013,4,43,294,337
NA,NA,2717013,5,10,2,12
NA,NA,2717013,6,1,8,9
NA,NA,2717013,7,5,7,12
NA,NA,2717016,1,10,98,108
NA,NA,2717016,2,21,196,217
NA,NA,2717016,3,9,117,126
NA,NA,2717065,3,1,2,3
NA,NA,2717064,1,8,95,103
NA,NA,2717064,2,4,45,49
NA,NA,2717064,3,8,52,60
NA,NA,2717064,4,18,118,136
NA,NA,2718235,3,24,381,405
NA,NA,2718244,3,10,583,593
NA,NA,2718244,4,9,266,275
NA,NA,2718242,1,28,526,554
NA,NA,2718242,2,50,480,530
NA,NA,2718242,3,25,270,295
NA,NA,2718242,4,32,366,398
NA,NA,2718229,1,14,569,583
NA,NA,2718229,2,18,568,586
NA,NA,2718233,2,11,9,20
NA,NA,2718235,4,37,294,331
NA,NA,2718235,5,21,358,379
NA,NA,2718236,1,42,381,423
NA,NA,2718236,2,41,277,318
NA,NA,2718236,3,39,374,413
NA,NA,2718236,4,68,323,391
NA,NA,2718236,5,18,185,203
NA,NA,2718236,6,18,107,125
NA,NA,2718240,1,26,500,526
NA,NA,2718240,2,20,515,535
NA,NA,2718240,3,15,510,525
NA,NA,2718229,3,53,496,549
NA,NA,2718233,1,19,10,29
NA,NA,2718241,1,10,547,557
NA,NA,2718241,2,4,240,244
NA,NA,2718241,3,26,531,557
NA,NA,2718241,4,12,241,253
NA,NA,2718244,1,14,543,557
NA,NA,2718244,2,18,551,569
NA,NA,2718239,1,50,497,547
NA,NA,2718239,2,97,392,489
NA,NA,2718239,3,60,410,470
NA,NA,2718239,4,29,491,520
NA,NA,2718239,5,20,256,276
NA,NA,2718231,1,18,84,102
NA,NA,2718231,2,18,86,104
NA,NA,2718231,3,0,6,6
NA,NA,2718232,1,100,494,594
NA,NA,2718232,2,19,578,597
NA,NA,2718243,1,32,39,71
NA,NA,2718243,2,10,25,35
NA,NA,2718243,3,146,436,582
NA,NA,2718243,4,101,493,594
NA,NA,2718231,4,0,2,2
NA,NA,2718231,5,0,5,5
NA,NA,2718235,1,48,386,434
NA,NA,2718235,2,23,477,500
NA,NA,2718239,6,30,281,311
NA,NA,2718239,7,12,187,199
NA,NA,2718240,8,10,353,363
NA,NA,2718238,4,27,540,567
NA,NA,2718238,5,15,298,313
NA,NA,2718238,6,20,320,340
NA,NA,2718238,7,0,350,350
NA,NA,2718238,8,30,370,400
NA,NA,2718237,1,32,399,431
NA,NA,2718237,2,90,323,413
NA,NA,2718237,3,32,453,485
NA,NA,2718237,4,104,350,454
NA,NA,2718237,7,16,270,286
NA,NA,2718237,8,15,222,237
NA,NA,2718234,1,54,506,560
NA,NA,2718234,2,58,514,572
NA,NA,2718234,3,16,247,263
NA,NA,2718240,5,19,526,545
NA,NA,2718240,6,25,409,434
NA,NA,2718240,7,25,400,425
NA,NA,2718238,3,22,558,580
NA,NA,2718237,6,30,271,301
NA,NA,2718234,4,17,313,330
NA,NA,2718238,2,15,9,24
NA,NA,2718238,1,13,21,34
NA,NA,2718240,4,524,18,542
NA,NA,2718230,1,136,464,600
NA,NA,2718230,2,100,500,600
NA,NA,2718237,5,28,463,491
NA,NA,2718239,8,23,353,376
"JAWZJAN","SHEBERGHAN",2801007,1,19,275,294
"JAWZJAN","SHEBERGHAN",2801025,2,58,26,84
"JAWZJAN","SHEBERGHAN",2801026,2,9,267,276
"JAWZJAN","SHEBERGHAN",2801008,1,15,297,312
"JAWZJAN","SHEBERGHAN",2801026,1,13,312,325
"JAWZJAN","SHEBERGHAN",2801025,3,12,36,48
"JAWZJAN","SHEBERGHAN",2801008,4,9,340,349
"JAWZJAN","SHEBERGHAN",2801032,3,57,229,286
"JAWZJAN","SHEBERGHAN",2801026,5,9,318,327
"JAWZJAN","SHEBERGHAN",2801032,1,42,137,179
"JAWZJAN","SHEBERGHAN",2801032,2,27,155,182
"JAWZJAN","SHEBERGHAN",2801026,4,14,566,580
"JAWZJAN","SHEBERGHAN",2801010,7,88,343,431
"JAWZJAN","SHEBERGHAN",2801003,2,60,242,302
"JAWZJAN","SHEBERGHAN",2801026,3,13,169,182
"JAWZJAN","SHEBERGHAN",2801010,6,84,430,514
"JAWZJAN","SHEBERGHAN",2801020,4,5,327,332
"JAWZJAN","SHEBERGHAN",2801010,8,72,419,491
"JAWZJAN","SHEBERGHAN",2801010,5,57,337,394
"JAWZJAN","SHEBERGHAN",2801020,3,25,241,266
"JAWZJAN","SHEBERGHAN",2801008,6,35,508,543
"JAWZJAN","SHEBERGHAN",2801008,2,11,274,285
"JAWZJAN","SHEBERGHAN",2801020,2,17,243,260
"JAWZJAN","SHEBERGHAN",2801028,3,61,203,264
"JAWZJAN","SHEBERGHAN",2801030,1,24,34,58
"JAWZJAN","SHEBERGHAN",2801030,2,28,16,44
"JAWZJAN","SHEBERGHAN",2801030,3,13,5,18
"JAWZJAN","SHEBERGHAN",2801025,1,33,31,64
"JAWZJAN","SHEBERGHAN",2801009,5,127,461,588
"JAWZJAN","SHEBERGHAN",2801009,6,116,417,533
"JAWZJAN","SHEBERGHAN",2801025,4,15,22,37
"JAWZJAN","SHEBERGHAN",2801025,5,46,127,173
"JAWZJAN","SHEBERGHAN",2801025,6,31,63,94
"JAWZJAN","SHEBERGHAN",2801022,1,18,92,110
"JAWZJAN","SHEBERGHAN",2801007,6,21,529,550
"JAWZJAN","SHEBERGHAN",2801008,7,33,560,593
"JAWZJAN","SHEBERGHAN",2801017,3,11,338,349
"JAWZJAN","SHEBERGHAN",2801017,4,38,543,581
"JAWZJAN","SHEBERGHAN",2801017,5,39,554,593
"JAWZJAN","SHEBERGHAN",2801017,6,18,103,121
"JAWZJAN","SHEBERGHAN",2801003,1,94,316,410
"JAWZJAN","SHEBERGHAN",2801019,3,44,256,300
"JAWZJAN","SHEBERGHAN",2801003,3,69,259,328
"JAWZJAN","SHEBERGHAN",2801003,4,58,250,308
"JAWZJAN","SHEBERGHAN",2801003,5,68,351,419
"JAWZJAN","SHEBERGHAN",2801023,1,4,71,75
"JAWZJAN","SHEBERGHAN",2801023,2,2,59,61
"JAWZJAN","SHEBERGHAN",2801023,3,0,120,120
"JAWZJAN","SHEBERGHAN",2801010,3,91,306,397
"JAWZJAN","SHEBERGHAN",2801010,4,122,468,590
"JAWZJAN","SHEBERGHAN",2801031,1,4,187,191
"JAWZJAN","SHEBERGHAN",2801031,2,1,85,86
"JAWZJAN","SHEBERGHAN",2801031,3,4,210,214
"JAWZJAN","SHEBERGHAN",2801020,1,15,288,303
"JAWZJAN","SHEBERGHAN",2801002,12,20,146,166
"JAWZJAN","SHEBERGHAN",2801002,13,13,147,160
"JAWZJAN","SHEBERGHAN",2801004,1,76,519,595
"JAWZJAN","SHEBERGHAN",2801020,5,27,541,568
"JAWZJAN","SHEBERGHAN",2801008,3,16,296,312
"JAWZJAN","SHEBERGHAN",2801008,5,9,198,207
"JAWZJAN","SHEBERGHAN",2801029,2,27,150,177
"JAWZJAN","SHEBERGHAN",2801029,3,12,65,77
"JAWZJAN","SHEBERGHAN",2801007,7,16,504,520
"JAWZJAN","SHEBERGHAN",2801007,8,34,520,554
"JAWZJAN","SHEBERGHAN",2801018,1,133,296,429
"JAWZJAN","SHEBERGHAN",2801018,2,86,215,301
"JAWZJAN","SHEBERGHAN",2801018,3,98,142,240
"JAWZJAN","SHEBERGHAN",2801018,4,141,385,526
"JAWZJAN","SHEBERGHAN",2801018,5,144,420,564
"JAWZJAN","SHEBERGHAN",2801011,1,17,385,402
"JAWZJAN","SHEBERGHAN",2801011,2,9,257,266
"JAWZJAN","SHEBERGHAN",2801011,3,12,175,187
"JAWZJAN","SHEBERGHAN",2801011,4,7,128,135
"JAWZJAN","SHEBERGHAN",2801011,5,26,568,594
"JAWZJAN","SHEBERGHAN",2801022,2,29,168,197
"JAWZJAN","SHEBERGHAN",2801017,1,20,384,404
"JAWZJAN","SHEBERGHAN",2801017,2,24,330,354
"JAWZJAN","SHEBERGHAN",2801027,1,68,130,198
"JAWZJAN","SHEBERGHAN",2801027,2,34,139,173
"JAWZJAN","SHEBERGHAN",2801027,3,54,161,215
"JAWZJAN","SHEBERGHAN",2801012,8,58,479,537
"JAWZJAN","SHEBERGHAN",2801002,1,92,296,388
"JAWZJAN","SHEBERGHAN",2801002,2,47,117,164
"JAWZJAN","SHEBERGHAN",2801002,3,26,109,135
"JAWZJAN","SHEBERGHAN",2801002,4,49,155,204
"JAWZJAN","SHEBERGHAN",2801003,6,132,459,591
"JAWZJAN","SHEBERGHAN",2801003,7,80,392,472
"JAWZJAN","SHEBERGHAN",2801010,1,50,241,291
"JAWZJAN","SHEBERGHAN",2801010,2,106,391,497
"JAWZJAN","SHEBERGHAN",2801021,4,14,292,306
"JAWZJAN","SHEBERGHAN",2801021,5,9,248,257
"JAWZJAN","SHEBERGHAN",2801016,2,101,481,582
"JAWZJAN","SHEBERGHAN",2801016,3,96,462,558
"JAWZJAN","SHEBERGHAN",2801016,4,32,183,215
"JAWZJAN","SHEBERGHAN",2801016,5,45,310,355
"JAWZJAN","SHEBERGHAN",2801016,6,49,280,329
"JAWZJAN","SHEBERGHAN",2801013,1,16,454,470
"JAWZJAN","SHEBERGHAN",2801004,2,80,400,480
"JAWZJAN","SHEBERGHAN",2801007,2,20,431,451
"JAWZJAN","SHEBERGHAN",2801007,3,20,282,302
"JAWZJAN","SHEBERGHAN",2801007,4,15,357,372
"JAWZJAN","SHEBERGHAN",2801007,5,15,223,238
"JAWZJAN","SHEBERGHAN",2801028,1,51,150,201
"JAWZJAN","SHEBERGHAN",2801028,2,50,124,174
"JAWZJAN","SHEBERGHAN",2801015,2,61,342,403
"JAWZJAN","SHEBERGHAN",2801015,3,62,409,471
"JAWZJAN","SHEBERGHAN",2801015,4,38,178,216
"JAWZJAN","SHEBERGHAN",2801015,5,72,338,410
"JAWZJAN","SHEBERGHAN",2801015,6,9,28,37
"JAWZJAN","SHEBERGHAN",2801015,7,4,23,27
"JAWZJAN","SHEBERGHAN",2801015,8,11,23,34
"JAWZJAN","SHEBERGHAN",2801015,9,8,49,57
"JAWZJAN","SHEBERGHAN",2801006,1,24,404,428
"JAWZJAN","SHEBERGHAN",2801006,2,18,243,261
"JAWZJAN","SHEBERGHAN",2801006,3,11,210,221
"JAWZJAN","SHEBERGHAN",2801006,4,5,250,255
"JAWZJAN","SHEBERGHAN",2801022,3,22,130,152
"JAWZJAN","SHEBERGHAN",2801022,4,45,217,262
"JAWZJAN","SHEBERGHAN",2801022,5,40,270,310
"JAWZJAN","SHEBERGHAN",2801006,8,21,566,587
"JAWZJAN","SHEBERGHAN",2801019,1,48,340,388
"JAWZJAN","SHEBERGHAN",2801019,2,50,313,363
"JAWZJAN","SHEBERGHAN",2801001,11,4,39,43
"JAWZJAN","SHEBERGHAN",2801019,4,20,240,260
"JAWZJAN","SHEBERGHAN",2801019,5,33,549,582
"JAWZJAN","SHEBERGHAN",2801019,6,47,528,575
"JAWZJAN","SHEBERGHAN",2801021,1,4,177,181
"JAWZJAN","SHEBERGHAN",2801021,2,8,158,166
"JAWZJAN","SHEBERGHAN",2801021,3,20,132,152
"JAWZJAN","SHEBERGHAN",2801002,6,119,331,450
"JAWZJAN","SHEBERGHAN",2801002,7,86,216,302
"JAWZJAN","SHEBERGHAN",2801002,8,57,282,339
"JAWZJAN","SHEBERGHAN",2801002,9,70,262,332
"JAWZJAN","SHEBERGHAN",2801002,10,41,239,280
"JAWZJAN","SHEBERGHAN",2801002,11,30,238,268
"JAWZJAN","SHEBERGHAN",2801009,4,73,355,428
"JAWZJAN","SHEBERGHAN",2801014,4,38,464,502
"JAWZJAN","SHEBERGHAN",2801013,2,7,329,336
"JAWZJAN","SHEBERGHAN",2801013,3,15,423,438
"JAWZJAN","SHEBERGHAN",2801020,6,30,409,439
"JAWZJAN","SHEBERGHAN",2801029,1,22,137,159
"JAWZJAN","SHEBERGHAN",2801013,6,18,387,405
"JAWZJAN","SHEBERGHAN",2801004,5,30,176,206
"JAWZJAN","SHEBERGHAN",2801004,6,116,468,584
"JAWZJAN","SHEBERGHAN",2801008,8,8,432,440
"JAWZJAN","SHEBERGHAN",2801009,1,135,459,594
"JAWZJAN","SHEBERGHAN",2801009,2,83,354,437
"JAWZJAN","SHEBERGHAN",2801009,3,115,445,560
"JAWZJAN","SHEBERGHAN",2801001,9,25,152,177
"JAWZJAN","SHEBERGHAN",2801001,10,14,101,115
"JAWZJAN","SHEBERGHAN",2801014,5,23,488,511
"JAWZJAN","SHEBERGHAN",2801009,7,65,249,314
"JAWZJAN","SHEBERGHAN",2801009,8,68,324,392
"JAWZJAN","SHEBERGHAN",2801012,1,29,184,213
"JAWZJAN","SHEBERGHAN",2801012,2,45,256,301
"JAWZJAN","SHEBERGHAN",2801012,3,52,331,383
"JAWZJAN","SHEBERGHAN",2801012,4,19,234,253
"JAWZJAN","SHEBERGHAN",2801012,5,40,256,296
"JAWZJAN","SHEBERGHAN",2801012,6,59,490,549
"JAWZJAN","SHEBERGHAN",2801012,7,71,516,587
"JAWZJAN","SHEBERGHAN",2801001,8,14,79,93
"JAWZJAN","SHEBERGHAN",2801014,2,124,464,588
"JAWZJAN","SHEBERGHAN",2801014,3,96,501,597
"JAWZJAN","SHEBERGHAN",2801005,4,25,199,224
"JAWZJAN","SHEBERGHAN",2801005,1,26,392,418
"JAWZJAN","SHEBERGHAN",2801005,2,9,251,260
"JAWZJAN","SHEBERGHAN",2801005,3,12,291,303
"JAWZJAN","SHEBERGHAN",2801016,1,88,385,473
"JAWZJAN","SHEBERGHAN",2801002,5,100,386,486
"JAWZJAN","SHEBERGHAN",2801005,6,20,343,363
"JAWZJAN","SHEBERGHAN",2801005,7,21,383,404
"JAWZJAN","SHEBERGHAN",2801001,7,36,177,213
"JAWZJAN","SHEBERGHAN",2801004,8,112,471,583
"JAWZJAN","SHEBERGHAN",2801014,1,95,499,594
"JAWZJAN","SHEBERGHAN",2801006,7,32,486,518
"JAWZJAN","SHEBERGHAN",2801001,1,82,225,307
"JAWZJAN","SHEBERGHAN",2801013,4,8,338,346
"JAWZJAN","SHEBERGHAN",2801004,3,57,294,351
"JAWZJAN","SHEBERGHAN",2801014,6,29,477,506
"JAWZJAN","SHEBERGHAN",2801013,8,20,475,495
"JAWZJAN","SHEBERGHAN",2801004,7,86,500,586
"JAWZJAN","SHEBERGHAN",2801024,3,32,259,291
"JAWZJAN","SHEBERGHAN",2801013,7,12,576,588
"JAWZJAN","SHEBERGHAN",2801001,6,110,477,587
"JAWZJAN","SHEBERGHAN",2801024,1,87,117,204
"JAWZJAN","SHEBERGHAN",2801001,2,31,101,132
"JAWZJAN","SHEBERGHAN",2801024,4,42,250,292
"JAWZJAN","SHEBERGHAN",2801011,6,17,578,595
"JAWZJAN","SHEBERGHAN",2801005,5,26,443,469
"JAWZJAN","SHEBERGHAN",2801024,2,81,128,209
"JAWZJAN","SHEBERGHAN",2801001,3,51,87,138
"JAWZJAN","SHEBERGHAN",2801006,6,17,370,387
"JAWZJAN","SHEBERGHAN",2801001,5,137,451,588
"JAWZJAN","SHEBERGHAN",2801004,4,25,183,208
"JAWZJAN","SHEBERGHAN",2801015,1,29,166,195
"JAWZJAN","SHEBERGHAN",2801006,5,16,168,184
"JAWZJAN","SHEBERGHAN",2801013,5,18,570,588
"JAWZJAN","SHEBERGHAN",2801001,4,45,132,177
"JAWZJAN","KHWAJA DUKO",2802110,8,8,577,585
"JAWZJAN","KHWAJA DUKO",2802110,10,1,586,587
"JAWZJAN","KHWAJA DUKO",2802114,2,31,112,143
"JAWZJAN","KHWAJA DUKO",2802110,9,4,589,593
"JAWZJAN","KHWAJA DUKO",2802123,2,6,46,52
"JAWZJAN","KHWAJA DUKO",2802123,3,4,24,28
"JAWZJAN","KHWAJA DUKO",2802110,7,15,570,585
"JAWZJAN","KHWAJA DUKO",2802123,1,9,49,58
"JAWZJAN","KHWAJA DUKO",2802111,2,60,281,341
"JAWZJAN","KHWAJA DUKO",2802112,1,101,233,334
"JAWZJAN","KHWAJA DUKO",2802114,1,56,142,198
"JAWZJAN","KHWAJA DUKO",2802111,4,51,537,588
"JAWZJAN","KHWAJA DUKO",2802110,1,9,415,424
"JAWZJAN","KHWAJA DUKO",2802110,4,15,450,465
"JAWZJAN","KHWAJA DUKO",2802110,6,15,574,589
"JAWZJAN","KHWAJA DUKO",2802111,3,57,304,361
"JAWZJAN","KHWAJA DUKO",2802111,1,72,301,373
"JAWZJAN","KHWAJA DUKO",2802112,3,81,337,418
"JAWZJAN","KHWAJA DUKO",2802110,3,9,447,456
"JAWZJAN","KHWAJA DUKO",2802110,5,16,573,589
"JAWZJAN","KHWAJA DUKO",2802112,2,117,225,342
"JAWZJAN","KHWAJA DUKO",2802110,2,19,516,535
"JAWZJAN","KHANAQA",2803122,1,115,26,141
"JAWZJAN","KHANAQA",2803120,3,18,90,108
"JAWZJAN","KHANAQA",2803117,1,127,113,240
"JAWZJAN","KHANAQA",2803120,2,51,47,98
"JAWZJAN","KHANAQA",2803116,2,23,320,343
"JAWZJAN","KHANAQA",2803119,1,76,67,143
"JAWZJAN","KHANAQA",2803118,2,13,40,53
"JAWZJAN","KHANAQA",2803119,3,24,57,81
"JAWZJAN","KHANAQA",2803119,2,66,43,109
"JAWZJAN","KHANAQA",2803115,3,75,58,133
"JAWZJAN","KHANAQA",2803118,1,17,71,88
"JAWZJAN","KHANAQA",2803120,1,53,60,113
"JAWZJAN","KHANAQA",2803116,1,36,288,324
"JAWZJAN","KHANAQA",2803122,2,11,9,20
"JAWZJAN","KHANAQA",2803116,3,26,337,363
"JAWZJAN","KHANAQA",2803115,2,102,70,172
"JAWZJAN","KHANAQA",2803117,2,81,109,190
"JAWZJAN","KHANAQA",2803115,1,78,77,155
"JAWZJAN","KHANAQA",2803115,4,159,218,377
"JAWZJAN","MINGAJIK",2804074,2,43,57,100
"JAWZJAN","MINGAJIK",2804074,3,5,40,45
"JAWZJAN","MINGAJIK",2804070,4,26,13,39
"JAWZJAN","MINGAJIK",2804074,1,45,50,95
"JAWZJAN","MINGAJIK",2804069,3,103,150,253
"JAWZJAN","MINGAJIK",2804069,4,29,58,87
"JAWZJAN","MINGAJIK",2804071,1,28,37,65
"JAWZJAN","MINGAJIK",2804071,2,29,34,63
"JAWZJAN","MINGAJIK",2804070,1,110,89,199
"JAWZJAN","MINGAJIK",2804076,1,43,62,105
"JAWZJAN","MINGAJIK",2804069,1,70,109,179
"JAWZJAN","MINGAJIK",2804069,2,71,112,183
"JAWZJAN","MINGAJIK",2804075,1,238,65,303
"JAWZJAN","MINGAJIK",2804076,2,76,50,126
"JAWZJAN","MINGAJIK",2804070,2,127,75,202
"JAWZJAN","MINGAJIK",2804070,3,30,9,39
"JAWZJAN","MINGAJIK",2804073,4,11,105,116
"JAWZJAN","MINGAJIK",2804077,1,136,186,322
"JAWZJAN","MINGAJIK",2804079,2,11,71,82
"JAWZJAN","MINGAJIK",2804073,3,8,103,111
"JAWZJAN","MINGAJIK",2804069,5,37,91,128
"JAWZJAN","MINGAJIK",2804072,1,41,41,82
"JAWZJAN","MINGAJIK",2804076,3,69,96,165
"JAWZJAN","MINGAJIK",2804073,2,44,166,210
"JAWZJAN","MINGAJIK",2804077,2,79,114,193
"JAWZJAN","MINGAJIK",2804078,3,4,74,78
"JAWZJAN","MINGAJIK",2804075,2,10,10,20
"JAWZJAN","MINGAJIK",2804072,2,40,24,64
"JAWZJAN","MINGAJIK",2804078,1,66,75,141
"JAWZJAN","MINGAJIK",2804071,3,1,3,4
"JAWZJAN","MINGAJIK",2804078,2,94,92,186
"JAWZJAN","MINGAJIK",2804077,3,47,18,65
"JAWZJAN","MINGAJIK",2804073,1,39,115,154
"JAWZJAN","MINGAJIK",2804079,1,140,63,203
"JAWZJAN","MINGAJIK",2804072,3,4,5,9
"JAWZJAN","QUSH TEPA",2805089,3,24,541,565
"JAWZJAN","QUSH TEPA",2805089,4,24,58,82
"JAWZJAN","QUSH TEPA",2805089,5,46,133,179
"JAWZJAN","QUSH TEPA",2805091,3,67,278,345
"JAWZJAN","QUSH TEPA",2805125,2,31,287,318
"JAWZJAN","QUSH TEPA",2805125,3,19,60,79
"JAWZJAN","QUSH TEPA",2805091,1,82,423,505
"JAWZJAN","QUSH TEPA",2805089,6,37,421,458
"JAWZJAN","QUSH TEPA",2805091,2,56,284,340
"JAWZJAN","QUSH TEPA",2805089,1,57,480,537
"JAWZJAN","QUSH TEPA",2805089,7,20,399,419
"JAWZJAN","QUSH TEPA",2805091,4,44,532,576
"JAWZJAN","QUSH TEPA",2805125,1,7,285,292
"JAWZJAN","QUSH TEPA",2805088,6,1,43,44
"JAWZJAN","QUSH TEPA",2805089,2,42,516,558
"JAWZJAN","QUSH TEPA",2805088,3,3,31,34
"JAWZJAN","QUSH TEPA",2805090,4,10,586,596
"JAWZJAN","QUSH TEPA",2805090,1,34,557,591
"JAWZJAN","QUSH TEPA",2805090,3,11,586,597
"JAWZJAN","QUSH TEPA",2805088,4,10,45,55
"JAWZJAN","QUSH TEPA",2805088,5,8,23,31
"JAWZJAN","QUSH TEPA",2805088,2,5,27,32
"JAWZJAN","QUSH TEPA",2805088,1,14,125,139
"JAWZJAN","QUSH TEPA",2805090,2,11,585,596
"JAWZJAN","KHAMYAB",2806084,4,34,128,162
"JAWZJAN","KHAMYAB",2806087,1,67,149,216
"JAWZJAN","KHAMYAB",2806084,3,69,155,224
"JAWZJAN","KHAMYAB",2806084,5,28,144,172
"JAWZJAN","KHAMYAB",2806085,2,87,167,254
"JAWZJAN","KHAMYAB",2806085,1,147,208,355
"JAWZJAN","KHAMYAB",2806085,3,36,173,209
"JAWZJAN","KHAMYAB",2806086,3,90,124,214
"JAWZJAN","KHAMYAB",2806086,1,153,174,327
"JAWZJAN","KHAMYAB",2806086,2,152,156,308
"JAWZJAN","KHAMYAB",2806084,2,73,160,233
"JAWZJAN","KHAMYAB",2806087,2,6,29,35
"JAWZJAN","KHAMYAB",2806084,1,107,267,374
"JAWZJAN","AQCHAH",2807033,8,61,220,281
"JAWZJAN","AQCHAH",2807034,2,124,30,154
"JAWZJAN","AQCHAH",2807039,4,61,171,232
"JAWZJAN","AQCHAH",2807034,3,221,39,260
"JAWZJAN","AQCHAH",2807033,7,74,237,311
"JAWZJAN","AQCHAH",2807034,1,202,31,233
"JAWZJAN","AQCHAH",2807048,2,60,425,485
"JAWZJAN","AQCHAH",2807036,1,42,179,221
"JAWZJAN","AQCHAH",2807033,4,61,161,222
"JAWZJAN","AQCHAH",2807038,3,23,148,171
"JAWZJAN","AQCHAH",2807038,4,20,129,149
"JAWZJAN","AQCHAH",2807048,3,26,98,124
"JAWZJAN","AQCHAH",2807033,5,28,97,125
"JAWZJAN","AQCHAH",2807042,3,37,99,136
"JAWZJAN","AQCHAH",2807033,9,49,225,274
"JAWZJAN","AQCHAH",2807042,1,89,99,188
"JAWZJAN","AQCHAH",2807042,2,91,145,236
"JAWZJAN","AQCHAH",2807033,3,65,261,326
"JAWZJAN","AQCHAH",2807040,4,7,106,113
"JAWZJAN","AQCHAH",2807039,1,133,453,586
"JAWZJAN","AQCHAH",2807039,2,146,445,591
"JAWZJAN","AQCHAH",2807039,3,73,203,276
"JAWZJAN","AQCHAH",2807044,5,17,43,60
"JAWZJAN","AQCHAH",2807039,5,38,106,144
"JAWZJAN","AQCHAH",2807036,2,60,168,228
"JAWZJAN","AQCHAH",2807036,3,76,240,316
"JAWZJAN","AQCHAH",2807038,2,118,228,346
"JAWZJAN","AQCHAH",2807043,2,2,4,6
"JAWZJAN","AQCHAH",2807047,1,87,48,135
"JAWZJAN","AQCHAH",2807047,2,3,4,7
"JAWZJAN","AQCHAH",2807048,1,117,475,592
"JAWZJAN","AQCHAH",2807035,1,46,89,135
"JAWZJAN","AQCHAH",2807035,2,35,89,124
"JAWZJAN","AQCHAH",2807033,6,32,129,161
"JAWZJAN","AQCHAH",2807045,1,62,36,98
"JAWZJAN","AQCHAH",2807033,2,32,205,237
"JAWZJAN","AQCHAH",2807044,1,22,62,84
"JAWZJAN","AQCHAH",2807035,3,22,74,96
"JAWZJAN","AQCHAH",2807033,1,51,130,181
"JAWZJAN","AQCHAH",2807044,4,18,36,54
"JAWZJAN","AQCHAH",2807045,2,23,18,41
"JAWZJAN","AQCHAH",2807044,2,17,49,66
"JAWZJAN","AQCHAH",2807044,3,17,62,79
"JAWZJAN","AQCHAH",2807037,3,6,59,65
"JAWZJAN","AQCHAH",2807038,1,92,283,375
"JAWZJAN","AQCHAH",2807045,3,31,30,61
"JAWZJAN","AQCHAH",2807045,4,33,5,38
"JAWZJAN","AQCHAH",2807041,2,44,193,237
"JAWZJAN","AQCHAH",2807046,1,137,210,347
"JAWZJAN","AQCHAH",2807040,3,25,114,139
"JAWZJAN","AQCHAH",2807041,1,75,258,333
"JAWZJAN","AQCHAH",2807037,1,20,60,80
"JAWZJAN","AQCHAH",2807037,2,17,58,75
"JAWZJAN","AQCHAH",2807046,2,37,43,80
"JAWZJAN","AQCHAH",2807043,1,33,62,95
"JAWZJAN","AQCHAH",2807040,2,7,87,94
"JAWZJAN","AQCHAH",2807040,1,17,192,209
"JAWZJAN","FAIZABAD",2808052,2,11,224,235
"JAWZJAN","FAIZABAD",2808059,2,8,137,145
"JAWZJAN","FAIZABAD",2808051,3,3,44,47
"JAWZJAN","FAIZABAD",2808052,3,31,378,409
"JAWZJAN","FAIZABAD",2808052,1,19,228,247
"JAWZJAN","FAIZABAD",2808049,1,15,334,349
"JAWZJAN","FAIZABAD",2808049,2,17,398,415
"JAWZJAN","FAIZABAD",2808059,1,5,207,212
"JAWZJAN","FAIZABAD",2808053,2,13,148,161
"JAWZJAN","FAIZABAD",2808057,1,72,13,85
"JAWZJAN","FAIZABAD",2808051,2,99,126,225
"JAWZJAN","FAIZABAD",2808057,3,139,18,157
"JAWZJAN","FAIZABAD",2808053,1,87,339,426
"JAWZJAN","FAIZABAD",2808126,2,11,134,145
"JAWZJAN","FAIZABAD",2808056,1,382,72,454
"JAWZJAN","FAIZABAD",2808056,2,271,12,283
"JAWZJAN","FAIZABAD",2808126,1,50,159,209
"JAWZJAN","FAIZABAD",2808054,3,100,140,240
"JAWZJAN","FAIZABAD",2808050,1,212,59,271
"JAWZJAN","FAIZABAD",2808051,1,107,124,231
"JAWZJAN","FAIZABAD",2808057,2,105,24,129
"JAWZJAN","FAIZABAD",2808055,2,23,6,29
"JAWZJAN","FAIZABAD",2808054,2,84,149,233
"JAWZJAN","FAIZABAD",2808050,2,168,51,219
"JAWZJAN","FAIZABAD",2808055,1,101,60,161
"JAWZJAN","FAIZABAD",2808049,4,16,293,309
"JAWZJAN","FAIZABAD",2808126,3,23,184,207
"JAWZJAN","FAIZABAD",2808049,3,8,404,412
"JAWZJAN","FAIZABAD",2808054,1,119,144,263
"JAWZJAN","MARDYAN",2809060,5,0,357,357
"JAWZJAN","MARDYAN",2809061,3,112,43,155
"JAWZJAN","MARDYAN",2809064,1,110,78,188
"JAWZJAN","MARDYAN",2809060,4,3,435,438
"JAWZJAN","MARDYAN",2809068,2,0,5,5
"JAWZJAN","MARDYAN",2809061,2,115,41,156
"JAWZJAN","MARDYAN",2809061,1,162,57,219
"JAWZJAN","MARDYAN",2809060,3,22,360,382
"JAWZJAN","MARDYAN",2809063,1,0,18,18
"JAWZJAN","MARDYAN",2809064,2,2,24,26
"JAWZJAN","MARDYAN",2809060,1,22,298,320
"JAWZJAN","MARDYAN",2809061,4,51,29,80
"JAWZJAN","MARDYAN",2809068,1,3,12,15
"JAWZJAN","MARDYAN",2809065,1,28,442,470
"JAWZJAN","MARDYAN",2809062,4,18,208,226
"JAWZJAN","MARDYAN",2809060,2,10,349,359
"JAWZJAN","MARDYAN",2809061,5,49,32,81
"JAWZJAN","MARDYAN",2809066,1,40,72,112
"JAWZJAN","MARDYAN",2809063,2,2,30,32
"JAWZJAN","MARDYAN",2809062,2,28,187,215
"JAWZJAN","MARDYAN",2809066,2,1,5,6
"JAWZJAN","MARDYAN",2809065,2,10,379,389
"JAWZJAN","MARDYAN",2809067,1,43,18,61
"JAWZJAN","MARDYAN",2809062,1,24,166,190
"JAWZJAN","MARDYAN",2809063,3,0,6,6
"JAWZJAN","MARDYAN",2809062,3,28,190,218
"JAWZJAN","MARDYAN",2809067,2,0,13,13
"JAWZJAN","QARQIN",2810082,1,308,267,575
"JAWZJAN","QARQIN",2810081,3,262,179,441
"JAWZJAN","QARQIN",2810083,2,344,186,530
"JAWZJAN","QARQIN",2810082,2,127,196,323
"JAWZJAN","QARQIN",2810080,2,194,116,310
"JAWZJAN","QARQIN",2810081,2,174,129,303
"JAWZJAN","QARQIN",2810080,9,61,123,184
"JAWZJAN","QARQIN",2810080,1,309,157,466
"JAWZJAN","QARQIN",2810083,1,247,125,372
"JAWZJAN","QARQIN",2810083,4,33,120,153
"JAWZJAN","QARQIN",2810080,3,229,112,341
"JAWZJAN","QARQIN",2810081,4,62,98,160
"JAWZJAN","QARQIN",2810080,6,215,101,316
"JAWZJAN","QARQIN",2810081,1,169,197,366
"JAWZJAN","QARQIN",2810080,8,88,60,148
"JAWZJAN","QARQIN",2810083,3,223,95,318
"JAWZJAN","QARQIN",2810080,4,323,210,533
"JAWZJAN","QARQIN",2810080,5,244,106,350
"JAWZJAN","QARQIN",2810080,7,81,52,133
"JAWZJAN","DARZAB",2811098,2,22,148,170
"JAWZJAN","DARZAB",2811098,3,23,343,366
"JAWZJAN","DARZAB",2811108,2,23,87,110
"JAWZJAN","DARZAB",2811106,2,21,147,168
"JAWZJAN","DARZAB",2811109,2,6,422,428
"JAWZJAN","DARZAB",2811108,1,44,146,190
"JAWZJAN","DARZAB",2811109,1,8,208,216
"JAWZJAN","DARZAB",2811098,1,14,187,201
"JAWZJAN","DARZAB",2811102,1,6,198,204
"JAWZJAN","DARZAB",2811102,2,9,172,181
"JAWZJAN","DARZAB",2811106,1,62,303,365
"JAWZJAN","DARZAB",2811099,2,23,216,239
"JAWZJAN","DARZAB",2811101,3,44,479,523
"JAWZJAN","DARZAB",2811107,2,12,497,509
"JAWZJAN","DARZAB",2811102,3,9,220,229
"JAWZJAN","DARZAB",2811127,1,23,161,184
"JAWZJAN","DARZAB",2811107,1,7,546,553
"JAWZJAN","DARZAB",2811096,4,169,299,468
"JAWZJAN","DARZAB",2811099,1,46,470,516
"JAWZJAN","DARZAB",2811101,1,19,235,254
"JAWZJAN","DARZAB",2811101,2,23,124,147
"JAWZJAN","DARZAB",2811097,3,109,214,323
"JAWZJAN","DARZAB",2811103,1,11,61,72
"JAWZJAN","DARZAB",2811100,3,57,128,185
"JAWZJAN","DARZAB",2811097,2,51,67,118
"JAWZJAN","DARZAB",2811100,1,12,50,62
"JAWZJAN","DARZAB",2811127,2,6,209,215
"JAWZJAN","DARZAB",2811127,3,4,150,154
"JAWZJAN","DARZAB",2811097,1,39,57,96
"JAWZJAN","DARZAB",2811096,2,24,39,63
"JAWZJAN","DARZAB",2811100,2,36,48,84
"JAWZJAN","DARZAB",2811096,3,21,15,36
"JAWZJAN","DARZAB",2811096,1,25,114,139
"JAWZJAN","DARZAB",2811103,2,1,51,52
"FARYAB","MAIMANA",2901199,5,27,324,351
"FARYAB","MAIMANA",2901199,4,60,530,590
"FARYAB","MAIMANA",2901002,6,45,552,597
"FARYAB","MAIMANA",2901007,2,61,230,291
"FARYAB","MAIMANA",2901002,8,42,543,585
"FARYAB","MAIMANA",2901007,3,147,445,592
"FARYAB","MAIMANA",2901007,1,29,58,87
"FARYAB","MAIMANA",2901002,7,36,560,596
"FARYAB","MAIMANA",2901006,6,17,92,109
"FARYAB","MAIMANA",2901010,4,24,565,589
"FARYAB","MAIMANA",2901010,5,18,582,600
"FARYAB","MAIMANA",2901009,3,77,246,323
"FARYAB","MAIMANA",2901010,3,24,569,593
"FARYAB","MAIMANA",2901009,5,32,159,191
"FARYAB","MAIMANA",2901010,6,12,579,591
"FARYAB","MAIMANA",2901015,4,46,289,335
"FARYAB","MAIMANA",2901009,4,25,254,279
"FARYAB","MAIMANA",2901007,4,207,387,594
"FARYAB","MAIMANA",2901002,4,19,574,593
"FARYAB","MAIMANA",2901002,5,27,561,588
"FARYAB","MAIMANA",2901199,2,34,555,589
"FARYAB","MAIMANA",2901010,1,37,555,592
"FARYAB","MAIMANA",2901001,4,42,287,329
"FARYAB","MAIMANA",2901015,3,65,201,266
"FARYAB","MAIMANA",2901014,1,17,578,595
"FARYAB","MAIMANA",2901199,3,65,515,580
"FARYAB","MAIMANA",2901014,3,11,589,600
"FARYAB","MAIMANA",2901014,4,14,584,598
"FARYAB","MAIMANA",2901014,5,19,578,597
"FARYAB","MAIMANA",2901014,2,8,590,598
"FARYAB","MAIMANA",2901007,7,108,143,251
"FARYAB","MAIMANA",2901009,1,84,348,432
"FARYAB","MAIMANA",2901009,2,35,156,191
"FARYAB","MAIMANA",2901006,3,18,335,353
"FARYAB","MAIMANA",2901006,4,21,179,200
"FARYAB","MAIMANA",2901006,5,14,120,134
"FARYAB","MAIMANA",2901015,2,37,291,328
"FARYAB","MAIMANA",2901002,9,31,332,363
"FARYAB","MAIMANA",2901002,10,3,166,169
"FARYAB","MAIMANA",2901002,11,165,181,346
"FARYAB","MAIMANA",2901003,1,40,506,546
"FARYAB","MAIMANA",2901007,5,105,211,316
"FARYAB","MAIMANA",2901010,2,67,530,597
"FARYAB","MAIMANA",2901014,7,7,212,219
"FARYAB","MAIMANA",2901002,3,17,575,592
"FARYAB","MAIMANA",2901006,2,28,329,357
"FARYAB","MAIMANA",2901013,5,85,212,297
"FARYAB","MAIMANA",2901013,6,43,166,209
"FARYAB","MAIMANA",2901015,1,53,299,352
"FARYAB","MAIMANA",2901004,4,48,154,202
"FARYAB","MAIMANA",2901012,5,23,577,600
"FARYAB","MAIMANA",2901012,6,19,576,595
"FARYAB","MAIMANA",2901015,5,47,351,398
"FARYAB","MAIMANA",2901016,1,103,101,204
"FARYAB","MAIMANA",2901016,2,231,218,449
"FARYAB","MAIMANA",2901014,6,6,590,596
"FARYAB","MAIMANA",2901007,6,34,119,153
"FARYAB","MAIMANA",2901013,3,50,194,244
"FARYAB","MAIMANA",2901013,4,139,244,383
"FARYAB","MAIMANA",2901001,1,98,498,596
"FARYAB","MAIMANA",2901001,2,127,452,579
"FARYAB","MAIMANA",2901001,3,45,554,599
"FARYAB","MAIMANA",2901012,3,17,575,592
"FARYAB","MAIMANA",2901199,6,2,592,594
"FARYAB","MAIMANA",2901001,5,22,230,252
"FARYAB","MAIMANA",2901001,6,27,258,285
"FARYAB","MAIMANA",2901001,7,22,213,235
"FARYAB","MAIMANA",2901001,8,33,214,247
"FARYAB","MAIMANA",2901001,9,46,245,291
"FARYAB","MAIMANA",2901002,1,23,574,597
"FARYAB","MAIMANA",2901002,2,17,581,598
"FARYAB","MAIMANA",2901006,1,25,574,599
"FARYAB","MAIMANA",2901003,6,20,388,408
"FARYAB","MAIMANA",2901012,1,30,570,600
"FARYAB","MAIMANA",2901012,2,43,551,594
"FARYAB","MAIMANA",2901004,3,42,144,186
"FARYAB","MAIMANA",2901012,4,20,448,468
"FARYAB","MAIMANA",2901209,1,124,245,369
"FARYAB","MAIMANA",2901209,2,66,80,146
"FARYAB","MAIMANA",2901005,1,91,323,414
"FARYAB","MAIMANA",2901011,2,47,411,458
"FARYAB","MAIMANA",2901011,3,21,156,177
"FARYAB","MAIMANA",2901011,4,15,497,512
"FARYAB","MAIMANA",2901003,4,33,555,588
"FARYAB","MAIMANA",2901003,5,41,490,531
"FARYAB","MAIMANA",2901016,6,193,105,298
"FARYAB","MAIMANA",2901016,7,53,69,122
"FARYAB","MAIMANA",2901199,1,65,529,594
"FARYAB","MAIMANA",2901004,2,76,247,323
"FARYAB","MAIMANA",2901005,2,76,208,284
"FARYAB","MAIMANA",2901005,3,67,486,553
"FARYAB","MAIMANA",2901016,3,76,98,174
"FARYAB","MAIMANA",2901016,4,70,59,129
"FARYAB","MAIMANA",2901016,5,195,223,418
"FARYAB","MAIMANA",2901008,5,24,317,341
"FARYAB","MAIMANA",2901013,2,109,228,337
"FARYAB","MAIMANA",2901004,1,45,257,302
"FARYAB","MAIMANA",2901008,3,23,293,316
"FARYAB","MAIMANA",2901004,5,76,219,295
"FARYAB","MAIMANA",2901008,1,56,322,378
"FARYAB","MAIMANA",2901008,2,24,465,489
"FARYAB","MAIMANA",2901209,3,48,83,131
"FARYAB","MAIMANA",2901008,4,16,275,291
"FARYAB","MAIMANA",2901013,1,187,360,547
"FARYAB","MAIMANA",2901005,6,56,229,285
"FARYAB","MAIMANA",2901011,1,46,523,569
"FARYAB","MAIMANA",2901003,2,29,397,426
"FARYAB","MAIMANA",2901011,5,30,283,313
"FARYAB","MAIMANA",2901005,5,71,333,404
"FARYAB","MAIMANA",2901003,3,16,577,593
"FARYAB","MAIMANA",2901005,4,82,307,389
"FARYAB","MAIMANA",2901209,4,128,315,443
"FARYAB","PASHTUN KOT",2902044,2,463,137,600
"FARYAB","PASHTUN KOT",2902044,1,367,232,599
"FARYAB","PASHTUN KOT",2902030,6,21,571,592
"FARYAB","PASHTUN KOT",2902043,1,550,48,598
"FARYAB","PASHTUN KOT",2902030,2,18,581,599
"FARYAB","PASHTUN KOT",2902030,5,44,543,587
"FARYAB","PASHTUN KOT",2902030,4,14,580,594
"FARYAB","PASHTUN KOT",2902031,1,99,488,587
"FARYAB","PASHTUN KOT",2902032,1,146,454,600
"FARYAB","PASHTUN KOT",2902032,2,35,75,110
"FARYAB","PASHTUN KOT",2902043,2,430,167,597
"FARYAB","PASHTUN KOT",2902030,1,13,581,594
"FARYAB","PASHTUN KOT",2902017,3,190,409,599
"FARYAB","PASHTUN KOT",2902028,1,600,0,600
"FARYAB","PASHTUN KOT",2902026,2,532,59,591
"FARYAB","PASHTUN KOT",2902037,4,372,219,591
"FARYAB","PASHTUN KOT",2902040,1,348,249,597
"FARYAB","PASHTUN KOT",2902040,2,199,200,399
"FARYAB","PASHTUN KOT",2902026,1,544,49,593
"FARYAB","PASHTUN KOT",2902045,2,467,132,599
"FARYAB","PASHTUN KOT",2902033,3,13,585,598
"FARYAB","PASHTUN KOT",2902037,1,97,113,210
"FARYAB","PASHTUN KOT",2902037,2,29,73,102
"FARYAB","PASHTUN KOT",2902037,3,375,219,594
"FARYAB","PASHTUN KOT",2902025,2,507,73,580
"FARYAB","PASHTUN KOT",2902052,2,156,167,323
"FARYAB","PASHTUN KOT",2902017,4,158,441,599
"FARYAB","PASHTUN KOT",2902042,1,150,448,598
"FARYAB","PASHTUN KOT",2902042,2,178,417,595
"FARYAB","PASHTUN KOT",2902048,1,0,600,600
"FARYAB","PASHTUN KOT",2902048,2,32,565,597
"FARYAB","PASHTUN KOT",2902046,1,19,578,597
"FARYAB","PASHTUN KOT",2902049,3,63,514,577
"FARYAB","PASHTUN KOT",2902046,3,0,597,597
"FARYAB","PASHTUN KOT",2902034,3,10,590,600
"FARYAB","PASHTUN KOT",2902027,2,26,571,597
"FARYAB","PASHTUN KOT",2902030,3,29,566,595
"FARYAB","PASHTUN KOT",2902033,2,219,379,598
"FARYAB","PASHTUN KOT",2902017,1,87,313,400
"FARYAB","PASHTUN KOT",2902052,3,325,269,594
"FARYAB","PASHTUN KOT",2902031,2,84,490,574
"FARYAB","PASHTUN KOT",2902028,2,598,0,598
"FARYAB","PASHTUN KOT",2902045,1,436,147,583
"FARYAB","PASHTUN KOT",2902029,3,394,200,594
"FARYAB","PASHTUN KOT",2902024,1,527,61,588
"FARYAB","PASHTUN KOT",2902046,2,14,584,598
"FARYAB","PASHTUN KOT",2902018,2,15,571,586
"FARYAB","PASHTUN KOT",2902018,3,20,575,595
"FARYAB","PASHTUN KOT",2902035,4,0,162,162
"FARYAB","PASHTUN KOT",2902025,1,496,77,573
"FARYAB","PASHTUN KOT",2902051,5,34,562,596
"FARYAB","PASHTUN KOT",2902052,1,224,251,475
"FARYAB","PASHTUN KOT",2902017,2,83,283,366
"FARYAB","PASHTUN KOT",2902019,2,487,113,600
"FARYAB","PASHTUN KOT",2902031,3,41,554,595
"FARYAB","PASHTUN KOT",2902038,1,199,400,599
"FARYAB","PASHTUN KOT",2902019,1,507,92,599
"FARYAB","PASHTUN KOT",2902027,1,157,433,590
"FARYAB","PASHTUN KOT",2902049,1,43,242,285
"FARYAB","PASHTUN KOT",2902049,2,9,2,11
"FARYAB","PASHTUN KOT",2902035,3,42,29,71
"FARYAB","PASHTUN KOT",2902023,3,4,164,168
"FARYAB","PASHTUN KOT",2902033,1,14,584,598
"FARYAB","PASHTUN KOT",2902035,1,44,56,100
"FARYAB","PASHTUN KOT",2902022,2,561,39,600
"FARYAB","PASHTUN KOT",2902034,2,8,589,597
"FARYAB","PASHTUN KOT",2902021,1,1,506,507
"FARYAB","PASHTUN KOT",2902023,1,33,550,583
"FARYAB","PASHTUN KOT",2902023,2,1,164,165
"FARYAB","PASHTUN KOT",2902022,1,407,187,594
"FARYAB","PASHTUN KOT",2902035,2,29,24,53
"FARYAB","PASHTUN KOT",2902021,2,21,573,594
"FARYAB","PASHTUN KOT",2902034,1,22,573,595
"FARYAB","PASHTUN KOT",2902200,2,500,89,589
"FARYAB","PASHTUN KOT",2902053,1,563,34,597
"FARYAB","PASHTUN KOT",2902051,4,45,551,596
"FARYAB","PASHTUN KOT",2902051,3,56,541,597
"FARYAB","PASHTUN KOT",2902040,3,382,217,599
"FARYAB","PASHTUN KOT",2902018,1,28,531,559
"FARYAB","PASHTUN KOT",2902029,2,400,200,600
"FARYAB","PASHTUN KOT",2902200,1,514,77,591
"FARYAB","PASHTUN KOT",2902036,1,21,579,600
"FARYAB","PASHTUN KOT",2902201,2,32,190,222
"FARYAB","PASHTUN KOT",2902041,1,211,6,217
"FARYAB","PASHTUN KOT",2902038,2,127,471,598
"FARYAB","PASHTUN KOT",2902041,2,296,30,326
"FARYAB","PASHTUN KOT",2902039,1,115,291,406
"FARYAB","PASHTUN KOT",2902039,2,415,164,579
"FARYAB","PASHTUN KOT",2902036,2,25,560,585
"FARYAB","PASHTUN KOT",2902202,2,448,151,599
"FARYAB","PASHTUN KOT",2902051,2,91,491,582
"FARYAB","PASHTUN KOT",2902202,1,349,248,597
"FARYAB","PASHTUN KOT",2902053,2,563,30,593
"FARYAB","PASHTUN KOT",2902039,3,323,160,483
"FARYAB","PASHTUN KOT",2902051,1,88,505,593
"FARYAB","PASHTUN KOT",2902201,1,15,202,217
"FARYAB","PASHTUN KOT",2902024,2,485,112,597
"FARYAB","KHWAJA SABZ POSH",2903054,7,1,37,38
"FARYAB","KHWAJA SABZ POSH",2903058,3,4,595,599
"FARYAB","KHWAJA SABZ POSH",2903054,5,1,449,450
"FARYAB","KHWAJA SABZ POSH",2903059,1,14,583,597
"FARYAB","KHWAJA SABZ POSH",2903061,4,29,570,599
"FARYAB","KHWAJA SABZ POSH",2903059,3,28,565,593
"FARYAB","KHWAJA SABZ POSH",2903211,2,65,524,589
"FARYAB","KHWAJA SABZ POSH",2903062,2,108,276,384
"FARYAB","KHWAJA SABZ POSH",2903054,3,2,597,599
"FARYAB","KHWAJA SABZ POSH",2903054,8,1,118,119
"FARYAB","KHWAJA SABZ POSH",2903054,6,12,587,599
"FARYAB","KHWAJA SABZ POSH",2903061,1,50,550,600
"FARYAB","KHWAJA SABZ POSH",2903211,1,108,475,583
"FARYAB","KHWAJA SABZ POSH",2903211,3,58,542,600
"FARYAB","KHWAJA SABZ POSH",2903061,3,41,559,600
"FARYAB","KHWAJA SABZ POSH",2903060,3,132,31,163
"FARYAB","KHWAJA SABZ POSH",2903059,7,7,592,599
"FARYAB","KHWAJA SABZ POSH",2903054,2,5,588,593
"FARYAB","KHWAJA SABZ POSH",2903059,2,15,581,596
"FARYAB","KHWAJA SABZ POSH",2903054,4,0,596,596
"FARYAB","KHWAJA SABZ POSH",2903210,1,7,577,584
"FARYAB","KHWAJA SABZ POSH",2903062,3,39,376,415
"FARYAB","KHWAJA SABZ POSH",2903058,2,41,554,595
"FARYAB","KHWAJA SABZ POSH",2903061,2,42,552,594
"FARYAB","KHWAJA SABZ POSH",2903056,3,82,62,144
"FARYAB","KHWAJA SABZ POSH",2903060,4,390,78,468
"FARYAB","KHWAJA SABZ POSH",2903060,1,192,38,230
"FARYAB","KHWAJA SABZ POSH",2903060,2,128,22,150
"FARYAB","KHWAJA SABZ POSH",2903055,3,118,460,578
"FARYAB","KHWAJA SABZ POSH",2903059,6,36,471,507
"FARYAB","KHWAJA SABZ POSH",2903057,2,21,576,597
"FARYAB","KHWAJA SABZ POSH",2903056,2,149,179,328
"FARYAB","KHWAJA SABZ POSH",2903058,5,5,344,349
"FARYAB","KHWAJA SABZ POSH",2903056,1,86,29,115
"FARYAB","KHWAJA SABZ POSH",2903062,1,144,450,594
"FARYAB","KHWAJA SABZ POSH",2903055,2,103,310,413
"FARYAB","KHWAJA SABZ POSH",2903054,1,6,585,591
"FARYAB","KHWAJA SABZ POSH",2903057,3,57,536,593
"FARYAB","KHWAJA SABZ POSH",2903210,2,16,582,598
"FARYAB","KHWAJA SABZ POSH",2903058,4,2,597,599
"FARYAB","KHWAJA SABZ POSH",2903059,5,1,599,600
"FARYAB","KHWAJA SABZ POSH",2903210,3,3,595,598
"FARYAB","KHWAJA SABZ POSH",2903059,4,6,592,598
"FARYAB","KHWAJA SABZ POSH",2903058,1,57,541,598
"FARYAB","KHWAJA SABZ POSH",2903055,1,38,270,308
"FARYAB","KHWAJA SABZ POSH",2903210,4,2,363,365
"FARYAB","ALMAR",2904063,5,137,460,597
"FARYAB","ALMAR",2904063,3,484,106,590
"FARYAB","ALMAR",2904074,1,405,183,588
"FARYAB","ALMAR",2904063,7,6,7,13
"FARYAB","ALMAR",2904077,1,5,592,597
"FARYAB","ALMAR",2904076,3,13,582,595
"FARYAB","ALMAR",2904063,2,228,369,597
"FARYAB","ALMAR",2904063,4,18,17,35
"FARYAB","ALMAR",2904076,1,11,589,600
"FARYAB","ALMAR",2904063,6,287,282,569
"FARYAB","ALMAR",2904077,2,3,593,596
"FARYAB","ALMAR",2904075,3,409,165,574
"FARYAB","ALMAR",2904073,3,7,591,598
"FARYAB","ALMAR",2904070,2,59,540,599
"FARYAB","ALMAR",2904074,2,261,337,598
"FARYAB","ALMAR",2904075,2,365,234,599
"FARYAB","ALMAR",2904073,2,8,591,599
"FARYAB","ALMAR",2904070,1,433,131,564
"FARYAB","ALMAR",2904065,5,558,37,595
"FARYAB","ALMAR",2904070,3,452,130,582
"FARYAB","ALMAR",2904076,2,10,588,598
"FARYAB","ALMAR",2904067,4,19,577,596
"FARYAB","ALMAR",2904066,2,497,69,566
"FARYAB","ALMAR",2904066,3,584,14,598
"FARYAB","ALMAR",2904065,1,550,48,598
"FARYAB","ALMAR",2904066,1,472,123,595
"FARYAB","ALMAR",2904065,2,549,49,598
"FARYAB","ALMAR",2904065,3,554,43,597
"FARYAB","ALMAR",2904075,1,395,205,600
"FARYAB","ALMAR",2904063,1,22,576,598
"FARYAB","ALMAR",2904073,1,4,594,598
"FARYAB","ALMAR",2904065,4,560,36,596
"FARYAB","ALMAR",2904067,3,5,594,599
"FARYAB","ALMAR",2904067,1,136,460,596
"FARYAB","ALMAR",2904067,2,9,589,598
"FARYAB","ALMAR",2904074,3,538,61,599
"FARYAB","BIL CHIRAGH",2905138,5,253,344,597
"FARYAB","BIL CHIRAGH",2905136,3,488,110,598
"FARYAB","BIL CHIRAGH",2905136,4,505,95,600
"FARYAB","BIL CHIRAGH",2905207,1,229,125,354
"FARYAB","BIL CHIRAGH",2905207,2,236,81,317
"FARYAB","BIL CHIRAGH",2905136,5,516,77,593
"FARYAB","BIL CHIRAGH",2905140,2,488,96,584
"FARYAB","BIL CHIRAGH",2905141,4,584,8,592
"FARYAB","BIL CHIRAGH",2905136,2,467,120,587
"FARYAB","BIL CHIRAGH",2905141,3,569,27,596
"FARYAB","BIL CHIRAGH",2905139,3,523,76,599
"FARYAB","BIL CHIRAGH",2905140,3,235,362,597
"FARYAB","BIL CHIRAGH",2905143,1,380,212,592
"FARYAB","BIL CHIRAGH",2905138,2,125,472,597
"FARYAB","BIL CHIRAGH",2905141,2,577,21,598
"FARYAB","BIL CHIRAGH",2905139,4,489,111,600
"FARYAB","BIL CHIRAGH",2905136,1,508,87,595
"FARYAB","BIL CHIRAGH",2905143,2,50,64,114
"FARYAB","BIL CHIRAGH",2905138,3,163,433,596
"FARYAB","BIL CHIRAGH",2905143,3,271,276,547
"FARYAB","BIL CHIRAGH",2905143,4,340,260,600
"FARYAB","BIL CHIRAGH",2905138,4,214,380,594
"FARYAB","BIL CHIRAGH",2905139,1,456,141,597
"FARYAB","BIL CHIRAGH",2905139,2,413,186,599
"FARYAB","BIL CHIRAGH",2905142,3,25,547,572
"FARYAB","BIL CHIRAGH",2905142,4,109,481,590
"FARYAB","BIL CHIRAGH",2905141,1,565,34,599
"FARYAB","BIL CHIRAGH",2905138,1,135,465,600
"FARYAB","BIL CHIRAGH",2905142,2,99,501,600
"FARYAB","BIL CHIRAGH",2905140,1,408,143,551
"FARYAB","BIL CHIRAGH",2905137,1,365,233,598
"FARYAB","BIL CHIRAGH",2905137,2,288,307,595
"FARYAB","BIL CHIRAGH",2905140,4,295,284,579
"FARYAB","BIL CHIRAGH",2905137,4,274,310,584
"FARYAB","BIL CHIRAGH",2905207,3,481,102,583
"FARYAB","BIL CHIRAGH",2905140,5,477,123,600
"FARYAB","BIL CHIRAGH",2905137,3,227,369,596
"FARYAB","BIL CHIRAGH",2905142,1,43,554,597
"FARYAB","SHIRIN TAGAB",2906152,4,154,414,568
"FARYAB","SHIRIN TAGAB",2906152,3,167,406,573
"FARYAB","SHIRIN TAGAB",2906154,1,45,17,62
"FARYAB","SHIRIN TAGAB",2906152,1,99,274,373
"FARYAB","SHIRIN TAGAB",2906146,4,38,292,330
"FARYAB","SHIRIN TAGAB",2906150,2,433,136,569
"FARYAB","SHIRIN TAGAB",2906148,5,19,165,184
"FARYAB","SHIRIN TAGAB",2906150,3,453,55,508
"FARYAB","SHIRIN TAGAB",2906146,3,54,503,557
"FARYAB","SHIRIN TAGAB",2906157,2,399,199,598
"FARYAB","SHIRIN TAGAB",2906152,2,85,380,465
"FARYAB","SHIRIN TAGAB",2906146,1,24,482,506
"FARYAB","SHIRIN TAGAB",2906157,1,400,196,596
"FARYAB","SHIRIN TAGAB",2906150,1,437,104,541
"FARYAB","SHIRIN TAGAB",2906148,4,69,505,574
"FARYAB","SHIRIN TAGAB",2906149,2,29,338,367
"FARYAB","SHIRIN TAGAB",2906149,1,27,471,498
"FARYAB","SHIRIN TAGAB",2906154,2,10,6,16
"FARYAB","SHIRIN TAGAB",2906147,3,154,303,457
"FARYAB","SHIRIN TAGAB",2906149,6,17,344,361
"FARYAB","SHIRIN TAGAB",2906149,3,38,496,534
"FARYAB","SHIRIN TAGAB",2906151,4,497,92,589
"FARYAB","SHIRIN TAGAB",2906149,5,43,550,593
"FARYAB","SHIRIN TAGAB",2906148,3,22,87,109
"FARYAB","SHIRIN TAGAB",2906208,3,317,244,561
"FARYAB","SHIRIN TAGAB",2906146,2,18,280,298
"FARYAB","SHIRIN TAGAB",2906147,2,86,39,125
"FARYAB","SHIRIN TAGAB",2906147,1,92,120,212
"FARYAB","SHIRIN TAGAB",2906145,4,65,356,421
"FARYAB","SHIRIN TAGAB",2906150,4,554,36,590
"FARYAB","SHIRIN TAGAB",2906150,5,534,59,593
"FARYAB","SHIRIN TAGAB",2906156,1,30,567,597
"FARYAB","SHIRIN TAGAB",2906156,2,81,477,558
"FARYAB","SHIRIN TAGAB",2906156,3,59,352,411
"FARYAB","SHIRIN TAGAB",2906151,3,520,75,595
"FARYAB","SHIRIN TAGAB",2906148,2,28,99,127
"FARYAB","SHIRIN TAGAB",2906148,1,32,241,273
"FARYAB","SHIRIN TAGAB",2906155,5,518,52,570
"FARYAB","SHIRIN TAGAB",2906155,6,480,80,560
"FARYAB","SHIRIN TAGAB",2906155,4,541,42,583
"FARYAB","SHIRIN TAGAB",2906145,3,123,186,309
"FARYAB","SHIRIN TAGAB",2906153,4,3,592,595
"FARYAB","SHIRIN TAGAB",2906153,1,20,334,354
"FARYAB","SHIRIN TAGAB",2906153,2,19,423,442
"FARYAB","SHIRIN TAGAB",2906153,3,8,161,169
"FARYAB","SHIRIN TAGAB",2906208,2,292,236,528
"FARYAB","SHIRIN TAGAB",2906149,4,36,541,577
"FARYAB","SHIRIN TAGAB",2906156,4,42,342,384
"FARYAB","SHIRIN TAGAB",2906151,2,343,248,591
"FARYAB","SHIRIN TAGAB",2906151,1,478,113,591
"FARYAB","SHIRIN TAGAB",2906145,1,74,186,260
"FARYAB","SHIRIN TAGAB",2906155,3,222,84,306
"FARYAB","SHIRIN TAGAB",2906145,2,132,255,387
"FARYAB","SHIRIN TAGAB",2906208,1,187,215,402
"FARYAB","SHIRIN TAGAB",2906153,5,22,568,590
"FARYAB","SHIRIN TAGAB",2906155,1,383,186,569
"FARYAB","SHIRIN TAGAB",2906155,2,412,41,453
"FARYAB","SHIRIN TAGAB",2906153,6,9,458,467
"FARYAB","QAISAR",2907090,1,27,570,597
"FARYAB","QAISAR",2907082,3,5,592,597
"FARYAB","QAISAR",2907102,5,517,63,580
"FARYAB","QAISAR",2907109,3,311,288,599
"FARYAB","QAISAR",2907109,1,325,274,599
"FARYAB","QAISAR",2907083,1,50,535,585
"FARYAB","QAISAR",2907104,5,23,558,581
"FARYAB","QAISAR",2907111,3,53,547,600
"FARYAB","QAISAR",2907109,2,200,400,600
"FARYAB","QAISAR",2907104,3,54,541,595
"FARYAB","QAISAR",2907102,4,576,0,576
"FARYAB","QAISAR",2907106,2,409,187,596
"FARYAB","QAISAR",2907106,3,199,398,597
"FARYAB","QAISAR",2907082,4,22,570,592
"FARYAB","QAISAR",2907090,2,51,546,597
"FARYAB","QAISAR",2907090,3,2,552,554
"FARYAB","QAISAR",2907090,4,19,564,583
"FARYAB","QAISAR",2907103,1,504,90,594
"FARYAB","QAISAR",2907100,3,181,418,599
"FARYAB","QAISAR",2907111,1,87,506,593
"FARYAB","QAISAR",2907111,2,46,544,590
"FARYAB","QAISAR",2907111,4,111,489,600
"FARYAB","QAISAR",2907105,3,161,435,596
"FARYAB","QAISAR",2907104,4,127,469,596
"FARYAB","QAISAR",2907102,3,574,13,587
"FARYAB","QAISAR",2907102,2,505,93,598
"FARYAB","QAISAR",2907089,2,3,555,558
"FARYAB","QAISAR",2907104,6,29,391,420
"FARYAB","QAISAR",2907081,3,11,583,594
"FARYAB","QAISAR",2907081,4,11,582,593
"FARYAB","QAISAR",2907083,3,50,540,590
"FARYAB","QAISAR",2907103,2,514,80,594
"FARYAB","QAISAR",2907100,1,127,472,599
"FARYAB","QAISAR",2907100,2,272,323,595
"FARYAB","QAISAR",2907104,2,101,489,590
"FARYAB","QAISAR",2907105,2,101,357,458
"FARYAB","QAISAR",2907106,1,355,233,588
"FARYAB","QAISAR",2907084,3,25,569,594
"FARYAB","QAISAR",2907089,1,50,543,593
"FARYAB","QAISAR",2907082,2,2,598,600
"FARYAB","QAISAR",2907081,2,11,583,594
"FARYAB","QAISAR",2907088,1,64,536,600
"FARYAB","QAISAR",2907088,2,67,526,593
"FARYAB","QAISAR",2907081,5,13,586,599
"FARYAB","QAISAR",2907081,6,10,300,310
"FARYAB","QAISAR",2907103,3,478,113,591
"FARYAB","QAISAR",2907101,3,29,570,599
"FARYAB","QAISAR",2907104,1,77,502,579
"FARYAB","QAISAR",2907105,1,92,312,404
"FARYAB","QAISAR",2907084,2,7,590,597
"FARYAB","QAISAR",2907093,2,87,163,250
"FARYAB","QAISAR",2907102,1,508,78,586
"FARYAB","QAISAR",2907093,1,33,343,376
"FARYAB","QAISAR",2907089,3,34,564,598
"FARYAB","QAISAR",2907081,7,3,572,575
"FARYAB","QAISAR",2907101,1,20,570,590
"FARYAB","QAISAR",2907094,1,414,185,599
"FARYAB","QAISAR",2907083,2,62,538,600
"FARYAB","QAISAR",2907084,1,10,586,596
"FARYAB","QAISAR",2907086,4,191,9,200
"FARYAB","QAISAR",2907101,4,3,587,590
"FARYAB","QAISAR",2907203,1,7,593,600
"FARYAB","QAISAR",2907081,1,23,566,589
"FARYAB","QAISAR",2907086,1,579,14,593
"FARYAB","QAISAR",2907092,2,155,445,600
"FARYAB","QAISAR",2907204,2,33,544,577
"FARYAB","QAISAR",2907094,2,569,31,600
"FARYAB","QAISAR",2907086,3,577,12,589
"FARYAB","QAISAR",2907086,2,555,39,594
"FARYAB","QAISAR",2907101,2,10,579,589
"FARYAB","QAISAR",2907094,3,382,208,590
"FARYAB","QAISAR",2907082,1,9,579,588
"FARYAB","QAISAR",2907203,2,2,598,600
"FARYAB","QAISAR",2907204,1,30,550,580
"FARYAB","QAISAR",2907096,2,487,54,541
"FARYAB","QAISAR",2907107,1,590,6,596
"FARYAB","QAISAR",2907107,2,568,18,586
"FARYAB","QAISAR",2907107,3,577,23,600
"FARYAB","QAISAR",2907094,4,467,131,598
"FARYAB","QAISAR",2907096,1,569,19,588
"FARYAB","QAISAR",2907092,1,260,338,598
"FARYAB","GURZIWAN",2908128,3,173,407,580
"FARYAB","GURZIWAN",2908127,5,580,20,600
"FARYAB","GURZIWAN",2908213,1,512,87,599
"FARYAB","GURZIWAN",2908125,4,570,10,580
"FARYAB","GURZIWAN",2908125,2,563,37,600
"FARYAB","GURZIWAN",2908128,2,25,568,593
"FARYAB","GURZIWAN",2908127,2,506,87,593
"FARYAB","GURZIWAN",2908128,1,12,588,600
"FARYAB","GURZIWAN",2908127,4,497,96,593
"FARYAB","GURZIWAN",2908125,3,571,16,587
"FARYAB","GURZIWAN",2908212,2,21,575,596
"FARYAB","GURZIWAN",2908125,1,578,22,600
"FARYAB","GURZIWAN",2908130,2,41,557,598
"FARYAB","GURZIWAN",2908130,3,1,596,597
"FARYAB","GURZIWAN",2908212,3,8,587,595
"FARYAB","GURZIWAN",2908129,1,581,18,599
"FARYAB","GURZIWAN",2908125,5,572,28,600
"FARYAB","GURZIWAN",2908123,1,543,30,573
"FARYAB","GURZIWAN",2908123,2,569,31,600
"FARYAB","GURZIWAN",2908127,1,476,122,598
"FARYAB","GURZIWAN",2908127,3,480,120,600
"FARYAB","GURZIWAN",2908206,3,599,0,599
"FARYAB","GURZIWAN",2908212,1,36,556,592
"FARYAB","GURZIWAN",2908124,5,443,121,564
"FARYAB","GURZIWAN",2908206,1,472,126,598
"FARYAB","GURZIWAN",2908124,3,445,148,593
"FARYAB","GURZIWAN",2908124,2,444,150,594
"FARYAB","GURZIWAN",2908130,4,29,556,585
"FARYAB","GURZIWAN",2908133,1,122,475,597
"FARYAB","GURZIWAN",2908213,3,492,101,593
"FARYAB","GURZIWAN",2908128,4,47,553,600
"FARYAB","GURZIWAN",2908128,5,81,518,599
"FARYAB","GURZIWAN",2908123,4,588,9,597
"FARYAB","GURZIWAN",2908206,2,444,155,599
"FARYAB","GURZIWAN",2908135,1,559,36,595
"FARYAB","GURZIWAN",2908135,2,500,92,592
"FARYAB","GURZIWAN",2908135,3,598,0,598
"FARYAB","GURZIWAN",2908124,4,419,131,550
"FARYAB","GURZIWAN",2908124,1,408,185,593
"FARYAB","GURZIWAN",2908131,4,80,187,267
"FARYAB","GURZIWAN",2908133,4,246,354,600
"FARYAB","GURZIWAN",2908123,3,584,13,597
"FARYAB","GURZIWAN",2908133,2,114,484,598
"FARYAB","GURZIWAN",2908133,3,347,251,598
"FARYAB","GURZIWAN",2908126,3,546,33,579
"FARYAB","GURZIWAN",2908126,4,591,9,600
"FARYAB","GURZIWAN",2908123,5,576,23,599
"FARYAB","GURZIWAN",2908132,4,104,494,598
"FARYAB","GURZIWAN",2908126,2,483,114,597
"FARYAB","GURZIWAN",2908129,2,536,59,595
"FARYAB","GURZIWAN",2908130,1,38,555,593
"FARYAB","GURZIWAN",2908131,3,11,67,78
"FARYAB","GURZIWAN",2908132,2,51,529,580
"FARYAB","GURZIWAN",2908126,1,496,100,596
"FARYAB","GURZIWAN",2908132,1,47,551,598
"FARYAB","GURZIWAN",2908132,3,29,567,596
"FARYAB","GURZIWAN",2908129,4,581,19,600
"FARYAB","GURZIWAN",2908131,1,23,60,83
"FARYAB","GURZIWAN",2908131,2,19,67,86
"FARYAB","GURZIWAN",2908129,3,543,55,598
"FARYAB","DAWLAT ABAD",2909163,1,61,67,128
"FARYAB","DAWLAT ABAD",2909159,4,26,117,143
"FARYAB","DAWLAT ABAD",2909168,1,15,95,110
"FARYAB","DAWLAT ABAD",2909164,4,38,147,185
"FARYAB","DAWLAT ABAD",2909164,2,27,59,86
"FARYAB","DAWLAT ABAD",2909162,2,17,222,239
"FARYAB","DAWLAT ABAD",2909159,1,15,176,191
"FARYAB","DAWLAT ABAD",2909160,2,14,169,183
"FARYAB","DAWLAT ABAD",2909164,3,58,124,182
"FARYAB","DAWLAT ABAD",2909159,3,3,105,108
"FARYAB","DAWLAT ABAD",2909164,1,29,61,90
"FARYAB","DAWLAT ABAD",2909168,2,17,100,117
"FARYAB","DAWLAT ABAD",2909162,1,5,593,598
"FARYAB","DAWLAT ABAD",2909160,1,12,242,254
"FARYAB","DAWLAT ABAD",2909163,4,159,202,361
"FARYAB","DAWLAT ABAD",2909162,5,27,284,311
"FARYAB","DAWLAT ABAD",2909163,2,53,68,121
"FARYAB","DAWLAT ABAD",2909159,2,22,186,208
"FARYAB","DAWLAT ABAD",2909165,2,15,109,124
"FARYAB","DAWLAT ABAD",2909158,1,27,331,358
"FARYAB","DAWLAT ABAD",2909160,3,20,296,316
"FARYAB","DAWLAT ABAD",2909168,3,35,102,137
"FARYAB","DAWLAT ABAD",2909158,5,12,479,491
"FARYAB","DAWLAT ABAD",2909162,4,23,433,456
"FARYAB","DAWLAT ABAD",2909162,3,35,559,594
"FARYAB","DAWLAT ABAD",2909158,2,18,400,418
"FARYAB","DAWLAT ABAD",2909163,3,23,55,78
"FARYAB","DAWLAT ABAD",2909158,3,28,206,234
"FARYAB","DAWLAT ABAD",2909158,4,25,535,560
"FARYAB","DAWLAT ABAD",2909166,1,6,11,17
"FARYAB","DAWLAT ABAD",2909165,1,8,35,43
"FARYAB","KOHISTAN",2910121,1,392,138,530
"FARYAB","KOHISTAN",2910121,2,431,168,599
"FARYAB","KOHISTAN",2910122,1,323,273,596
"FARYAB","KOHISTAN",2910122,2,267,323,590
"FARYAB","KOHISTAN",2910121,3,512,72,584
"FARYAB","KOHISTAN",2910115,1,355,237,592
"FARYAB","KOHISTAN",2910205,2,566,21,587
"FARYAB","KOHISTAN",2910120,4,576,16,592
"FARYAB","KOHISTAN",2910120,3,561,39,600
"FARYAB","KOHISTAN",2910115,2,395,204,599
"FARYAB","KOHISTAN",2910120,1,580,17,597
"FARYAB","KOHISTAN",2910120,2,564,33,597
"FARYAB","KOHISTAN",2910215,1,536,64,600
"FARYAB","KOHISTAN",2910205,1,558,30,588
"FARYAB","KOHISTAN",2910113,1,550,50,600
"FARYAB","KOHISTAN",2910113,2,358,40,398
"FARYAB","KOHISTAN",2910117,2,442,134,576
"FARYAB","KOHISTAN",2910115,3,454,144,598
"FARYAB","KOHISTAN",2910214,3,494,105,599
"FARYAB","KOHISTAN",2910214,1,495,105,600
"FARYAB","KOHISTAN",2910117,1,488,109,597
"FARYAB","KOHISTAN",2910214,2,547,51,598
"FARYAB","KOHISTAN",2910215,3,554,46,600
"FARYAB","KOHISTAN",2910215,2,565,35,600
"FARYAB","QARAM QUL",2911173,2,29,285,314
"FARYAB","QARAM QUL",2911216,2,5,237,242
"FARYAB","QARAM QUL",2911174,3,132,188,320
"FARYAB","QARAM QUL",2911172,1,138,58,196
"FARYAB","QARAM QUL",2911173,1,14,316,330
"FARYAB","QARAM QUL",2911216,1,6,295,301
"FARYAB","QARAM QUL",2911170,4,27,43,70
"FARYAB","QARAM QUL",2911171,2,85,76,161
"FARYAB","QARAM QUL",2911216,3,4,504,508
"FARYAB","QARAM QUL",2911173,4,9,478,487
"FARYAB","QARAM QUL",2911170,1,15,28,43
"FARYAB","QARAM QUL",2911174,1,177,159,336
"FARYAB","QARAM QUL",2911173,3,29,470,499
"FARYAB","QARAM QUL",2911172,2,50,21,71
"FARYAB","QARAM QUL",2911174,4,143,180,323
"FARYAB","QARAM QUL",2911171,1,89,84,173
"FARYAB","QARAM QUL",2911170,3,26,38,64
"FARYAB","QARAM QUL",2911171,3,11,45,56
"FARYAB","QARAM QUL",2911171,4,10,28,38
"FARYAB","QARAM QUL",2911170,2,24,31,55
"FARYAB","QARAM QUL",2911174,2,178,132,310
"FARYAB","QURGHAN",2912193,2,31,159,190
"FARYAB","QURGHAN",2912191,1,115,84,199
"FARYAB","QURGHAN",2912194,3,57,230,287
"FARYAB","QURGHAN",2912197,1,86,236,322
"FARYAB","QURGHAN",2912197,3,33,257,290
"FARYAB","QURGHAN",2912197,4,43,325,368
"FARYAB","QURGHAN",2912190,1,64,162,226
"FARYAB","QURGHAN",2912197,2,61,273,334
"FARYAB","QURGHAN",2912193,1,34,87,121
"FARYAB","QURGHAN",2912194,1,253,338,591
"FARYAB","QURGHAN",2912198,4,11,515,526
"FARYAB","QURGHAN",2912190,2,66,153,219
"FARYAB","QURGHAN",2912193,3,26,204,230
"FARYAB","QURGHAN",2912194,2,63,147,210
"FARYAB","QURGHAN",2912196,3,18,134,152
"FARYAB","QURGHAN",2912198,3,21,575,596
"FARYAB","QURGHAN",2912190,3,70,158,228
"FARYAB","QURGHAN",2912191,2,26,35,61
"FARYAB","QURGHAN",2912195,1,14,319,333
"FARYAB","QURGHAN",2912195,2,15,254,269
"FARYAB","QURGHAN",2912192,2,146,225,371
"FARYAB","QURGHAN",2912196,2,19,105,124
"FARYAB","QURGHAN",2912198,1,36,258,294
"FARYAB","QURGHAN",2912198,2,42,271,313
"FARYAB","QURGHAN",2912195,3,10,196,206
"FARYAB","QURGHAN",2912195,4,7,410,417
"FARYAB","QURGHAN",2912190,4,18,137,155
"FARYAB","QURGHAN",2912192,1,301,259,560
"FARYAB","QURGHAN",2912196,1,22,63,85
"FARYAB","QURGHAN",2912190,5,3,168,171
"FARYAB","QURGHAN",2912195,5,10,519,529
"FARYAB","ANDKHOY",2913184,5,5,568,573
"FARYAB","ANDKHOY",2913182,5,8,484,492
"FARYAB","ANDKHOY",2913182,2,39,553,592
"FARYAB","ANDKHOY",2913182,1,46,540,586
"FARYAB","ANDKHOY",2913183,1,9,470,479
"FARYAB","ANDKHOY",2913181,2,34,525,559
"FARYAB","ANDKHOY",2913187,4,13,578,591
"FARYAB","ANDKHOY",2913184,1,3,370,373
"FARYAB","ANDKHOY",2913181,1,25,567,592
"FARYAB","ANDKHOY",2913182,6,16,121,137
"FARYAB","ANDKHOY",2913181,7,11,582,593
"FARYAB","ANDKHOY",2913188,5,11,579,590
"FARYAB","ANDKHOY",2913184,2,3,386,389
"FARYAB","ANDKHOY",2913182,4,8,398,406
"FARYAB","ANDKHOY",2913184,4,13,576,589
"FARYAB","ANDKHOY",2913186,5,20,570,590
"FARYAB","ANDKHOY",2913187,5,13,470,483
"FARYAB","ANDKHOY",2913182,3,12,465,477
"FARYAB","ANDKHOY",2913187,2,20,306,326
"FARYAB","ANDKHOY",2913187,3,14,334,348
"FARYAB","ANDKHOY",2913189,5,2,543,545
"FARYAB","ANDKHOY",2913181,3,31,563,594
"FARYAB","ANDKHOY",2913186,3,38,458,496
"FARYAB","ANDKHOY",2913181,4,17,576,593
"FARYAB","ANDKHOY",2913189,4,5,419,424
"FARYAB","ANDKHOY",2913187,1,18,418,436
"FARYAB","ANDKHOY",2913188,2,14,463,477
"FARYAB","ANDKHOY",2913186,4,24,565,589
"FARYAB","ANDKHOY",2913188,4,9,580,589
"FARYAB","ANDKHOY",2913188,1,16,399,415
"FARYAB","ANDKHOY",2913183,4,5,472,477
"FARYAB","ANDKHOY",2913188,3,17,476,493
"FARYAB","ANDKHOY",2913183,2,8,372,380
"FARYAB","ANDKHOY",2913181,6,12,576,588
"FARYAB","ANDKHOY",2913186,2,16,405,421
"FARYAB","ANDKHOY",2913183,5,6,475,481
"FARYAB","ANDKHOY",2913183,6,5,497,502
"FARYAB","ANDKHOY",2913184,3,4,386,390
"FARYAB","ANDKHOY",2913183,3,7,423,430
"FARYAB","ANDKHOY",2913189,3,6,162,168
"FARYAB","ANDKHOY",2913185,4,2,452,454
"FARYAB","ANDKHOY",2913185,1,38,479,517
"FARYAB","ANDKHOY",2913186,1,46,552,598
"FARYAB","ANDKHOY",2913185,3,26,394,420
"FARYAB","ANDKHOY",2913189,1,5,316,321
"FARYAB","ANDKHOY",2913185,5,7,467,474
"FARYAB","ANDKHOY",2913189,2,5,227,232
"FARYAB","ANDKHOY",2913185,2,40,549,589
"FARYAB","ANDKHOY",2913181,5,3,587,590
"FARYAB","KHANI CHARBA",2914178,6,13,284,297
"FARYAB","KHANI CHARBA",2914175,1,25,187,212
"FARYAB","KHANI CHARBA",2914175,2,20,182,202
"FARYAB","KHANI CHARBA",2914178,5,10,343,353
"FARYAB","KHANI CHARBA",2914179,1,49,352,401
"FARYAB","KHANI CHARBA",2914178,4,12,162,174
"FARYAB","KHANI CHARBA",2914178,2,31,88,119
"FARYAB","KHANI CHARBA",2914178,3,18,98,116
"FARYAB","KHANI CHARBA",2914176,3,10,54,64
"FARYAB","KHANI CHARBA",2914178,7,14,155,169
"FARYAB","KHANI CHARBA",2914176,1,6,65,71
"FARYAB","KHANI CHARBA",2914179,2,15,469,484
"FARYAB","KHANI CHARBA",2914178,1,40,114,154
"FARYAB","KHANI CHARBA",2914175,6,41,538,579
"FARYAB","KHANI CHARBA",2914175,3,30,245,275
"FARYAB","KHANI CHARBA",2914175,4,36,366,402
"FARYAB","KHANI CHARBA",2914176,2,6,82,88
"FARYAB","KHANI CHARBA",2914177,4,20,565,585
"FARYAB","KHANI CHARBA",2914177,2,26,283,309
"FARYAB","KHANI CHARBA",2914176,4,5,204,209
"FARYAB","KHANI CHARBA",2914180,2,28,527,555
"FARYAB","KHANI CHARBA",2914175,5,29,561,590
"FARYAB","KHANI CHARBA",2914177,1,34,254,288
"FARYAB","KHANI CHARBA",2914177,3,24,185,209
"FARYAB","KHANI CHARBA",2914180,1,69,518,587
"HELMAND","LASHKARGAH",3001010,1,117,163,280
"HELMAND","LASHKARGAH",3001012,5,104,167,271
"HELMAND","LASHKARGAH",3001010,5,39,82,121
"HELMAND","LASHKARGAH",3001005,7,13,87,100
"HELMAND","LASHKARGAH",3001007,5,65,75,140
"HELMAND","LASHKARGAH",3001007,6,52,104,156
"HELMAND","LASHKARGAH",3001005,6,29,89,118
"HELMAND","LASHKARGAH",3001012,4,154,203,357
"HELMAND","LASHKARGAH",3001012,2,228,211,439
"HELMAND","LASHKARGAH",3001012,3,191,283,474
"HELMAND","LASHKARGAH",3001012,1,154,243,397
"HELMAND","LASHKARGAH",3001007,4,57,74,131
"HELMAND","LASHKARGAH",3001024,2,20,67,87
"HELMAND","LASHKARGAH",3001024,3,7,35,42
"HELMAND","LASHKARGAH",3001022,5,32,103,135
"HELMAND","LASHKARGAH",3001022,2,71,255,326
"HELMAND","LASHKARGAH",3001002,1,66,493,559
"HELMAND","LASHKARGAH",3001002,2,64,349,413
"HELMAND","LASHKARGAH",3001024,4,13,6,19
"HELMAND","LASHKARGAH",3001024,5,2,11,13
"HELMAND","LASHKARGAH",3001015,3,27,111,138
"HELMAND","LASHKARGAH",3001022,7,5,12,17
"HELMAND","LASHKARGAH",3001002,3,64,164,228
"HELMAND","LASHKARGAH",3001015,2,51,239,290
"HELMAND","LASHKARGAH",3001024,1,19,125,144
"HELMAND","LASHKARGAH",3001015,9,5,37,42
"HELMAND","LASHKARGAH",3001015,10,10,27,37
"HELMAND","LASHKARGAH",3001019,1,12,25,37
"HELMAND","LASHKARGAH",3001019,2,3,4,7
"HELMAND","LASHKARGAH",3001010,2,22,69,91
"HELMAND","LASHKARGAH",3001010,3,26,75,101
"HELMAND","LASHKARGAH",3001010,4,52,95,147
"HELMAND","LASHKARGAH",3001013,1,66,374,440
"HELMAND","LASHKARGAH",3001010,6,25,51,76
"HELMAND","LASHKARGAH",3001015,4,22,177,199
"HELMAND","LASHKARGAH",3001015,5,12,43,55
"HELMAND","LASHKARGAH",3001022,8,7,4,11
"HELMAND","LASHKARGAH",3001007,2,50,115,165
"HELMAND","LASHKARGAH",3001007,3,48,86,134
"HELMAND","LASHKARGAH",3001013,8,9,67,76
"HELMAND","LASHKARGAH",3001013,9,9,107,116
"HELMAND","LASHKARGAH",3001013,10,24,27,51
"HELMAND","LASHKARGAH",3001022,1,76,207,283
"HELMAND","LASHKARGAH",3001027,3,1,0,1
"HELMAND","LASHKARGAH",3001008,1,216,152,368
"HELMAND","LASHKARGAH",3001022,3,43,166,209
"HELMAND","LASHKARGAH",3001022,4,20,126,146
"HELMAND","LASHKARGAH",3001022,6,7,15,22
"HELMAND","LASHKARGAH",3001008,5,384,185,569
"HELMAND","LASHKARGAH",3001008,6,19,7,26
"HELMAND","LASHKARGAH",3001021,2,4,228,232
"HELMAND","LASHKARGAH",3001021,3,4,225,229
"HELMAND","LASHKARGAH",3001021,4,7,16,23
"HELMAND","LASHKARGAH",3001021,5,11,262,273
"HELMAND","LASHKARGAH",3001021,6,1,5,6
"HELMAND","LASHKARGAH",3001018,1,1,8,9
"HELMAND","LASHKARGAH",3001018,2,13,18,31
"HELMAND","LASHKARGAH",3001018,3,0,106,106
"HELMAND","LASHKARGAH",3001018,4,3,35,38
"HELMAND","LASHKARGAH",3001015,1,66,314,380
"HELMAND","LASHKARGAH",3001004,1,34,192,226
"HELMAND","LASHKARGAH",3001004,2,34,101,135
"HELMAND","LASHKARGAH",3001004,3,21,98,119
"HELMAND","LASHKARGAH",3001015,6,16,45,61
"HELMAND","LASHKARGAH",3001015,7,4,42,46
"HELMAND","LASHKARGAH",3001015,8,5,36,41
"HELMAND","LASHKARGAH",3001005,3,68,277,345
"HELMAND","LASHKARGAH",3001005,4,37,161,198
"HELMAND","LASHKARGAH",3001005,5,20,109,129
"HELMAND","LASHKARGAH",3001019,3,1,12,13
"HELMAND","LASHKARGAH",3001019,4,6,65,71
"HELMAND","LASHKARGAH",3001019,5,6,64,70
"HELMAND","LASHKARGAH",3001030,2,31,106,137
"HELMAND","LASHKARGAH",3001013,2,36,211,247
"HELMAND","LASHKARGAH",3001010,7,59,148,207
"HELMAND","LASHKARGAH",3001010,8,138,305,443
"HELMAND","LASHKARGAH",3001007,1,62,134,196
"HELMAND","LASHKARGAH",3001013,6,32,282,314
"HELMAND","LASHKARGAH",3001013,7,8,90,98
"HELMAND","LASHKARGAH",3001017,1,23,104,127
"HELMAND","LASHKARGAH",3001017,2,23,85,108
"HELMAND","LASHKARGAH",3001017,3,28,80,108
"HELMAND","LASHKARGAH",3001017,4,32,77,109
"HELMAND","LASHKARGAH",3001017,5,17,85,102
"HELMAND","LASHKARGAH",3001028,1,15,14,29
"HELMAND","LASHKARGAH",3001028,2,3,5,8
"HELMAND","LASHKARGAH",3001008,2,182,186,368
"HELMAND","LASHKARGAH",3001008,4,425,164,589
"HELMAND","LASHKARGAH",3001020,6,9,4,13
"HELMAND","LASHKARGAH",3001021,1,170,41,211
"HELMAND","LASHKARGAH",3001006,1,1,5,6
"HELMAND","LASHKARGAH",3001006,2,3,5,8
"HELMAND","LASHKARGAH",3001006,3,2,8,10
"HELMAND","LASHKARGAH",3001029,1,22,18,40
"HELMAND","LASHKARGAH",3001029,2,6,14,20
"HELMAND","LASHKARGAH",3001029,3,1,9,10
"HELMAND","LASHKARGAH",3001025,1,9,75,84
"HELMAND","LASHKARGAH",3001025,2,4,42,46
"HELMAND","LASHKARGAH",3001025,3,1,7,8
"HELMAND","LASHKARGAH",3001025,4,2,14,16
"HELMAND","LASHKARGAH",3001002,4,44,183,227
"HELMAND","LASHKARGAH",3001002,5,45,159,204
"HELMAND","LASHKARGAH",3001011,2,225,222,447
"HELMAND","LASHKARGAH",3001004,4,14,139,153
"HELMAND","LASHKARGAH",3001004,5,14,89,103
"HELMAND","LASHKARGAH",3001004,6,16,83,99
"HELMAND","LASHKARGAH",3001005,1,65,300,365
"HELMAND","LASHKARGAH",3001005,2,55,267,322
"HELMAND","LASHKARGAH",3001033,2,6,11,17
"HELMAND","LASHKARGAH",3001033,3,0,13,13
"HELMAND","LASHKARGAH",3001033,4,2,6,8
"HELMAND","LASHKARGAH",3001030,1,49,90,139
"HELMAND","LASHKARGAH",3001016,4,38,290,328
"HELMAND","LASHKARGAH",3001030,3,71,172,243
"HELMAND","LASHKARGAH",3001013,3,30,185,215
"HELMAND","LASHKARGAH",3001013,4,14,198,212
"HELMAND","LASHKARGAH",3001013,5,26,195,221
"HELMAND","LASHKARGAH",3001030,6,4,22,26
"HELMAND","LASHKARGAH",3001031,1,86,115,201
"HELMAND","LASHKARGAH",3001031,2,66,59,125
"HELMAND","LASHKARGAH",3001031,3,55,71,126
"HELMAND","LASHKARGAH",3001031,4,53,30,83
"HELMAND","LASHKARGAH",3001031,5,44,30,74
"HELMAND","LASHKARGAH",3001031,6,12,30,42
"HELMAND","LASHKARGAH",3001020,1,10,26,36
"HELMAND","LASHKARGAH",3001020,2,7,22,29
"HELMAND","LASHKARGAH",3001028,3,8,18,26
"HELMAND","LASHKARGAH",3001008,3,111,100,211
"HELMAND","LASHKARGAH",3001020,5,1,6,7
"HELMAND","LASHKARGAH",3001001,1,14,58,72
"HELMAND","LASHKARGAH",3001001,3,6,39,45
"HELMAND","LASHKARGAH",3001001,5,2,11,13
"HELMAND","LASHKARGAH",3001026,2,10,17,27
"HELMAND","LASHKARGAH",3001006,4,1,2,3
"HELMAND","LASHKARGAH",3001006,5,4,3,7
"HELMAND","LASHKARGAH",3001003,1,17,51,68
"HELMAND","LASHKARGAH",3001003,2,28,93,121
"HELMAND","LASHKARGAH",3001003,3,33,103,136
"HELMAND","LASHKARGAH",3001003,4,33,145,178
"HELMAND","LASHKARGAH",3001003,5,37,84,121
"HELMAND","LASHKARGAH",3001003,6,75,220,295
"HELMAND","LASHKARGAH",3001011,1,264,271,535
"HELMAND","LASHKARGAH",3001030,4,7,9,16
"HELMAND","LASHKARGAH",3001025,5,0,9,9
"HELMAND","LASHKARGAH",3001026,1,8,17,25
"HELMAND","LASHKARGAH",3001014,3,21,46,67
"HELMAND","LASHKARGAH",3001026,4,2,0,2
"HELMAND","LASHKARGAH",3001033,1,3,3,6
"HELMAND","LASHKARGAH",3001011,6,142,26,168
"HELMAND","LASHKARGAH",3001016,2,14,254,268
"HELMAND","LASHKARGAH",3001011,7,75,30,105
"HELMAND","LASHKARGAH",3001011,8,193,59,252
"HELMAND","LASHKARGAH",3001016,1,77,459,536
"HELMAND","LASHKARGAH",3001014,2,31,97,128
"HELMAND","LASHKARGAH",3001016,5,9,64,73
"HELMAND","LASHKARGAH",3001028,4,0,2,2
"HELMAND","LASHKARGAH",3001030,5,5,13,18
"HELMAND","LASHKARGAH",3001011,5,118,14,132
"HELMAND","LASHKARGAH",3001014,1,39,129,168
"HELMAND","LASHKARGAH",3001014,5,14,37,51
"HELMAND","LASHKARGAH",3001014,6,19,44,63
"HELMAND","LASHKARGAH",3001027,1,26,59,85
"HELMAND","LASHKARGAH",3001020,3,0,19,19
"HELMAND","LASHKARGAH",3001020,4,0,7,7
"HELMAND","LASHKARGAH",3001031,7,27,22,49
"HELMAND","LASHKARGAH",3001016,6,5,69,74
"HELMAND","LASHKARGAH",3001016,7,5,30,35
"HELMAND","LASHKARGAH",3001016,3,23,230,253
"HELMAND","LASHKARGAH",3001011,3,163,112,275
"HELMAND","LASHKARGAH",3001011,4,179,86,265
"HELMAND","LASHKARGAH",3001027,2,8,61,69
"HELMAND","NAD ALI",3002084,3,11,34,45
"HELMAND","NAD ALI",3002084,1,14,47,61
"HELMAND","NAD ALI",3002084,2,8,40,48
"HELMAND","NAD ALI",3002081,3,5,33,38
"HELMAND","NAD ALI",3002066,2,28,164,192
"HELMAND","NAD ALI",3002070,4,4,116,120
"HELMAND","NAD ALI",3002062,7,3,24,27
"HELMAND","NAD ALI",3002067,2,7,5,12
"HELMAND","NAD ALI",3002068,1,7,23,30
"HELMAND","NAD ALI",3002067,5,7,1,8
"HELMAND","NAD ALI",3002067,6,4,0,4
"HELMAND","NAD ALI",3002084,4,10,35,45
"HELMAND","NAD ALI",3002067,3,8,3,11
"HELMAND","NAD ALI",3002065,1,10,187,197
"HELMAND","NAD ALI",3002065,3,4,43,47
"HELMAND","NAD ALI",3002066,3,18,130,148
"HELMAND","NAD ALI",3002079,1,58,30,88
"HELMAND","NAD ALI",3002079,2,78,17,95
"HELMAND","NAD ALI",3002062,6,1,18,19
"HELMAND","NAD ALI",3002079,3,75,3,78
"HELMAND","NAD ALI",3002079,4,76,1,77
"HELMAND","NAD ALI",3002080,1,15,299,314
"HELMAND","NAD ALI",3002080,2,14,197,211
"HELMAND","NAD ALI",3002080,3,5,75,80
"HELMAND","NAD ALI",3002080,4,1,82,83
"HELMAND","NAD ALI",3002070,1,28,568,596
"HELMAND","NAD ALI",3002070,2,30,521,551
"HELMAND","NAD ALI",3002070,3,15,523,538
"HELMAND","NAD ALI",3002066,1,10,165,175
"HELMAND","NAD ALI",3002069,1,21,46,67
"HELMAND","NAD ALI",3002062,5,3,9,12
"HELMAND","NAD ALI",3002069,3,10,11,21
"HELMAND","NAD ALI",3002071,1,28,113,141
"HELMAND","NAD ALI",3002071,2,5,66,71
"HELMAND","NAD ALI",3002081,1,10,65,75
"HELMAND","NAD ALI",3002081,2,10,31,41
"HELMAND","NAD ALI",3002067,1,24,15,39
"HELMAND","NAD ALI",3002068,2,9,15,24
"HELMAND","NAD ALI",3002068,3,8,9,17
"HELMAND","NAD ALI",3002068,4,6,10,16
"HELMAND","NAD ALI",3002062,1,6,25,31
"HELMAND","NAD ALI",3002065,2,5,67,72
"HELMAND","NAD ALI",3002062,2,3,8,11
"HELMAND","NAD ALI",3002069,2,9,36,45
"HELMAND","NAD ALI",3002224,2,15,18,33
"HELMAND","NAD ALI",3002224,3,0,1,1
"HELMAND","NAD ALI",3002223,1,22,60,82
"HELMAND","NAD ALI",3002223,2,15,75,90
"HELMAND","NAD ALI",3002223,3,0,2,2
"HELMAND","NAD ALI",3002078,3,29,108,137
"HELMAND","NAD ALI",3002224,1,37,74,111
"HELMAND","NAD ALI",3002078,1,21,113,134
"HELMAND","NAD ALI",3002078,2,10,63,73
"HELMAND","NAD ALI",3002062,3,1,7,8
"HELMAND","NAD ALI",3002078,4,3,0,3
"HELMAND","NAD ALI",3002071,4,2,36,38
"HELMAND","NAD ALI",3002062,4,3,10,13
"HELMAND","NAWA-E-BARAKZAYI",3003096,2,2,13,15
"HELMAND","NAWA-E-BARAKZAYI",3003108,3,1,12,13
"HELMAND","NAWA-E-BARAKZAYI",3003098,1,34,91,125
"HELMAND","NAWA-E-BARAKZAYI",3003092,1,13,295,308
"HELMAND","NAWA-E-BARAKZAYI",3003094,1,39,56,95
"HELMAND","NAWA-E-BARAKZAYI",3003092,3,14,214,228
"HELMAND","NAWA-E-BARAKZAYI",3003103,3,20,29,49
"HELMAND","NAWA-E-BARAKZAYI",3003102,2,2,15,17
"HELMAND","NAWA-E-BARAKZAYI",3003102,3,1,7,8
"HELMAND","NAWA-E-BARAKZAYI",3003090,1,2,97,99
"HELMAND","NAWA-E-BARAKZAYI",3003102,1,8,100,108
"HELMAND","NAWA-E-BARAKZAYI",3003108,2,7,23,30
"HELMAND","NAWA-E-BARAKZAYI",3003097,4,19,163,182
"HELMAND","NAWA-E-BARAKZAYI",3003108,4,2,0,2
"HELMAND","NAWA-E-BARAKZAYI",3003090,2,4,170,174
"HELMAND","NAWA-E-BARAKZAYI",3003098,4,2,5,7
"HELMAND","NAWA-E-BARAKZAYI",3003091,1,5,87,92
"HELMAND","NAWA-E-BARAKZAYI",3003092,2,4,413,417
"HELMAND","NAWA-E-BARAKZAYI",3003091,3,0,57,57
"HELMAND","NAWA-E-BARAKZAYI",3003105,3,22,36,58
"HELMAND","NAWA-E-BARAKZAYI",3003094,2,19,12,31
"HELMAND","NAWA-E-BARAKZAYI",3003094,3,12,10,22
"HELMAND","NAWA-E-BARAKZAYI",3003094,4,33,154,187
"HELMAND","NAWA-E-BARAKZAYI",3003106,1,28,40,68
"HELMAND","NAWA-E-BARAKZAYI",3003108,1,8,32,40
"HELMAND","NAWA-E-BARAKZAYI",3003090,4,0,9,9
"HELMAND","NAWA-E-BARAKZAYI",3003103,1,65,126,191
"HELMAND","NAWA-E-BARAKZAYI",3003103,2,32,52,84
"HELMAND","NAWA-E-BARAKZAYI",3003100,3,26,33,59
"HELMAND","NAWA-E-BARAKZAYI",3003107,1,12,32,44
"HELMAND","NAWA-E-BARAKZAYI",3003107,2,12,26,38
"HELMAND","NAWA-E-BARAKZAYI",3003107,3,8,27,35
"HELMAND","NAWA-E-BARAKZAYI",3003096,1,1,23,24
"HELMAND","NAWA-E-BARAKZAYI",3003095,4,4,50,54
"HELMAND","NAWA-E-BARAKZAYI",3003096,3,5,52,57
"HELMAND","NAWA-E-BARAKZAYI",3003096,4,0,3,3
"HELMAND","NAWA-E-BARAKZAYI",3003097,2,12,295,307
"HELMAND","NAWA-E-BARAKZAYI",3003090,3,6,78,84
"HELMAND","NAWA-E-BARAKZAYI",3003097,3,58,386,444
"HELMAND","NAWA-E-BARAKZAYI",3003098,2,31,45,76
"HELMAND","NAWA-E-BARAKZAYI",3003098,3,14,62,76
"HELMAND","NAWA-E-BARAKZAYI",3003089,3,14,88,102
"HELMAND","NAWA-E-BARAKZAYI",3003089,4,8,17,25
"HELMAND","NAWA-E-BARAKZAYI",3003103,4,9,26,35
"HELMAND","NAWA-E-BARAKZAYI",3003103,5,4,53,57
"HELMAND","NAWA-E-BARAKZAYI",3003101,1,24,99,123
"HELMAND","NAWA-E-BARAKZAYI",3003101,2,10,114,124
"HELMAND","NAWA-E-BARAKZAYI",3003101,3,18,140,158
"HELMAND","NAWA-E-BARAKZAYI",3003093,1,20,71,91
"HELMAND","NAWA-E-BARAKZAYI",3003093,2,12,65,77
"HELMAND","NAWA-E-BARAKZAYI",3003093,3,21,66,87
"HELMAND","NAWA-E-BARAKZAYI",3003093,4,24,112,136
"HELMAND","NAWA-E-BARAKZAYI",3003089,1,8,16,24
"HELMAND","NAWA-E-BARAKZAYI",3003089,2,6,46,52
"HELMAND","NAWA-E-BARAKZAYI",3003100,2,6,30,36
"HELMAND","NAWA-E-BARAKZAYI",3003099,2,4,33,37
"HELMAND","NAWA-E-BARAKZAYI",3003105,1,9,16,25
"HELMAND","NAWA-E-BARAKZAYI",3003091,2,7,67,74
"HELMAND","NAWA-E-BARAKZAYI",3003105,2,8,19,27
"HELMAND","NAWA-E-BARAKZAYI",3003095,3,10,86,96
"HELMAND","NAWA-E-BARAKZAYI",3003104,3,9,21,30
"HELMAND","NAWA-E-BARAKZAYI",3003105,4,14,56,70
"HELMAND","NAWA-E-BARAKZAYI",3003104,1,6,99,105
"HELMAND","NAWA-E-BARAKZAYI",3003104,2,10,40,50
"HELMAND","NAWA-E-BARAKZAYI",3003104,5,8,43,51
"HELMAND","NAWA-E-BARAKZAYI",3003099,3,4,15,19
"HELMAND","NAWA-E-BARAKZAYI",3003106,2,17,30,47
"HELMAND","NAWA-E-BARAKZAYI",3003100,1,16,58,74
"HELMAND","NAWA-E-BARAKZAYI",3003097,1,27,241,268
"HELMAND","NAWA-E-BARAKZAYI",3003095,1,13,63,76
"HELMAND","NAWA-E-BARAKZAYI",3003095,2,12,54,66
"HELMAND","NAWA-E-BARAKZAYI",3003099,1,11,68,79
"HELMAND","NAWA-E-BARAKZAYI",3003104,4,7,31,38
"HELMAND","NAHR-E-SARAJ",3004041,4,18,88,106
"HELMAND","NAHR-E-SARAJ",3004055,1,2,5,7
"HELMAND","NAHR-E-SARAJ",3004057,3,26,26,52
"HELMAND","NAHR-E-SARAJ",3004054,1,6,8,14
"HELMAND","NAHR-E-SARAJ",3004034,1,80,50,130
"HELMAND","NAHR-E-SARAJ",3004040,2,46,4,50
"HELMAND","NAHR-E-SARAJ",3004057,4,16,10,26
"HELMAND","NAHR-E-SARAJ",3004041,6,35,36,71
"HELMAND","NAHR-E-SARAJ",3004038,1,68,143,211
"HELMAND","NAHR-E-SARAJ",3004041,3,33,102,135
"HELMAND","NAHR-E-SARAJ",3004041,5,17,40,57
"HELMAND","NAHR-E-SARAJ",3004035,5,40,81,121
"HELMAND","NAHR-E-SARAJ",3004035,6,14,7,21
"HELMAND","NAHR-E-SARAJ",3004035,7,16,11,27
"HELMAND","NAHR-E-SARAJ",3004035,4,84,120,204
"HELMAND","NAHR-E-SARAJ",3004049,2,0,28,28
"HELMAND","NAHR-E-SARAJ",3004043,1,7,11,18
"HELMAND","NAHR-E-SARAJ",3004043,2,14,8,22
"HELMAND","NAHR-E-SARAJ",3004049,1,2,33,35
"HELMAND","NAHR-E-SARAJ",3004034,5,2,5,7
"HELMAND","NAHR-E-SARAJ",3004035,1,139,217,356
"HELMAND","NAHR-E-SARAJ",3004035,2,150,213,363
"HELMAND","NAHR-E-SARAJ",3004043,3,17,23,40
"HELMAND","NAHR-E-SARAJ",3004053,2,6,6,12
"HELMAND","NAHR-E-SARAJ",3004052,1,31,31,62
"HELMAND","NAHR-E-SARAJ",3004059,1,22,24,46
"HELMAND","NAHR-E-SARAJ",3004059,2,18,28,46
"HELMAND","NAHR-E-SARAJ",3004040,1,38,4,42
"HELMAND","NAHR-E-SARAJ",3004055,2,4,22,26
"HELMAND","NAHR-E-SARAJ",3004036,1,194,38,232
"HELMAND","NAHR-E-SARAJ",3004036,2,88,20,108
"HELMAND","NAHR-E-SARAJ",3004036,3,127,33,160
"HELMAND","NAHR-E-SARAJ",3004043,4,6,15,21
"HELMAND","NAHR-E-SARAJ",3004051,1,6,46,52
"HELMAND","NAHR-E-SARAJ",3004051,2,3,45,48
"HELMAND","NAHR-E-SARAJ",3004035,3,67,133,200
"HELMAND","NAHR-E-SARAJ",3004056,2,7,12,19
"HELMAND","NAHR-E-SARAJ",3004056,3,3,8,11
"HELMAND","NAHR-E-SARAJ",3004057,1,31,28,59
"HELMAND","NAHR-E-SARAJ",3004057,2,34,23,57
"HELMAND","NAHR-E-SARAJ",3004038,4,48,27,75
"HELMAND","NAHR-E-SARAJ",3004038,5,36,99,135
"HELMAND","NAHR-E-SARAJ",3004040,3,20,49,69
"HELMAND","NAHR-E-SARAJ",3004040,4,25,11,36
"HELMAND","NAHR-E-SARAJ",3004039,3,41,23,64
"HELMAND","NAHR-E-SARAJ",3004034,2,68,56,124
"HELMAND","NAHR-E-SARAJ",3004034,3,113,33,146
"HELMAND","NAHR-E-SARAJ",3004041,1,28,139,167
"HELMAND","NAHR-E-SARAJ",3004053,1,7,4,11
"HELMAND","NAHR-E-SARAJ",3004058,4,0,1,1
"HELMAND","NAHR-E-SARAJ",3004039,4,53,31,84
"HELMAND","NAHR-E-SARAJ",3004038,2,42,108,150
"HELMAND","NAHR-E-SARAJ",3004038,3,33,73,106
"HELMAND","NAHR-E-SARAJ",3004041,2,20,46,66
"HELMAND","NAHR-E-SARAJ",3004056,1,9,39,48
"HELMAND","NAHR-E-SARAJ",3004039,1,73,46,119
"HELMAND","NAHR-E-SARAJ",3004039,2,84,45,129
"HELMAND","NAHR-E-SARAJ",3004052,2,11,11,22
"HELMAND","NAHR-E-SARAJ",3004058,3,0,4,4
"HELMAND","NAHR-E-SARAJ",3004058,1,6,8,14
"HELMAND","NAHR-E-SARAJ",3004058,2,4,2,6
"HELMAND","NAHR-E-SARAJ",3004036,5,140,98,238
"HELMAND","NAHR-E-SARAJ",3004036,6,117,66,183
"HELMAND","NAHR-E-SARAJ",3004036,4,54,20,74
"HELMAND","NAHR-E-SARAJ",3004034,4,4,4,8
"HELMAND","WASHER",3005211,2,10,63,73
"HELMAND","WASHER",3005211,8,111,113,224
"HELMAND","WASHER",3005211,3,13,34,47
"HELMAND","WASHER",3005211,1,10,62,72
"HELMAND","WASHER",3005211,7,167,180,347
"HELMAND","WASHER",3005211,10,172,208,380
"HELMAND","WASHER",3005211,9,108,94,202
"HELMAND","WASHER",3005211,4,7,32,39
"HELMAND","WASHER",3005211,11,162,161,323
"HELMAND","GARM SER",3006113,5,13,137,150
"HELMAND","GARM SER",3006110,1,28,110,138
"HELMAND","GARM SER",3006115,2,19,100,119
"HELMAND","GARM SER",3006115,3,37,178,215
"HELMAND","GARM SER",3006120,3,23,69,92
"HELMAND","GARM SER",3006114,3,17,45,62
"HELMAND","GARM SER",3006116,3,33,55,88
"HELMAND","GARM SER",3006116,4,28,62,90
"HELMAND","GARM SER",3006116,1,32,24,56
"HELMAND","GARM SER",3006115,1,17,83,100
"HELMAND","GARM SER",3006111,3,1,48,49
"HELMAND","GARM SER",3006113,1,11,164,175
"HELMAND","GARM SER",3006113,2,14,100,114
"HELMAND","GARM SER",3006116,2,30,37,67
"HELMAND","GARM SER",3006113,4,5,88,93
"HELMAND","GARM SER",3006123,3,60,328,388
"HELMAND","GARM SER",3006125,1,26,162,188
"HELMAND","GARM SER",3006113,3,6,59,65
"HELMAND","GARM SER",3006120,1,45,69,114
"HELMAND","GARM SER",3006119,3,7,41,48
"HELMAND","GARM SER",3006119,4,19,41,60
"HELMAND","GARM SER",3006125,2,37,197,234
"HELMAND","GARM SER",3006114,2,12,41,53
"HELMAND","GARM SER",3006121,3,3,80,83
"HELMAND","GARM SER",3006118,1,58,183,241
"HELMAND","GARM SER",3006114,4,5,35,40
"HELMAND","GARM SER",3006112,1,17,43,60
"HELMAND","GARM SER",3006112,2,73,62,135
"HELMAND","GARM SER",3006124,1,7,18,25
"HELMAND","GARM SER",3006124,2,6,30,36
"HELMAND","GARM SER",3006119,1,16,83,99
"HELMAND","GARM SER",3006119,2,34,168,202
"HELMAND","GARM SER",3006111,2,7,32,39
"HELMAND","GARM SER",3006225,1,28,92,120
"HELMAND","GARM SER",3006121,1,15,203,218
"HELMAND","GARM SER",3006114,1,25,81,106
"HELMAND","GARM SER",3006109,1,30,55,85
"HELMAND","GARM SER",3006109,2,11,21,32
"HELMAND","GARM SER",3006118,2,56,148,204
"HELMAND","GARM SER",3006118,3,19,39,58
"HELMAND","GARM SER",3006121,2,14,136,150
"HELMAND","GARM SER",3006110,3,0,2,2
"HELMAND","GARM SER",3006109,3,12,20,32
"HELMAND","GARM SER",3006225,2,21,101,122
"HELMAND","GARM SER",3006126,1,54,150,204
"HELMAND","GARM SER",3006126,2,36,111,147
"HELMAND","GARM SER",3006123,1,40,290,330
"HELMAND","GARM SER",3006123,2,55,228,283
"HELMAND","GARM SER",3006117,2,20,90,110
"HELMAND","GARM SER",3006110,2,49,76,125
"HELMAND","GARM SER",3006111,1,19,78,97
"HELMAND","GARM SER",3006117,1,37,106,143
"HELMAND","NAWZAD",3007204,1,29,45,74
"HELMAND","NAWZAD",3007196,1,18,14,32
"HELMAND","NAWZAD",3007204,7,1,1,2
"HELMAND","NAWZAD",3007204,2,14,23,37
"HELMAND","NAWZAD",3007196,4,15,38,53
"HELMAND","NAWZAD",3007192,4,13,9,22
"HELMAND","NAWZAD",3007192,2,4,21,25
"HELMAND","NAWZAD",3007196,2,5,16,21
"HELMAND","NAWZAD",3007196,3,4,11,15
"HELMAND","NAWZAD",3007196,5,15,21,36
"HELMAND","NAWZAD",3007192,1,3,31,34
"HELMAND","NAWZAD",3007192,3,2,5,7
"HELMAND","NAWZAD",3007192,5,3,7,10
"HELMAND","NAWZAD",3007204,3,6,11,17
"HELMAND","NAWZAD",3007196,6,5,12,17
"HELMAND","SANGIN QALA",3008226,3,21,33,54
"HELMAND","SANGIN QALA",3008131,5,0,4,4
"HELMAND","SANGIN QALA",3008133,1,5,3,8
"HELMAND","SANGIN QALA",3008226,2,5,44,49
"HELMAND","SANGIN QALA",3008134,4,12,3,15
"HELMAND","SANGIN QALA",3008226,1,7,51,58
"HELMAND","SANGIN QALA",3008132,5,51,22,73
"HELMAND","SANGIN QALA",3008133,2,25,15,40
"HELMAND","SANGIN QALA",3008133,3,5,2,7
"HELMAND","SANGIN QALA",3008132,3,39,7,46
"HELMAND","SANGIN QALA",3008130,5,10,28,38
"HELMAND","SANGIN QALA",3008132,1,40,13,53
"HELMAND","SANGIN QALA",3008132,2,22,6,28
"HELMAND","SANGIN QALA",3008127,1,10,12,22
"HELMAND","SANGIN QALA",3008132,4,18,5,23
"HELMAND","SANGIN QALA",3008134,3,5,6,11
"HELMAND","SANGIN QALA",3008130,2,30,38,68
"HELMAND","SANGIN QALA",3008131,3,10,9,19
"HELMAND","SANGIN QALA",3008131,4,2,2,4
"HELMAND","SANGIN QALA",3008134,2,23,4,27
"HELMAND","SANGIN QALA",3008226,4,1,0,1
"HELMAND","SANGIN QALA",3008129,1,22,47,69
"HELMAND","SANGIN QALA",3008134,1,21,4,25
"HELMAND","SANGIN QALA",3008127,4,9,10,19
"HELMAND","SANGIN QALA",3008131,2,14,5,19
"HELMAND","SANGIN QALA",3008135,1,18,13,31
"HELMAND","SANGIN QALA",3008134,5,13,3,16
"HELMAND","SANGIN QALA",3008130,4,5,38,43
"HELMAND","SANGIN QALA",3008135,7,32,21,53
"HELMAND","SANGIN QALA",3008130,3,11,15,26
"HELMAND","SANGIN QALA",3008131,1,46,13,59
"HELMAND","SANGIN QALA",3008130,1,34,58,92
"HELMAND","SANGIN QALA",3008135,2,18,10,28
"HELMAND","MUSA QALA",3009180,4,4,21,25
"HELMAND","MUSA QALA",3009189,1,9,37,46
"HELMAND","MUSA QALA",3009186,1,31,61,92
"HELMAND","MUSA QALA",3009180,3,3,9,12
"HELMAND","MUSA QALA",3009180,1,6,43,49
"HELMAND","MUSA QALA",3009187,3,370,39,409
"HELMAND","MUSA QALA",3009189,2,6,51,57
"HELMAND","MUSA QALA",3009189,3,7,16,23
"HELMAND","MUSA QALA",3009178,3,10,15,25
"HELMAND","MUSA QALA",3009178,2,8,12,20
"HELMAND","MUSA QALA",3009187,2,176,135,311
"HELMAND","MUSA QALA",3009180,2,1,15,16
"HELMAND","MUSA QALA",3009189,4,4,25,29
"HELMAND","MUSA QALA",3009186,3,2,42,44
"HELMAND","MUSA QALA",3009184,3,26,34,60
"HELMAND","MUSA QALA",3009185,1,7,16,23
"HELMAND","MUSA QALA",3009186,2,22,53,75
"HELMAND","MUSA QALA",3009178,1,4,14,18
"HELMAND","MUSA QALA",3009187,1,284,53,337
"HELMAND","MUSA QALA",3009185,2,4,32,36
"HELMAND","MUSA QALA",3009185,3,39,22,61
"HELMAND","MUSA QALA",3009184,2,2,1,3
"HELMAND","MUSA QALA",3009186,4,6,37,43
"PARWAN","CHARIKAR",301032,1,356,8,364
"PARWAN","CHARIKAR",301005,4,204,7,211
"PARWAN","CHARIKAR",301024,3,413,83,496
"PARWAN","CHARIKAR",301015,3,56,4,60
"PARWAN","CHARIKAR",301013,3,278,74,352
"PARWAN","CHARIKAR",301013,2,391,27,418
"PARWAN","CHARIKAR",301005,3,118,6,124
"PARWAN","CHARIKAR",301026,1,323,5,328
"PARWAN","CHARIKAR",301024,2,380,101,481
"PARWAN","CHARIKAR",301026,2,226,5,231
"PARWAN","CHARIKAR",301026,3,312,7,319
"PARWAN","CHARIKAR",301020,3,171,8,179
"PARWAN","CHARIKAR",301021,1,319,58,377
"PARWAN","CHARIKAR",301022,1,359,15,374
"PARWAN","CHARIKAR",301022,2,302,9,311
"PARWAN","CHARIKAR",301017,1,376,9,385
"PARWAN","CHARIKAR",301017,2,163,2,165
"PARWAN","CHARIKAR",301013,1,421,79,500
"PARWAN","CHARIKAR",301029,1,367,15,382
"PARWAN","CHARIKAR",301029,2,157,5,162
"PARWAN","CHARIKAR",301019,1,173,16,189
"PARWAN","CHARIKAR",301019,2,113,15,128
"PARWAN","CHARIKAR",301032,2,311,7,318
"PARWAN","CHARIKAR",301032,3,331,19,350
"PARWAN","CHARIKAR",301033,1,265,23,288
"PARWAN","CHARIKAR",301033,2,191,11,202
"PARWAN","CHARIKAR",301016,1,512,11,523
"PARWAN","CHARIKAR",301016,2,372,16,388
"PARWAN","CHARIKAR",301034,3,330,9,339
"PARWAN","CHARIKAR",301034,4,567,14,581
"PARWAN","CHARIKAR",301034,5,49,1,50
"PARWAN","CHARIKAR",301014,3,278,2,280
"PARWAN","CHARIKAR",301015,1,189,79,268
"PARWAN","CHARIKAR",301015,2,151,81,232
"PARWAN","CHARIKAR",301003,5,205,10,215
"PARWAN","CHARIKAR",301003,6,217,22,239
"PARWAN","CHARIKAR",301004,1,304,10,314
"PARWAN","CHARIKAR",301004,2,191,11,202
"PARWAN","CHARIKAR",301004,3,170,6,176
"PARWAN","CHARIKAR",301026,4,421,4,425
"PARWAN","CHARIKAR",301024,1,443,140,583
"PARWAN","CHARIKAR",301006,2,257,8,265
"PARWAN","CHARIKAR",301006,3,207,3,210
"PARWAN","CHARIKAR",301006,4,186,2,188
"PARWAN","CHARIKAR",301006,5,355,17,372
"PARWAN","CHARIKAR",301005,1,202,11,213
"PARWAN","CHARIKAR",301005,2,114,4,118
"PARWAN","CHARIKAR",301010,2,290,18,308
"PARWAN","CHARIKAR",301010,3,171,42,213
"PARWAN","CHARIKAR",301021,2,281,97,378
"PARWAN","CHARIKAR",301021,3,398,55,453
"PARWAN","CHARIKAR",301021,4,213,37,250
"PARWAN","CHARIKAR",301036,1,119,17,136
"PARWAN","CHARIKAR",301036,2,95,11,106
"PARWAN","CHARIKAR",301036,3,110,7,117
"PARWAN","CHARIKAR",301022,3,270,4,274
"PARWAN","CHARIKAR",301034,1,254,22,276
"PARWAN","CHARIKAR",301034,2,300,17,317
"PARWAN","CHARIKAR",301012,1,261,9,270
"PARWAN","CHARIKAR",301012,2,387,15,402
"PARWAN","CHARIKAR",301012,3,342,17,359
"PARWAN","CHARIKAR",301012,4,127,12,139
"PARWAN","CHARIKAR",301019,3,290,20,310
"PARWAN","CHARIKAR",301031,1,301,24,325
"PARWAN","CHARIKAR",301031,2,502,46,548
"PARWAN","CHARIKAR",301031,3,461,24,485
"PARWAN","CHARIKAR",301007,5,536,26,562
"PARWAN","CHARIKAR",301008,1,231,13,244
"PARWAN","CHARIKAR",301016,3,386,16,402
"PARWAN","CHARIKAR",301014,1,285,8,293
"PARWAN","CHARIKAR",301014,2,191,6,197
"PARWAN","CHARIKAR",301003,2,230,20,250
"PARWAN","CHARIKAR",301003,3,208,9,217
"PARWAN","CHARIKAR",301003,4,192,9,201
"PARWAN","CHARIKAR",301011,3,393,3,396
"PARWAN","CHARIKAR",301011,4,323,9,332
"PARWAN","CHARIKAR",301009,1,132,4,136
"PARWAN","CHARIKAR",301009,2,185,11,196
"PARWAN","CHARIKAR",301009,3,258,7,265
"PARWAN","CHARIKAR",301004,4,298,11,309
"PARWAN","CHARIKAR",301006,1,273,6,279
"PARWAN","CHARIKAR",301001,2,126,6,132
"PARWAN","CHARIKAR",301001,3,325,26,351
"PARWAN","CHARIKAR",301001,4,137,4,141
"PARWAN","CHARIKAR",301001,5,105,12,117
"PARWAN","CHARIKAR",301001,6,76,4,80
"PARWAN","CHARIKAR",301010,1,116,28,144
"PARWAN","CHARIKAR",301020,2,180,8,188
"PARWAN","CHARIKAR",301023,2,25,252,277
"PARWAN","CHARIKAR",301010,4,220,28,248
"PARWAN","CHARIKAR",301010,5,481,48,529
"PARWAN","CHARIKAR",301002,1,494,34,528
"PARWAN","CHARIKAR",301002,2,567,22,589
"PARWAN","CHARIKAR",301002,3,245,18,263
"PARWAN","CHARIKAR",301002,4,367,27,394
"PARWAN","CHARIKAR",301008,2,317,24,341
"PARWAN","CHARIKAR",301002,5,554,35,589
"PARWAN","CHARIKAR",301002,6,226,21,247
"PARWAN","CHARIKAR",301003,1,230,32,262
"PARWAN","CHARIKAR",301025,3,568,5,573
"PARWAN","CHARIKAR",301023,1,27,237,264
"PARWAN","CHARIKAR",301011,1,318,49,367
"PARWAN","CHARIKAR",301012,5,259,12,271
"PARWAN","CHARIKAR",301012,6,196,15,211
"PARWAN","CHARIKAR",301007,1,457,31,488
"PARWAN","CHARIKAR",301007,2,354,22,376
"PARWAN","CHARIKAR",301007,3,155,15,170
"PARWAN","CHARIKAR",301007,4,221,27,248
"PARWAN","CHARIKAR",301018,2,247,2,249
"PARWAN","CHARIKAR",301008,3,234,10,244
"PARWAN","CHARIKAR",301008,4,407,23,430
"PARWAN","CHARIKAR",301027,2,147,41,188
"PARWAN","CHARIKAR",301027,3,129,6,135
"PARWAN","CHARIKAR",301020,1,217,6,223
"PARWAN","CHARIKAR",301025,2,292,12,304
"PARWAN","CHARIKAR",301023,3,11,111,122
"PARWAN","CHARIKAR",301030,1,474,22,496
"PARWAN","CHARIKAR",301030,2,557,32,589
"PARWAN","CHARIKAR",301030,3,187,23,210
"PARWAN","CHARIKAR",301009,4,238,17,255
"PARWAN","CHARIKAR",301001,1,101,17,118
"PARWAN","CHARIKAR",301018,1,300,3,303
"PARWAN","CHARIKAR",301018,3,187,4,191
"PARWAN","CHARIKAR",301027,1,139,23,162
"PARWAN","CHARIKAR",301035,3,486,28,514
"PARWAN","CHARIKAR",301028,1,154,81,235
"PARWAN","CHARIKAR",301028,2,71,39,110
"PARWAN","CHARIKAR",301035,1,312,22,334
"PARWAN","CHARIKAR",301011,2,350,16,366
"PARWAN","CHARIKAR",301030,4,301,18,319
"PARWAN","CHARIKAR",301025,1,461,4,465
"PARWAN","CHARIKAR",301035,2,336,31,367
"HELMAND","KAJAKI",3010158,1,36,92,128
"HELMAND","KAJAKI",3010157,4,20,18,38
"HELMAND","KAJAKI",3010147,2,61,88,149
"HELMAND","KAJAKI",3010149,4,9,11,20
"HELMAND","KAJAKI",3010157,3,17,32,49
"HELMAND","KAJAKI",3010149,1,19,24,43
"HELMAND","KAJAKI",3010158,2,55,94,149
"HELMAND","KAJAKI",3010158,3,56,56,112
"HELMAND","KAJAKI",3010147,4,141,74,215
"HELMAND","KAJAKI",3010147,1,71,93,164
"HELMAND","KAJAKI",3010157,7,18,33,51
"HELMAND","KAJAKI",3010157,5,13,14,27
"HELMAND","KAJAKI",3010157,2,25,32,57
"HELMAND","KAJAKI",3010149,3,7,11,18
"HELMAND","KAJAKI",3010157,6,20,32,52
"HELMAND","KAJAKI",3010149,2,19,14,33
"HELMAND","KAJAKI",3010147,3,150,73,223
"HELMAND","REGͲEͲKHAN NI",3011212,3,19,9,28
"HELMAND","REGͲEͲKHAN NI",3011212,4,1,6,7
"HELMAND","REGͲEͲKHAN NI",3011227,1,24,34,58
"HELMAND","REGͲEͲKHAN NI",3011218,1,5,9,14
"HELMAND","REGͲEͲKHAN NI",3011214,1,5,23,28
"HELMAND","REGͲEͲKHAN NI",3011214,2,2,24,26
"HELMAND","REGͲEͲKHAN NI",3011227,2,28,31,59
"HELMAND","REGͲEͲKHAN NI",3011215,1,38,8,46
"HELMAND","REGͲEͲKHAN NI",3011217,2,1,8,9
"HELMAND","REGͲEͲKHAN NI",3011212,1,4,6,10
"HELMAND","REGͲEͲKHAN NI",3011215,2,41,24,65
"HELMAND","REGͲEͲKHAN NI",3011217,1,4,8,12
"HELMAND","REGͲEͲKHAN NI",3011216,2,10,16,26
"HELMAND","REGͲEͲKHAN NI",3011213,1,1,9,10
"HELMAND","REGͲEͲKHAN NI",3011212,2,14,12,26
"HELMAND","REGͲEͲKHAN NI",3011216,1,13,53,66
"HELMAND","REGͲEͲKHAN NI",3011213,2,3,5,8
"HELMAND","REGͲEͲKHAN NI",3011218,2,4,10,14
"HELMAND","REGͲEͲKHAN NI",3011213,3,1,11,12
NA,NA,3014086,3,318,37,355
NA,NA,3014064,2,59,169,228
NA,NA,3014064,3,49,180,229
NA,NA,3014087,1,9,10,19
NA,NA,3014087,2,20,12,32
NA,NA,3014063,1,23,23,46
NA,NA,3014063,2,21,10,31
NA,NA,3014063,3,10,12,22
NA,NA,3014082,1,30,100,130
NA,NA,3014082,2,35,185,220
NA,NA,3014085,1,19,7,26
NA,NA,3014085,2,4,4,8
NA,NA,3014077,1,45,133,178
NA,NA,3014077,2,36,74,110
NA,NA,3014077,3,24,81,105
NA,NA,3014083,1,45,62,107
NA,NA,3014083,2,37,39,76
NA,NA,3014076,3,13,7,20
NA,NA,3014072,1,55,268,323
NA,NA,3014072,2,32,165,197
NA,NA,3014072,3,24,101,125
NA,NA,3014072,4,3,2,5
NA,NA,3014074,1,13,165,178
NA,NA,3014074,2,26,151,177
NA,NA,3014074,3,0,10,10
NA,NA,3014075,1,10,14,24
NA,NA,3014075,2,13,9,22
NA,NA,3014075,3,15,6,21
NA,NA,3014075,4,14,3,17
NA,NA,3014075,5,19,5,24
NA,NA,3014075,6,21,8,29
NA,NA,3014073,1,74,86,160
NA,NA,3014073,2,94,113,207
NA,NA,3014088,1,15,195,210
NA,NA,3014088,2,1,0,1
NA,NA,3014086,1,160,91,251
NA,NA,3014086,2,118,69,187
NA,NA,3014076,1,7,12,19
NA,NA,3014076,2,7,8,15
"PARWAN","BAGRAM",302112,4,383,3,386
"PARWAN","BAGRAM",302100,5,372,16,388
"PARWAN","BAGRAM",302112,5,527,1,528
"PARWAN","BAGRAM",302110,2,479,108,587
"PARWAN","BAGRAM",302111,1,577,18,595
"PARWAN","BAGRAM",302110,1,489,102,591
"PARWAN","BAGRAM",302110,6,180,37,217
"PARWAN","BAGRAM",302110,3,454,7,461
"PARWAN","BAGRAM",302111,2,575,19,594
"PARWAN","BAGRAM",302112,3,268,18,286
"PARWAN","BAGRAM",302100,4,407,11,418
"PARWAN","BAGRAM",302103,3,576,18,594
"PARWAN","BAGRAM",302103,4,228,3,231
"PARWAN","BAGRAM",302111,3,172,1,173
"PARWAN","BAGRAM",302102,2,219,359,578
"PARWAN","BAGRAM",302102,3,194,376,570
"PARWAN","BAGRAM",302102,4,319,257,576
"PARWAN","BAGRAM",302102,1,221,361,582
"PARWAN","BAGRAM",302110,4,212,4,216
"PARWAN","BAGRAM",302110,5,160,29,189
"PARWAN","BAGRAM",302100,1,352,15,367
"PARWAN","BAGRAM",302102,5,280,169,449
"PARWAN","BAGRAM",302100,3,536,5,541
"PARWAN","BAGRAM",302103,2,329,20,349
"PARWAN","BAGRAM",302101,4,189,151,340
"PARWAN","BAGRAM",302101,5,152,127,279
"PARWAN","BAGRAM",302119,3,257,18,275
"PARWAN","BAGRAM",302119,4,94,149,243
"PARWAN","BAGRAM",302119,5,46,183,229
"PARWAN","BAGRAM",302111,4,284,7,291
"PARWAN","BAGRAM",302106,1,338,72,410
"PARWAN","BAGRAM",302106,2,402,60,462
"PARWAN","BAGRAM",302106,3,276,50,326
"PARWAN","BAGRAM",302104,3,186,4,190
"PARWAN","BAGRAM",302100,2,497,7,504
"PARWAN","BAGRAM",302101,2,159,129,288
"PARWAN","BAGRAM",302101,3,287,173,460
"PARWAN","BAGRAM",302108,3,174,17,191
"PARWAN","BAGRAM",302108,4,170,18,188
"PARWAN","BAGRAM",302109,1,439,101,540
"PARWAN","BAGRAM",302109,2,513,75,588
"PARWAN","BAGRAM",302109,3,391,9,400
"PARWAN","BAGRAM",302113,1,566,24,590
"PARWAN","BAGRAM",302113,2,515,23,538
"PARWAN","BAGRAM",302113,3,374,44,418
"PARWAN","BAGRAM",302113,4,287,144,431
"PARWAN","BAGRAM",302116,1,569,11,580
"PARWAN","BAGRAM",302101,1,239,114,353
"PARWAN","BAGRAM",302108,1,512,54,566
"PARWAN","BAGRAM",302108,2,558,37,595
"PARWAN","BAGRAM",302116,5,392,6,398
"PARWAN","BAGRAM",302112,1,423,17,440
"PARWAN","BAGRAM",302112,2,294,20,314
"PARWAN","BAGRAM",302117,1,441,148,589
"PARWAN","BAGRAM",302117,2,455,133,588
"PARWAN","BAGRAM",302117,3,491,97,588
"PARWAN","BAGRAM",302117,4,259,130,389
"PARWAN","BAGRAM",302117,5,139,33,172
"PARWAN","BAGRAM",302104,1,426,39,465
"PARWAN","BAGRAM",302104,2,182,15,197
"PARWAN","BAGRAM",302120,3,592,1,593
"PARWAN","BAGRAM",302152,1,301,11,312
"PARWAN","BAGRAM",302152,2,322,11,333
"PARWAN","BAGRAM",302152,3,221,355,576
"PARWAN","BAGRAM",302119,1,12,238,250
"PARWAN","BAGRAM",302119,2,22,326,348
"PARWAN","BAGRAM",302115,2,139,416,555
"PARWAN","BAGRAM",302115,3,33,110,143
"PARWAN","BAGRAM",302115,4,29,95,124
"PARWAN","BAGRAM",302121,1,62,163,225
"PARWAN","BAGRAM",302121,2,73,144,217
"PARWAN","BAGRAM",302121,3,57,105,162
"PARWAN","BAGRAM",302121,4,148,74,222
"PARWAN","BAGRAM",302118,1,544,7,551
"PARWAN","BAGRAM",302106,4,268,76,344
"PARWAN","BAGRAM",302118,2,384,3,387
"PARWAN","BAGRAM",302118,3,538,8,546
"PARWAN","BAGRAM",302118,4,302,2,304
"PARWAN","BAGRAM",302115,1,95,474,569
"PARWAN","BAGRAM",302153,2,158,19,177
"PARWAN","BAGRAM",302153,3,426,6,432
"PARWAN","BAGRAM",302107,3,258,25,283
"PARWAN","BAGRAM",302109,4,191,6,197
"PARWAN","BAGRAM",302107,1,347,66,413
"PARWAN","BAGRAM",302107,2,283,51,334
"PARWAN","BAGRAM",302105,4,248,0,248
"PARWAN","BAGRAM",302105,1,278,39,317
"PARWAN","BAGRAM",302105,2,284,87,371
"PARWAN","BAGRAM",302105,3,159,2,161
"PARWAN","BAGRAM",302114,2,353,76,429
"PARWAN","BAGRAM",302103,1,365,229,594
"PARWAN","BAGRAM",302153,1,194,20,214
"PARWAN","BAGRAM",302114,1,249,47,296
"PARWAN","BAGRAM",302120,1,397,58,455
"PARWAN","BAGRAM",302120,2,223,14,237
"PARWAN","BAGRAM",302116,4,571,18,589
"PARWAN","BAGRAM",302116,2,586,7,593
"PARWAN","BAGRAM",302116,3,548,13,561
"PARWAN","BAGRAM",302114,4,292,7,299
"PARWAN","BAGRAM",302114,3,218,4,222
"PARWAN","SHINWARI",303073,1,79,397,476
"PARWAN","SHINWARI",303075,1,26,386,412
"PARWAN","SHINWARI",303075,2,8,25,33
"PARWAN","SHINWARI",303073,4,2,116,118
"PARWAN","SHINWARI",303077,1,84,287,371
"PARWAN","SHINWARI",303077,2,18,2,20
"PARWAN","SHINWARI",303072,2,78,76,154
"PARWAN","SHINWARI",303074,1,34,25,59
"PARWAN","SHINWARI",303076,3,0,10,10
"PARWAN","SHINWARI",303076,2,4,23,27
"PARWAN","SHINWARI",303073,2,27,267,294
"PARWAN","SHINWARI",303073,3,15,148,163
"PARWAN","SHINWARI",303072,3,97,26,123
"PARWAN","SHINWARI",303074,2,3,3,6
"PARWAN","SHINWARI",303072,1,136,77,213
"PARWAN","SHINWARI",303076,1,7,78,85
"PARWAN","SAYID KHIAL",304042,1,563,25,588
"PARWAN","SAYID KHIAL",304049,2,182,8,190
"PARWAN","SAYID KHIAL",304046,2,302,6,308
"PARWAN","SAYID KHIAL",304048,2,73,2,75
"PARWAN","SAYID KHIAL",304045,2,105,8,113
"PARWAN","SAYID KHIAL",304046,1,206,12,218
"PARWAN","SAYID KHIAL",304047,1,107,2,109
"PARWAN","SAYID KHIAL",304047,2,89,3,92
"PARWAN","SAYID KHIAL",304047,3,161,6,167
"PARWAN","SAYID KHIAL",304045,1,196,33,229
"PARWAN","SAYID KHIAL",304049,1,392,16,408
"PARWAN","SAYID KHIAL",304037,3,217,3,220
"PARWAN","SAYID KHIAL",304037,4,306,4,310
"PARWAN","SAYID KHIAL",304038,1,580,14,594
"PARWAN","SAYID KHIAL",304038,2,284,5,289
"PARWAN","SAYID KHIAL",304039,1,553,7,560
"PARWAN","SAYID KHIAL",304048,1,285,29,314
"PARWAN","SAYID KHIAL",304039,3,371,23,394
"PARWAN","SAYID KHIAL",304043,1,269,13,282
"PARWAN","SAYID KHIAL",304043,2,422,22,444
"PARWAN","SAYID KHIAL",304041,1,467,18,485
"PARWAN","SAYID KHIAL",304041,2,156,14,170
"PARWAN","SAYID KHIAL",304047,4,51,4,55
"PARWAN","SAYID KHIAL",304047,5,86,1,87
"PARWAN","SAYID KHIAL",304037,2,343,3,346
"PARWAN","SAYID KHIAL",304039,2,547,16,563
"PARWAN","SAYID KHIAL",304042,2,138,28,166
"PARWAN","SAYID KHIAL",304044,1,129,1,130
"PARWAN","SAYID KHIAL",304044,2,111,5,116
"PARWAN","SAYID KHIAL",304043,3,269,11,280
"PARWAN","SAYID KHIAL",304040,3,308,3,311
"PARWAN","SAYID KHIAL",304040,1,206,9,215
"PARWAN","SAYID KHIAL",304040,2,217,10,227
"PARWAN","SAYID KHIAL",304044,3,129,4,133
"PARWAN","SAYID KHIAL",304037,1,498,2,500
"PARWAN","JABULUSSARAJ",305054,2,557,37,594
"PARWAN","JABULUSSARAJ",305060,4,180,10,190
"PARWAN","JABULUSSARAJ",305052,1,475,23,498
"PARWAN","JABULUSSARAJ",305052,2,426,21,447
"PARWAN","JABULUSSARAJ",305054,1,450,8,458
"PARWAN","JABULUSSARAJ",305059,3,358,59,417
"PARWAN","JABULUSSARAJ",305155,2,230,5,235
"PARWAN","JABULUSSARAJ",305155,3,383,6,389
"PARWAN","JABULUSSARAJ",305057,4,428,8,436
"PARWAN","JABULUSSARAJ",305060,3,256,18,274
"PARWAN","JABULUSSARAJ",305058,3,327,63,390
"PARWAN","JABULUSSARAJ",305056,1,173,1,174
"PARWAN","JABULUSSARAJ",305056,2,150,3,153
"PARWAN","JABULUSSARAJ",305052,3,454,29,483
"PARWAN","JABULUSSARAJ",305052,4,538,22,560
"PARWAN","JABULUSSARAJ",305051,1,358,6,364
"PARWAN","JABULUSSARAJ",305051,2,251,5,256
"PARWAN","JABULUSSARAJ",305051,3,197,7,204
"PARWAN","JABULUSSARAJ",305051,4,201,3,204
"PARWAN","JABULUSSARAJ",305059,4,377,8,385
"PARWAN","JABULUSSARAJ",305060,1,366,21,387
"PARWAN","JABULUSSARAJ",305060,2,350,135,485
"PARWAN","JABULUSSARAJ",305154,1,583,4,587
"PARWAN","JABULUSSARAJ",305154,2,407,18,425
"PARWAN","JABULUSSARAJ",305154,3,197,5,202
"PARWAN","JABULUSSARAJ",305062,1,268,15,283
"PARWAN","JABULUSSARAJ",305054,3,514,80,594
"PARWAN","JABULUSSARAJ",305054,4,557,37,594
"PARWAN","JABULUSSARAJ",305055,1,587,9,596
"PARWAN","JABULUSSARAJ",305055,2,586,9,595
"PARWAN","JABULUSSARAJ",305055,3,586,3,589
"PARWAN","JABULUSSARAJ",305059,1,577,6,583
"PARWAN","JABULUSSARAJ",305057,1,578,11,589
"PARWAN","JABULUSSARAJ",305057,2,590,6,596
"PARWAN","JABULUSSARAJ",305057,3,568,17,585
"PARWAN","JABULUSSARAJ",305061,2,311,18,329
"PARWAN","JABULUSSARAJ",305061,3,191,10,201
"PARWAN","JABULUSSARAJ",305061,4,384,5,389
"PARWAN","JABULUSSARAJ",305050,1,573,18,591
"PARWAN","JABULUSSARAJ",305050,2,580,18,598
"PARWAN","JABULUSSARAJ",305050,3,576,13,589
"PARWAN","JABULUSSARAJ",305050,4,570,24,594
"PARWAN","JABULUSSARAJ",305052,5,321,9,330
"PARWAN","JABULUSSARAJ",305052,6,161,6,167
"PARWAN","JABULUSSARAJ",305053,1,568,23,591
"PARWAN","JABULUSSARAJ",305059,2,584,8,592
"PARWAN","JABULUSSARAJ",305055,6,32,3,35
"PARWAN","JABULUSSARAJ",305061,1,318,18,336
"PARWAN","JABULUSSARAJ",305058,1,401,25,426
"PARWAN","JABULUSSARAJ",305058,2,361,47,408
"PARWAN","JABULUSSARAJ",305062,3,204,48,252
"PARWAN","JABULUSSARAJ",305056,3,170,3,173
"PARWAN","JABULUSSARAJ",305056,4,139,7,146
"PARWAN","JABULUSSARAJ",305062,2,233,15,248
"PARWAN","JABULUSSARAJ",305055,4,586,8,594
"PARWAN","JABULUSSARAJ",305055,5,79,2,81
"PARWAN","JABULUSSARAJ",305053,3,559,36,595
"PARWAN","JABULUSSARAJ",305053,4,586,12,598
"PARWAN","JABULUSSARAJ",305050,5,574,15,589
"PARWAN","JABULUSSARAJ",305062,4,476,102,578
"PARWAN","JABULUSSARAJ",305155,1,194,12,206
"PARWAN","JABULUSSARAJ",305053,2,555,25,580
"PARWAN","SALANG",306068,2,171,1,172
"PARWAN","SALANG",306064,1,192,3,195
"PARWAN","SALANG",306069,2,323,12,335
"PARWAN","SALANG",306070,2,254,3,257
"PARWAN","SALANG",306066,2,369,12,381
"PARWAN","SALANG",306065,2,324,2,326
"PARWAN","SALANG",306064,2,159,5,164
"PARWAN","SALANG",306066,1,520,16,536
"PARWAN","SALANG",306068,1,242,14,256
"PARWAN","SALANG",306067,2,309,3,312
"PARWAN","SALANG",306066,3,363,14,377
"PARWAN","SALANG",306069,1,382,19,401
"PARWAN","SALANG",306067,1,484,10,494
"PARWAN","SALANG",306071,1,154,20,174
"PARWAN","SALANG",306071,2,285,6,291
"PARWAN","SALANG",306063,4,396,22,418
"PARWAN","SALANG",306064,3,220,4,224
"PARWAN","SALANG",306070,1,525,19,544
"PARWAN","SALANG",306065,1,570,14,584
"PARWAN","SALANG",306063,1,206,17,223
"PARWAN","SALANG",306063,2,315,10,325
"PARWAN","SALANG",306063,3,504,17,521
"PARWAN","SYAHGIRDI GHO",307085,2,55,175,230
"PARWAN","SYAHGIRDI GHO",307085,3,74,39,113
"PARWAN","SYAHGIRDI GHO",307090,1,495,12,507
"PARWAN","SYAHGIRDI GHO",307090,2,294,24,318
"PARWAN","SYAHGIRDI GHO",307086,1,410,126,536
"PARWAN","SYAHGIRDI GHO",307086,2,382,84,466
"PARWAN","SYAHGIRDI GHO",307085,1,102,194,296
"PARWAN","SYAHGIRDI GHO",307086,3,585,8,593
"PARWAN","SYAHGIRDI GHO",307082,1,137,52,189
"PARWAN","SYAHGIRDI GHO",307087,2,579,14,593
"PARWAN","SYAHGIRDI GHO",307087,3,426,9,435
"PARWAN","SYAHGIRDI GHO",307082,4,78,39,117
"PARWAN","SYAHGIRDI GHO",307092,2,362,28,390
"PARWAN","SYAHGIRDI GHO",307090,3,288,16,304
"PARWAN","SYAHGIRDI GHO",307092,1,140,117,257
"PARWAN","SYAHGIRDI GHO",307087,1,518,56,574
"PARWAN","SYAHGIRDI GHO",307082,3,109,105,214
"PARWAN","SYAHGIRDI GHO",307082,2,66,87,153
"PARWAN","KOHI SAFI",308149,3,9,13,22
"PARWAN","KOHI SAFI",308144,1,54,364,418
"PARWAN","KOHI SAFI",308145,1,14,66,80
"PARWAN","KOHI SAFI",308146,2,1,4,5
"PARWAN","KOHI SAFI",308147,1,30,215,245
"PARWAN","KOHI SAFI",308144,2,44,54,98
"PARWAN","KOHI SAFI",308156,3,0,1,1
"PARWAN","KOHI SAFI",308145,2,28,133,161
"PARWAN","KOHI SAFI",308156,1,4,118,122
"PARWAN","KOHI SAFI",308156,2,0,8,8
"PARWAN","KOHI SAFI",308147,2,7,51,58
"PARWAN","KOHI SAFI",308143,1,14,85,99
"PARWAN","KOHI SAFI",308143,2,7,87,94
"PARWAN","KOHI SAFI",308146,1,19,220,239
"PARWAN","KOHI SAFI",308145,3,3,9,12
"PARWAN","KOHI SAFI",308148,1,33,246,279
"PARWAN","KOHI SAFI",308149,1,14,71,85
"PARWAN","KOHI SAFI",308149,2,7,79,86
"PARWAN","SURKHI PARSA",309135,2,328,22,350
"PARWAN","SURKHI PARSA",309141,2,449,100,549
"PARWAN","SURKHI PARSA",309136,2,432,21,453
"PARWAN","SURKHI PARSA",309140,2,407,43,450
"PARWAN","SURKHI PARSA",309139,1,161,15,176
"PARWAN","SURKHI PARSA",309133,1,318,136,454
"PARWAN","SURKHI PARSA",309140,1,168,62,230
"PARWAN","SURKHI PARSA",309132,3,60,7,67
"PARWAN","SURKHI PARSA",309138,1,248,48,296
"PARWAN","SURKHI PARSA",309142,1,144,46,190
"PARWAN","SURKHI PARSA",309134,1,364,52,416
"PARWAN","SURKHI PARSA",309134,2,332,21,353
"PARWAN","SURKHI PARSA",309137,1,351,99,450
"PARWAN","SURKHI PARSA",309135,1,310,50,360
"PARWAN","SURKHI PARSA",309132,1,59,13,72
"PARWAN","SURKHI PARSA",309142,2,154,28,182
"PARWAN","SURKHI PARSA",309141,1,302,286,588
"PARWAN","SURKHI PARSA",309133,2,78,37,115
"PARWAN","SURKHI PARSA",309138,2,185,21,206
"PARWAN","SURKHI PARSA",309132,2,83,17,100
"PARWAN","SURKHI PARSA",309136,1,413,32,445
"PARWAN","SURKHI PARSA",309137,2,151,22,173
"PARWAN","SURKHI PARSA",309139,2,171,5,176
"PARWAN","SHAYKH ALI",310124,1,139,41,180
"PARWAN","SHAYKH ALI",310131,1,252,103,355
"PARWAN","SHAYKH ALI",310128,2,285,14,299
"PARWAN","SHAYKH ALI",310128,1,316,27,343
"PARWAN","SHAYKH ALI",310131,2,35,12,47
"PARWAN","SHAYKH ALI",310127,2,285,74,359
"PARWAN","SHAYKH ALI",310129,1,559,41,600
"PARWAN","SHAYKH ALI",310129,2,572,8,580
"PARWAN","SHAYKH ALI",310124,2,15,0,15
"PARWAN","SHAYKH ALI",310130,1,130,60,190
"PARWAN","SHAYKH ALI",310130,2,103,48,151
"PARWAN","SHAYKH ALI",310123,1,238,63,301
"PARWAN","SHAYKH ALI",310123,2,174,33,207
"PARWAN","SHAYKH ALI",310122,1,97,6,103
"PARWAN","SHAYKH ALI",310125,1,165,57,222
"PARWAN","SHAYKH ALI",310125,2,434,36,470
"PARWAN","SHAYKH ALI",310122,3,234,4,238
"PARWAN","SHAYKH ALI",310126,1,142,106,248
"PARWAN","SHAYKH ALI",310126,2,28,34,62
"PARWAN","SHAYKH ALI",310127,1,335,95,430
"PARWAN","SHAYKH ALI",310122,2,93,10,103
"BADGHIS","QALA-E-NOW",3101005,1,191,18,209
"BADGHIS","QALA-E-NOW",3101005,2,110,4,114
"BADGHIS","QALA-E-NOW",3101005,3,161,16,177
"BADGHIS","QALA-E-NOW",3101005,4,156,12,168
"BADGHIS","QALA-E-NOW",3101001,4,420,157,577
"BADGHIS","QALA-E-NOW",3101001,1,415,168,583
"BADGHIS","QALA-E-NOW",3101001,2,438,142,580
"BADGHIS","QALA-E-NOW",3101001,3,305,102,407
"BADGHIS","QALA-E-NOW",3101004,2,167,10,177
"BADGHIS","QALA-E-NOW",3101010,5,208,4,212
"BADGHIS","QALA-E-NOW",3101001,14,376,117,493
"BADGHIS","QALA-E-NOW",3101004,1,185,11,196
"BADGHIS","QALA-E-NOW",3101002,3,148,66,214
"BADGHIS","QALA-E-NOW",3101002,4,125,41,166
"BADGHIS","QALA-E-NOW",3101001,5,407,183,590
"BADGHIS","QALA-E-NOW",3101002,2,238,74,312
"BADGHIS","QALA-E-NOW",3101002,7,412,102,514
"BADGHIS","QALA-E-NOW",3101011,5,60,0,60
"BADGHIS","QALA-E-NOW",3101002,5,194,83,277
"BADGHIS","QALA-E-NOW",3101002,6,170,60,230
"BADGHIS","QALA-E-NOW",3101019,4,41,9,50
"BADGHIS","QALA-E-NOW",3101007,1,257,54,311
"BADGHIS","QALA-E-NOW",3101017,4,214,10,224
"BADGHIS","QALA-E-NOW",3101011,4,143,2,145
"BADGHIS","QALA-E-NOW",3101003,2,297,17,314
"BADGHIS","QALA-E-NOW",3101003,3,367,30,397
"BADGHIS","QALA-E-NOW",3101001,6,364,155,519
"BADGHIS","QALA-E-NOW",3101003,1,309,37,346
"BADGHIS","QALA-E-NOW",3101011,3,148,1,149
"BADGHIS","QALA-E-NOW",3101015,4,38,2,40
"BADGHIS","QALA-E-NOW",3101001,10,194,94,288
"BADGHIS","QALA-E-NOW",3101011,6,70,1,71
"BADGHIS","QALA-E-NOW",3101002,1,466,119,585
"BADGHIS","QALA-E-NOW",3101001,13,246,70,316
"BADGHIS","QALA-E-NOW",3101006,6,155,154,309
"BADGHIS","QALA-E-NOW",3101010,3,133,3,136
"BADGHIS","QALA-E-NOW",3101010,4,125,11,136
"BADGHIS","QALA-E-NOW",3101013,2,262,67,329
"BADGHIS","QALA-E-NOW",3101004,3,160,6,166
"BADGHIS","QALA-E-NOW",3101004,4,66,12,78
"BADGHIS","QALA-E-NOW",3101011,2,102,3,105
"BADGHIS","QALA-E-NOW",3101011,1,138,1,139
"BADGHIS","QALA-E-NOW",3101018,4,111,3,114
"BADGHIS","QALA-E-NOW",3101015,1,197,11,208
"BADGHIS","QALA-E-NOW",3101001,11,226,72,298
"BADGHIS","QALA-E-NOW",3101001,12,195,79,274
"BADGHIS","QALA-E-NOW",3101008,3,114,7,121
"BADGHIS","QALA-E-NOW",3101008,4,54,3,57
"BADGHIS","QALA-E-NOW",3101008,5,46,0,46
"BADGHIS","QALA-E-NOW",3101013,1,271,79,350
"BADGHIS","QALA-E-NOW",3101016,1,248,46,294
"BADGHIS","QALA-E-NOW",3101013,3,226,72,298
"BADGHIS","QALA-E-NOW",3101013,4,256,109,365
"BADGHIS","QALA-E-NOW",3101013,5,272,121,393
"BADGHIS","QALA-E-NOW",3101008,2,89,9,98
"BADGHIS","QALA-E-NOW",3101016,2,180,59,239
"BADGHIS","QALA-E-NOW",3101016,3,154,20,174
"BADGHIS","QALA-E-NOW",3101008,1,136,21,157
"BADGHIS","QALA-E-NOW",3101017,3,268,9,277
"BADGHIS","QALA-E-NOW",3101019,2,84,14,98
"BADGHIS","QALA-E-NOW",3101019,3,123,15,138
"BADGHIS","QALA-E-NOW",3101009,6,286,160,446
"BADGHIS","QALA-E-NOW",3101007,4,192,18,210
"BADGHIS","QALA-E-NOW",3101001,7,286,120,406
"BADGHIS","QALA-E-NOW",3101007,2,203,25,228
"BADGHIS","QALA-E-NOW",3101007,3,130,22,152
"BADGHIS","QALA-E-NOW",3101012,3,75,23,98
"BADGHIS","QALA-E-NOW",3101012,4,35,7,42
"BADGHIS","QALA-E-NOW",3101001,8,203,83,286
"BADGHIS","QALA-E-NOW",3101001,9,152,64,216
"BADGHIS","QALA-E-NOW",3101010,2,188,5,193
"BADGHIS","QALA-E-NOW",3101006,5,135,55,190
"BADGHIS","QALA-E-NOW",3101012,5,43,15,58
"BADGHIS","QALA-E-NOW",3101010,1,272,8,280
"BADGHIS","QALA-E-NOW",3101018,2,197,12,209
"BADGHIS","QALA-E-NOW",3101014,3,150,11,161
"BADGHIS","QALA-E-NOW",3101004,5,89,13,102
"BADGHIS","QALA-E-NOW",3101018,3,117,3,120
"BADGHIS","QALA-E-NOW",3101019,1,146,8,154
"BADGHIS","QALA-E-NOW",3101009,5,239,118,357
"BADGHIS","QALA-E-NOW",3101015,2,141,8,149
"BADGHIS","QALA-E-NOW",3101015,3,27,4,31
"BADGHIS","QALA-E-NOW",3101014,1,167,10,177
"BADGHIS","QALA-E-NOW",3101014,2,143,8,151
"BADGHIS","QALA-E-NOW",3101017,2,108,11,119
"BADGHIS","QALA-E-NOW",3101005,5,146,17,163
"BADGHIS","QALA-E-NOW",3101016,5,125,50,175
"BADGHIS","QALA-E-NOW",3101006,2,204,77,281
"BADGHIS","QALA-E-NOW",3101003,6,354,35,389
"BADGHIS","QALA-E-NOW",3101016,4,135,26,161
"BADGHIS","QALA-E-NOW",3101003,7,274,23,297
"BADGHIS","QALA-E-NOW",3101003,4,427,38,465
"BADGHIS","QALA-E-NOW",3101006,3,216,96,312
"BADGHIS","QALA-E-NOW",3101006,4,209,81,290
"BADGHIS","QALA-E-NOW",3101017,1,89,12,101
"BADGHIS","QALA-E-NOW",3101006,1,226,52,278
"BADGHIS","QALA-E-NOW",3101003,5,329,18,347
"BADGHIS","QALA-E-NOW",3101002,9,254,128,382
"BADGHIS","QALA-E-NOW",3101007,5,195,19,214
"BADGHIS","QALA-E-NOW",3101009,1,92,24,116
"BADGHIS","QALA-E-NOW",3101009,3,160,83,243
"BADGHIS","QALA-E-NOW",3101009,4,232,85,317
"BADGHIS","QALA-E-NOW",3101014,4,111,5,116
"BADGHIS","QALA-E-NOW",3101014,5,78,14,92
"BADGHIS","QALA-E-NOW",3101009,2,64,38,102
"BADGHIS","QALA-E-NOW",3101018,1,233,11,244
"BADGHIS","QALA-E-NOW",3101002,8,310,112,422
"BADGHIS","QALA-E-NOW",3101012,1,74,16,90
"BADGHIS","QALA-E-NOW",3101012,2,80,9,89
"BADGHIS","AB KAMARI",3102044,1,262,29,291
"BADGHIS","AB KAMARI",3102036,1,287,32,319
"BADGHIS","AB KAMARI",3102175,3,193,48,241
"BADGHIS","AB KAMARI",3102192,3,68,6,74
"BADGHIS","AB KAMARI",3102046,3,164,51,215
"BADGHIS","AB KAMARI",3102039,2,232,16,248
"BADGHIS","AB KAMARI",3102192,2,86,13,99
"BADGHIS","AB KAMARI",3102039,4,90,13,103
"BADGHIS","AB KAMARI",3102192,1,75,15,90
"BADGHIS","AB KAMARI",3102041,1,345,9,354
"BADGHIS","AB KAMARI",3102039,3,161,13,174
"BADGHIS","AB KAMARI",3102028,2,203,40,243
"BADGHIS","AB KAMARI",3102176,1,423,26,449
"BADGHIS","AB KAMARI",3102028,4,500,5,505
"BADGHIS","AB KAMARI",3102046,1,226,36,262
"BADGHIS","AB KAMARI",3102046,2,189,39,228
"BADGHIS","AB KAMARI",3102028,3,204,30,234
"BADGHIS","AB KAMARI",3102035,3,542,24,566
"BADGHIS","AB KAMARI",3102044,2,382,33,415
"BADGHIS","AB KAMARI",3102044,3,268,33,301
"BADGHIS","AB KAMARI",3102035,2,157,8,165
"BADGHIS","AB KAMARI",3102036,5,366,28,394
"BADGHIS","AB KAMARI",3102039,1,214,17,231
"BADGHIS","AB KAMARI",3102049,3,290,16,306
"BADGHIS","AB KAMARI",3102036,4,462,30,492
"BADGHIS","AB KAMARI",3102175,2,119,14,133
"BADGHIS","AB KAMARI",3102040,2,432,17,449
"BADGHIS","AB KAMARI",3102040,3,136,4,140
"BADGHIS","AB KAMARI",3102175,1,205,44,249
"BADGHIS","AB KAMARI",3102045,3,31,11,42
"BADGHIS","AB KAMARI",3102049,1,187,20,207
"BADGHIS","AB KAMARI",3102049,2,100,8,108
"BADGHIS","AB KAMARI",3102191,1,127,12,139
"BADGHIS","AB KAMARI",3102190,3,215,265,480
"BADGHIS","AB KAMARI",3102035,1,405,22,427
"BADGHIS","AB KAMARI",3102047,3,583,12,595
"BADGHIS","AB KAMARI",3102042,2,113,26,139
"BADGHIS","AB KAMARI",3102038,2,482,11,493
"BADGHIS","AB KAMARI",3102191,2,117,20,137
"BADGHIS","AB KAMARI",3102176,2,177,23,200
"BADGHIS","AB KAMARI",3102040,1,296,16,312
"BADGHIS","AB KAMARI",3102028,1,128,25,153
"BADGHIS","AB KAMARI",3102036,3,263,33,296
"BADGHIS","AB KAMARI",3102048,3,343,62,405
"BADGHIS","AB KAMARI",3102037,1,521,21,542
"BADGHIS","AB KAMARI",3102037,2,549,1,550
"BADGHIS","AB KAMARI",3102047,1,575,23,598
"BADGHIS","AB KAMARI",3102047,2,556,32,588
"BADGHIS","AB KAMARI",3102191,3,169,22,191
"BADGHIS","AB KAMARI",3102048,1,364,44,408
"BADGHIS","AB KAMARI",3102038,1,486,31,517
"BADGHIS","AB KAMARI",3102045,2,151,33,184
"BADGHIS","AB KAMARI",3102043,3,131,15,146
"BADGHIS","AB KAMARI",3102190,1,88,116,204
"BADGHIS","AB KAMARI",3102045,1,104,14,118
"BADGHIS","AB KAMARI",3102190,2,133,104,237
"BADGHIS","AB KAMARI",3102043,2,133,15,148
"BADGHIS","AB KAMARI",3102048,2,309,51,360
"BADGHIS","AB KAMARI",3102042,1,201,20,221
"BADGHIS","AB KAMARI",3102043,1,141,16,157
"BADGHIS","AB KAMARI",3102041,2,237,3,240
"BADGHIS","AB KAMARI",3102036,2,387,33,420
"BADGHIS","MUQUR",3103021,3,284,26,310
"BADGHIS","MUQUR",3103020,3,205,21,226
"BADGHIS","MUQUR",3103024,1,40,478,518
"BADGHIS","MUQUR",3103022,3,57,1,58
"BADGHIS","MUQUR",3103020,1,254,114,368
"BADGHIS","MUQUR",3103020,4,23,519,542
"BADGHIS","MUQUR",3103022,2,56,38,94
"BADGHIS","MUQUR",3103021,2,116,22,138
"BADGHIS","MUQUR",3103020,2,280,105,385
"BADGHIS","MUQUR",3103022,1,54,32,86
"BADGHIS","MUQUR",3103027,2,95,43,138
"BADGHIS","MUQUR",3103027,1,166,100,266
"BADGHIS","MUQUR",3103023,2,171,33,204
"BADGHIS","MUQUR",3103023,1,236,133,369
"BADGHIS","MUQUR",3103021,1,170,18,188
"BADGHIS","MUQUR",3103025,2,110,4,114
"BADGHIS","MUQUR",3103025,3,88,61,149
"BADGHIS","MUQUR",3103026,1,36,16,52
"BADGHIS","MUQUR",3103024,2,2,590,592
"BADGHIS","MUQUR",3103025,1,72,7,79
"BADGHIS","QADIS",3104058,1,115,66,181
"BADGHIS","QADIS",3104088,2,117,1,118
"BADGHIS","QADIS",3104079,1,492,101,593
"BADGHIS","QADIS",3104088,1,37,8,45
"BADGHIS","QADIS",3104055,2,149,46,195
"BADGHIS","QADIS",3104055,3,270,64,334
"BADGHIS","QADIS",3104088,3,126,38,164
"BADGHIS","QADIS",3104082,1,156,14,170
"BADGHIS","QADIS",3104193,2,336,178,514
"BADGHIS","QADIS",3104193,3,505,81,586
"BADGHIS","QADIS",3104178,1,78,59,137
"BADGHIS","QADIS",3104193,1,482,53,535
"BADGHIS","QADIS",3104081,1,210,38,248
"BADGHIS","QADIS",3104080,2,399,77,476
"BADGHIS","QADIS",3104065,1,93,5,98
"BADGHIS","QADIS",3104178,2,22,42,64
"BADGHIS","QADIS",3104080,1,441,78,519
"BADGHIS","QADIS",3104068,1,137,63,200
"BADGHIS","QADIS",3104079,2,562,36,598
"BADGHIS","QADIS",3104078,3,489,106,595
"BADGHIS","QADIS",3104078,2,427,90,517
"BADGHIS","QADIS",3104066,2,183,38,221
"BADGHIS","QADIS",3104059,1,378,56,434
"BADGHIS","QADIS",3104068,2,69,28,97
"BADGHIS","QADIS",3104066,1,330,60,390
"BADGHIS","QADIS",3104056,2,180,41,221
"BADGHIS","QADIS",3104057,1,349,115,464
"BADGHIS","QADIS",3104057,2,325,103,428
"BADGHIS","QADIS",3104062,1,197,35,232
"BADGHIS","QADIS",3104057,4,215,79,294
"BADGHIS","QADIS",3104055,1,128,55,183
"BADGHIS","QADIS",3104064,2,76,174,250
"BADGHIS","QADIS",3104065,2,11,8,19
"BADGHIS","QADIS",3104069,2,130,10,140
"BADGHIS","QADIS",3104058,2,135,64,199
"BADGHIS","QADIS",3104058,3,82,45,127
"BADGHIS","QADIS",3104069,1,236,32,268
"BADGHIS","QADIS",3104061,2,88,25,113
"BADGHIS","QADIS",3104076,1,366,228,594
"BADGHIS","QADIS",3104076,2,126,467,593
"BADGHIS","QADIS",3104084,1,29,12,41
"BADGHIS","QADIS",3104057,3,200,79,279
"BADGHIS","QADIS",3104063,1,118,43,161
"BADGHIS","QADIS",3104063,2,233,43,276
"BADGHIS","QADIS",3104063,3,364,144,508
"BADGHIS","QADIS",3104081,2,91,70,161
"BADGHIS","QADIS",3104061,1,95,26,121
"BADGHIS","QADIS",3104177,1,90,39,129
"BADGHIS","QADIS",3104177,2,125,97,222
"BADGHIS","QADIS",3104077,1,336,251,587
"BADGHIS","QADIS",3104062,2,147,65,212
"BADGHIS","QADIS",3104078,1,451,110,561
"BADGHIS","QADIS",3104070,3,402,52,454
"BADGHIS","QADIS",3104070,2,232,23,255
"BADGHIS","QADIS",3104054,1,363,154,517
"BADGHIS","QADIS",3104082,2,124,12,136
"BADGHIS","QADIS",3104056,1,262,57,319
"BADGHIS","QADIS",3104073,3,153,441,594
"BADGHIS","QADIS",3104060,2,54,125,179
"BADGHIS","QADIS",3104077,2,415,185,600
"BADGHIS","QADIS",3104075,1,70,526,596
"BADGHIS","QADIS",3104075,2,11,585,596
"BADGHIS","QADIS",3104064,1,147,108,255
"BADGHIS","QADIS",3104073,1,149,443,592
"BADGHIS","QADIS",3104054,2,400,157,557
"BADGHIS","QADIS",3104054,4,321,101,422
"BADGHIS","QADIS",3104060,1,123,137,260
"BADGHIS","QADIS",3104070,1,279,26,305
"BADGHIS","QADIS",3104067,1,139,58,197
"BADGHIS","QADIS",3104084,2,35,8,43
"BADGHIS","QADIS",3104084,3,4,1,5
"BADGHIS","QADIS",3104059,2,240,45,285
"BADGHIS","QADIS",3104067,3,170,69,239
"BADGHIS","QADIS",3104073,2,248,305,553
"BADGHIS","QADIS",3104081,3,332,251,583
"BADGHIS","QADIS",3104067,2,136,31,167
"BADGHIS","QADIS",3104054,3,281,103,384
"BADGHIS","BALA MURGHA",3105147,1,88,504,592
"BADGHIS","BALA MURGHA",3105194,3,252,278,530
"BADGHIS","BALA MURGHA",3105158,3,295,280,575
"BADGHIS","BALA MURGHA",3105188,2,7,18,25
"BADGHIS","BALA MURGHA",3105194,2,169,288,457
"BADGHIS","BALA MURGHA",3105188,3,4,24,28
"BADGHIS","BALA MURGHA",3105194,1,170,259,429
"BADGHIS","BALA MURGHA",3105153,1,17,396,413
"BADGHIS","BALA MURGHA",3105148,1,9,578,587
"BADGHIS","BALA MURGHA",3105147,3,150,417,567
"BADGHIS","BALA MURGHA",3105148,3,75,523,598
"BADGHIS","BALA MURGHA",3105158,2,182,183,365
"BADGHIS","BALA MURGHA",3105149,1,22,95,117
"BADGHIS","BALA MURGHA",3105147,2,91,503,594
"BADGHIS","BALA MURGHA",3105148,2,37,537,574
"BADGHIS","BALA MURGHA",3105168,5,186,195,381
"BADGHIS","BALA MURGHA",3105188,1,15,51,66
"BADGHIS","BALA MURGHA",3105150,2,6,56,62
"BADGHIS","BALA MURGHA",3105147,4,72,498,570
"BADGHIS","BALA MURGHA",3105149,3,11,45,56
"BADGHIS","BALA MURGHA",3105158,1,298,298,596
"BADGHIS","BALA MURGHA",3105168,2,138,107,245
"BADGHIS","BALA MURGHA",3105168,3,147,66,213
"BADGHIS","BALA MURGHA",3105153,3,34,536,570
"BADGHIS","BALA MURGHA",3105168,4,181,180,361
"BADGHIS","BALA MURGHA",3105189,2,184,281,465
"BADGHIS","BALA MURGHA",3105150,1,14,93,107
"BADGHIS","BALA MURGHA",3105153,2,17,581,598
"BADGHIS","BALA MURGHA",3105149,2,8,90,98
"BADGHIS","BALA MURGHA",3105189,1,234,260,494
"BADGHIS","BALA MURGHA",3105168,1,134,101,235
"BADGHIS","JAWAND",3106091,2,346,158,504
"BADGHIS","JAWAND",3106201,1,473,69,542
"BADGHIS","JAWAND",3106091,1,263,287,550
"BADGHIS","JAWAND",3106112,2,300,300,600
"BADGHIS","JAWAND",3106111,1,374,196,570
"BADGHIS","JAWAND",3106114,2,316,280,596
"BADGHIS","JAWAND",3106095,3,149,402,551
"BADGHIS","JAWAND",3106200,1,247,353,600
"BADGHIS","JAWAND",3106102,2,277,277,554
"BADGHIS","JAWAND",3106095,1,368,232,600
"BADGHIS","JAWAND",3106114,1,297,290,587
"BADGHIS","JAWAND",3106199,1,257,332,589
"BADGHIS","JAWAND",3106199,2,349,250,599
"BADGHIS","JAWAND",3106199,3,426,160,586
"BADGHIS","JAWAND",3106095,2,104,493,597
"BADGHIS","JAWAND",3106179,2,465,120,585
"BADGHIS","JAWAND",3106103,1,37,495,532
"BADGHIS","JAWAND",3106201,2,466,133,599
"BADGHIS","JAWAND",3106091,3,421,115,536
"BADGHIS","JAWAND",3106097,2,316,284,600
"BADGHIS","JAWAND",3106102,1,332,265,597
"BADGHIS","JAWAND",3106094,3,263,334,597
"BADGHIS","JAWAND",3106198,2,180,409,589
"BADGHIS","JAWAND",3106200,3,175,423,598
"BADGHIS","JAWAND",3106197,3,321,279,600
"BADGHIS","JAWAND",3106112,1,410,188,598
"BADGHIS","JAWAND",3106196,1,574,20,594
"BADGHIS","JAWAND",3106179,1,345,250,595
"BADGHIS","JAWAND",3106111,2,494,64,558
"BADGHIS","JAWAND",3106111,3,132,440,572
"BADGHIS","JAWAND",3106108,1,330,49,379
"BADGHIS","JAWAND",3106200,2,129,471,600
"BADGHIS","JAWAND",3106106,1,347,249,596
"BADGHIS","JAWAND",3106094,2,188,351,539
"BADGHIS","JAWAND",3106198,1,543,40,583
"BADGHIS","JAWAND",3106096,1,264,330,594
"BADGHIS","JAWAND",3106198,3,558,15,573
"BADGHIS","JAWAND",3106109,1,14,584,598
"BADGHIS","JAWAND",3106109,2,17,522,539
"BADGHIS","JAWAND",3106107,1,540,0,540
"BADGHIS","JAWAND",3106196,2,566,32,598
"BADGHIS","JAWAND",3106107,2,540,0,540
"BADGHIS","JAWAND",3106093,3,422,116,538
"BADGHIS","JAWAND",3106097,1,405,191,596
"BADGHIS","JAWAND",3106108,2,480,0,480
"BADGHIS","JAWAND",3106180,1,581,17,598
"BADGHIS","JAWAND",3106094,1,118,478,596
"BADGHIS","JAWAND",3106197,1,232,367,599
"BADGHIS","JAWAND",3106110,1,268,328,596
"BADGHIS","JAWAND",3106096,2,250,345,595
"BADGHIS","JAWAND",3106104,2,423,117,540
"BADGHIS","JAWAND",3106196,3,528,65,593
"BADGHIS","JAWAND",3106197,2,400,189,589
"BADGHIS","JAWAND",3106089,4,395,203,598
"BADGHIS","JAWAND",3106093,1,443,156,599
"BADGHIS","JAWAND",3106101,1,502,89,591
"BADGHIS","JAWAND",3106101,2,548,50,598
"BADGHIS","JAWAND",3106195,1,40,505,545
"BADGHIS","JAWAND",3106201,3,448,150,598
"BADGHIS","JAWAND",3106089,1,233,15,248
"BADGHIS","JAWAND",3106089,2,181,9,190
"BADGHIS","JAWAND",3106089,3,130,14,144
"BADGHIS","JAWAND",3106110,2,405,134,539
"BADGHIS","JAWAND",3106092,1,515,81,596
"BADGHIS","JAWAND",3106093,2,431,83,514
"BADGHIS","JAWAND",3106106,2,546,52,598
"BADGHIS","JAWAND",3106113,2,566,32,598
"BADGHIS","JAWAND",3106195,2,30,515,545
"BADGHIS","JAWAND",3106092,2,512,85,597
"BADGHIS","JAWAND",3106096,3,96,494,590
"BADGHIS","JAWAND",3106105,1,573,22,595
"BADGHIS","JAWAND",3106113,1,477,119,596
"BADGHIS","JAWAND",3106195,3,30,515,545
"BADGHIS","JAWAND",3106104,1,390,147,537
"BADGHIS","JAWAND",3106092,3,483,112,595
"BADGHIS","JAWAND",3106105,2,423,177,600
"BADGHIS","JAWAND",3106180,2,580,18,598
"BADGHIS","JAWAND",3106103,2,62,471,533
"BADGHIS","GHORMACH",3107124,4,0,600,600
"BADGHIS","GHORMACH",3107124,2,0,598,598
"BADGHIS","GHORMACH",3107140,4,8,592,600
"BADGHIS","GHORMACH",3107140,1,101,499,600
"BADGHIS","GHORMACH",3107140,2,8,592,600
"BADGHIS","GHORMACH",3107124,3,579,18,597
"BADGHIS","GHORMACH",3107125,3,600,0,600
"BADGHIS","GHORMACH",3107124,5,0,590,590
"BADGHIS","GHORMACH",3107125,1,583,17,600
"BADGHIS","GHORMACH",3107124,1,0,598,598
"BADGHIS","GHORMACH",3107125,2,594,4,598
"BADGHIS","GHORMACH",3107140,3,285,315,600
"HERAT","HERAT",3201009,2,332,105,437
"HERAT","HERAT",3201030,9,137,62,199
"HERAT","HERAT",3201002,6,203,121,324
"HERAT","HERAT",3201009,1,311,88,399
"HERAT","HERAT",3201005,4,173,95,268
"HERAT","HERAT",3201005,5,107,57,164
"HERAT","HERAT",3201009,3,428,161,589
"HERAT","HERAT",3201005,3,78,55,133
"HERAT","HERAT",3201030,8,136,47,183
"HERAT","HERAT",3201006,6,351,138,489
"HERAT","HERAT",3201006,7,267,126,393
"HERAT","HERAT",3201006,8,277,120,397
"HERAT","HERAT",3201009,4,440,144,584
"HERAT","HERAT",3201009,5,338,89,427
"HERAT","HERAT",3201006,11,196,66,262
"HERAT","HERAT",3201009,6,334,63,397
"HERAT","HERAT",3201009,7,309,53,362
"HERAT","HERAT",3201002,4,357,223,580
"HERAT","HERAT",3201002,5,312,236,548
"HERAT","HERAT",3201002,7,389,191,580
"HERAT","HERAT",3201005,2,170,121,291
"HERAT","HERAT",3201006,9,215,63,278
"HERAT","HERAT",3201006,10,174,76,250
"HERAT","HERAT",3201003,1,195,57,252
"HERAT","HERAT",3201002,8,299,156,455
"HERAT","HERAT",3201003,3,105,26,131
"HERAT","HERAT",3201009,8,155,23,178
"HERAT","HERAT",3201009,9,153,23,176
"HERAT","HERAT",3201003,2,127,47,174
"HERAT","HERAT",3201011,2,392,197,589
"HERAT","HERAT",3201011,3,382,208,590
"HERAT","HERAT",3201011,4,417,176,593
"HERAT","HERAT",3201011,5,400,198,598
"HERAT","HERAT",3201011,6,399,151,550
"HERAT","HERAT",3201002,9,302,230,532
"HERAT","HERAT",3201002,10,333,201,534
"HERAT","HERAT",3201005,8,64,33,97
"HERAT","HERAT",3201005,9,63,36,99
"HERAT","HERAT",3201006,1,376,196,572
"HERAT","HERAT",3201011,12,60,53,113
"HERAT","HERAT",3201003,5,201,59,260
"HERAT","HERAT",3201005,1,221,144,365
"HERAT","HERAT",3201030,6,183,74,257
"HERAT","HERAT",3201030,7,298,132,430
"HERAT","HERAT",3201006,5,345,186,531
"HERAT","HERAT",3201031,8,291,202,493
"HERAT","HERAT",3201031,9,264,136,400
"HERAT","HERAT",3201031,10,318,189,507
"HERAT","HERAT",3201031,11,365,172,537
"HERAT","HERAT",3201031,12,204,128,332
"HERAT","HERAT",3201031,13,221,142,363
"HERAT","HERAT",3201007,1,339,204,543
"HERAT","HERAT",3201007,2,170,132,302
"HERAT","HERAT",3201007,3,188,85,273
"HERAT","HERAT",3201003,6,186,66,252
"HERAT","HERAT",3201002,1,345,231,576
"HERAT","HERAT",3201002,2,346,242,588
"HERAT","HERAT",3201002,3,345,231,576
"HERAT","HERAT",3201007,9,401,152,553
"HERAT","HERAT",3201007,11,189,90,279
"HERAT","HERAT",3201013,1,219,104,323
"HERAT","HERAT",3201013,2,144,83,227
"HERAT","HERAT",3201013,3,302,187,489
"HERAT","HERAT",3201013,4,202,130,332
"HERAT","HERAT",3201013,5,198,115,313
"HERAT","HERAT",3201013,6,235,94,329
"HERAT","HERAT",3201003,4,220,78,298
"HERAT","HERAT",3201007,4,204,112,316
"HERAT","HERAT",3201011,1,368,223,591
"HERAT","HERAT",3201025,9,227,35,262
"HERAT","HERAT",3201025,10,24,9,33
"HERAT","HERAT",3201027,1,312,103,415
"HERAT","HERAT",3201027,2,328,118,446
"HERAT","HERAT",3201027,3,422,159,581
"HERAT","HERAT",3201011,7,238,104,342
"HERAT","HERAT",3201005,6,78,20,98
"HERAT","HERAT",3201005,7,60,32,92
"HERAT","HERAT",3201011,10,424,171,595
"HERAT","HERAT",3201011,11,251,113,364
"HERAT","HERAT",3201027,9,364,54,418
"HERAT","HERAT",3201013,8,147,74,221
"HERAT","HERAT",3201012,1,385,182,567
"HERAT","HERAT",3201006,3,394,183,577
"HERAT","HERAT",3201006,4,375,207,582
"HERAT","HERAT",3201031,7,325,167,492
"HERAT","HERAT",3201012,4,212,66,278
"HERAT","HERAT",3201012,5,212,80,292
"HERAT","HERAT",3201012,6,124,55,179
"HERAT","HERAT",3201012,7,224,73,297
"HERAT","HERAT",3201012,8,164,48,212
"HERAT","HERAT",3201016,1,210,145,355
"HERAT","HERAT",3201016,2,370,187,557
"HERAT","HERAT",3201010,1,446,152,598
"HERAT","HERAT",3201010,2,397,190,587
"HERAT","HERAT",3201010,3,264,111,375
"HERAT","HERAT",3201007,5,378,201,579
"HERAT","HERAT",3201007,6,363,154,517
"HERAT","HERAT",3201007,7,335,153,488
"HERAT","HERAT",3201007,8,298,135,433
"HERAT","HERAT",3201007,10,124,70,194
"HERAT","HERAT",3201024,9,204,62,266
"HERAT","HERAT",3201025,1,421,164,585
"HERAT","HERAT",3201025,2,383,174,557
"HERAT","HERAT",3201025,3,436,144,580
"HERAT","HERAT",3201025,4,369,130,499
"HERAT","HERAT",3201025,5,306,79,385
"HERAT","HERAT",3201013,7,196,71,267
"HERAT","HERAT",3201025,7,236,70,306
"HERAT","HERAT",3201025,8,189,49,238
"HERAT","HERAT",3201004,2,156,74,230
"HERAT","HERAT",3201004,3,216,117,333
"HERAT","HERAT",3201004,4,81,35,116
"HERAT","HERAT",3201004,5,156,77,233
"HERAT","HERAT",3201004,6,262,184,446
"HERAT","HERAT",3201027,4,270,121,391
"HERAT","HERAT",3201027,5,262,110,372
"HERAT","HERAT",3201027,6,415,176,591
"HERAT","HERAT",3201027,7,426,111,537
"HERAT","HERAT",3201027,8,421,117,538
"HERAT","HERAT",3201004,12,94,61,155
"HERAT","HERAT",3201006,2,356,217,573
"HERAT","HERAT",3201030,4,265,207,472
"HERAT","HERAT",3201030,5,231,103,334
"HERAT","HERAT",3201031,6,312,234,546
"HERAT","HERAT",3201012,3,147,56,203
"HERAT","HERAT",3201475,4,450,59,509
"HERAT","HERAT",3201475,5,119,63,182
"HERAT","HERAT",3201471,1,537,54,591
"HERAT","HERAT",3201471,2,525,55,580
"HERAT","HERAT",3201471,3,424,59,483
"HERAT","HERAT",3201471,4,577,22,599
"HERAT","HERAT",3201471,5,542,43,585
"HERAT","HERAT",3201471,6,565,21,586
"HERAT","HERAT",3201472,1,369,215,584
"HERAT","HERAT",3201472,2,366,205,571
"HERAT","HERAT",3201010,4,291,128,419
"HERAT","HERAT",3201010,5,285,74,359
"HERAT","HERAT",3201010,6,421,179,600
"HERAT","HERAT",3201010,7,399,82,481
"HERAT","HERAT",3201428,4,405,180,585
"HERAT","HERAT",3201428,5,302,89,391
"HERAT","HERAT",3201428,6,305,100,405
"HERAT","HERAT",3201428,7,311,115,426
"HERAT","HERAT",3201428,8,356,132,488
"HERAT","HERAT",3201428,9,294,142,436
"HERAT","HERAT",3201428,10,312,98,410
"HERAT","HERAT",3201025,6,278,60,338
"HERAT","HERAT",3201428,12,81,31,112
"HERAT","HERAT",3201004,1,221,145,366
"HERAT","HERAT",3201001,3,189,94,283
"HERAT","HERAT",3201001,4,170,92,262
"HERAT","HERAT",3201001,5,294,182,476
"HERAT","HERAT",3201001,6,171,129,300
"HERAT","HERAT",3201001,7,116,74,190
"HERAT","HERAT",3201004,7,173,81,254
"HERAT","HERAT",3201004,8,139,88,227
"HERAT","HERAT",3201004,9,137,66,203
"HERAT","HERAT",3201004,10,125,58,183
"HERAT","HERAT",3201004,11,166,76,242
"HERAT","HERAT",3201030,1,372,212,584
"HERAT","HERAT",3201027,10,351,86,437
"HERAT","HERAT",3201004,14,65,39,104
"HERAT","HERAT",3201021,1,356,182,538
"HERAT","HERAT",3201012,2,259,134,393
"HERAT","HERAT",3201475,3,467,76,543
"HERAT","HERAT",3201021,3,247,171,418
"HERAT","HERAT",3201021,4,270,130,400
"HERAT","HERAT",3201021,5,268,135,403
"HERAT","HERAT",3201021,6,262,168,430
"HERAT","HERAT",3201021,7,282,138,420
"HERAT","HERAT",3201433,1,230,223,453
"HERAT","HERAT",3201433,2,247,207,454
"HERAT","HERAT",3201433,3,172,197,369
"HERAT","HERAT",3201016,3,365,213,578
"HERAT","HERAT",3201016,4,371,218,589
"HERAT","HERAT",3201472,3,348,141,489
"HERAT","HERAT",3201472,4,295,149,444
"HERAT","HERAT",3201428,1,402,169,571
"HERAT","HERAT",3201428,2,409,175,584
"HERAT","HERAT",3201428,3,409,158,567
"HERAT","HERAT",3201024,6,203,50,253
"HERAT","HERAT",3201024,7,165,45,210
"HERAT","HERAT",3201024,8,184,28,212
"HERAT","HERAT",3201010,11,165,15,180
"HERAT","HERAT",3201010,12,164,33,197
"HERAT","HERAT",3201010,13,138,27,165
"HERAT","HERAT",3201428,11,40,18,58
"HERAT","HERAT",3201029,6,183,50,233
"HERAT","HERAT",3201029,7,149,33,182
"HERAT","HERAT",3201001,1,198,130,328
"HERAT","HERAT",3201001,2,317,238,555
"HERAT","HERAT",3201424,7,241,70,311
"HERAT","HERAT",3201424,8,185,57,242
"HERAT","HERAT",3201424,9,215,94,309
"HERAT","HERAT",3201001,8,82,40,122
"HERAT","HERAT",3201001,9,61,42,103
"HERAT","HERAT",3201001,10,171,113,284
"HERAT","HERAT",3201001,11,116,46,162
"HERAT","HERAT",3201001,12,93,57,150
"HERAT","HERAT",3201011,8,289,90,379
"HERAT","HERAT",3201004,13,79,34,113
"HERAT","HERAT",3201030,3,349,236,585
"HERAT","HERAT",3201475,1,383,167,550
"HERAT","HERAT",3201475,2,362,189,551
"HERAT","HERAT",3201021,2,255,144,399
"HERAT","HERAT",3201430,2,335,234,569
"HERAT","HERAT",3201430,3,228,158,386
"HERAT","HERAT",3201430,4,209,177,386
"HERAT","HERAT",3201430,5,241,160,401
"HERAT","HERAT",3201430,6,326,139,465
"HERAT","HERAT",3201430,7,346,167,513
"HERAT","HERAT",3201430,8,298,134,432
"HERAT","HERAT",3201430,9,349,148,497
"HERAT","HERAT",3201429,1,334,248,582
"HERAT","HERAT",3201429,2,126,76,202
"HERAT","HERAT",3201016,5,366,179,545
"HERAT","HERAT",3201016,6,423,169,592
"HERAT","HERAT",3201016,7,320,120,440
"HERAT","HERAT",3201016,8,303,106,409
"HERAT","HERAT",3201016,9,283,108,391
"HERAT","HERAT",3201010,8,340,100,440
"HERAT","HERAT",3201010,9,207,51,258
"HERAT","HERAT",3201010,10,164,42,206
"HERAT","HERAT",3201018,3,402,176,578
"HERAT","HERAT",3201018,4,416,170,586
"HERAT","HERAT",3201018,5,320,106,426
"HERAT","HERAT",3201018,6,281,91,372
"HERAT","HERAT",3201008,1,381,101,482
"HERAT","HERAT",3201008,2,387,110,497
"HERAT","HERAT",3201008,3,447,134,581
"HERAT","HERAT",3201008,4,324,70,394
"HERAT","HERAT",3201008,5,210,46,256
"HERAT","HERAT",3201008,6,190,33,223
"HERAT","HERAT",3201008,7,346,60,406
"HERAT","HERAT",3201424,10,78,33,111
"HERAT","HERAT",3201427,1,393,198,591
"HERAT","HERAT",3201427,2,383,208,591
"HERAT","HERAT",3201427,3,307,130,437
"HERAT","HERAT",3201427,4,421,170,591
"HERAT","HERAT",3201427,5,198,60,258
"HERAT","HERAT",3201011,9,193,65,258
"HERAT","HERAT",3201030,2,349,238,587
"HERAT","HERAT",3201427,8,458,138,596
"HERAT","HERAT",3201031,2,312,270,582
"HERAT","HERAT",3201430,1,371,211,582
"HERAT","HERAT",3201031,4,301,222,523
"HERAT","HERAT",3201031,5,320,257,577
"HERAT","HERAT",3201023,2,306,187,493
"HERAT","HERAT",3201023,3,280,190,470
"HERAT","HERAT",3201023,4,182,102,284
"HERAT","HERAT",3201023,5,173,106,279
"HERAT","HERAT",3201023,6,166,118,284
"HERAT","HERAT",3201023,7,287,190,477
"HERAT","HERAT",3201023,8,325,104,429
"HERAT","HERAT",3201023,9,217,128,345
"HERAT","HERAT",3201023,10,309,164,473
"HERAT","HERAT",3201023,11,131,87,218
"HERAT","HERAT",3201024,1,254,86,340
"HERAT","HERAT",3201024,2,157,43,200
"HERAT","HERAT",3201024,3,135,48,183
"HERAT","HERAT",3201024,4,128,48,176
"HERAT","HERAT",3201024,5,367,106,473
"HERAT","HERAT",3201018,2,394,176,570
"HERAT","HERAT",3201020,6,113,46,159
"HERAT","HERAT",3201017,1,363,213,576
"HERAT","HERAT",3201017,2,366,213,579
"HERAT","HERAT",3201029,3,275,84,359
"HERAT","HERAT",3201029,4,252,103,355
"HERAT","HERAT",3201029,5,276,73,349
"HERAT","HERAT",3201424,1,399,174,573
"HERAT","HERAT",3201424,2,381,195,576
"HERAT","HERAT",3201424,3,393,180,573
"HERAT","HERAT",3201424,4,435,154,589
"HERAT","HERAT",3201424,5,427,137,564
"HERAT","HERAT",3201424,6,359,106,465
"HERAT","HERAT",3201017,12,223,127,350
"HERAT","HERAT",3201017,13,336,160,496
"HERAT","HERAT",3201022,1,205,165,370
"HERAT","HERAT",3201022,2,300,272,572
"HERAT","HERAT",3201014,8,227,80,307
"HERAT","HERAT",3201427,6,366,151,517
"HERAT","HERAT",3201022,5,287,264,551
"HERAT","HERAT",3201427,7,358,107,465
"HERAT","HERAT",3201031,1,350,232,582
"HERAT","HERAT",3201031,3,290,231,521
"HERAT","HERAT",3201019,4,199,128,327
"HERAT","HERAT",3201019,5,175,176,351
"HERAT","HERAT",3201027,11,449,114,563
"HERAT","HERAT",3201028,1,380,210,590
"HERAT","HERAT",3201028,2,384,198,582
"HERAT","HERAT",3201028,3,371,225,596
"HERAT","HERAT",3201028,4,380,211,591
"HERAT","HERAT",3201028,5,371,115,486
"HERAT","HERAT",3201028,6,358,159,517
"HERAT","HERAT",3201433,4,129,42,171
"HERAT","HERAT",3201433,5,290,147,437
"HERAT","HERAT",3201433,6,155,71,226
"HERAT","HERAT",3201028,9,411,170,581
"HERAT","HERAT",3201028,10,100,39,139
"HERAT","HERAT",3201026,1,401,175,576
"HERAT","HERAT",3201026,2,374,200,574
"HERAT","HERAT",3201018,1,372,208,580
"HERAT","HERAT",3201020,5,101,37,138
"HERAT","HERAT",3201026,3,423,161,584
"HERAT","HERAT",3201026,4,260,70,330
"HERAT","HERAT",3201026,5,278,88,366
"HERAT","HERAT",3201026,6,229,78,307
"HERAT","HERAT",3201026,7,212,87,299
"HERAT","HERAT",3201026,8,170,109,279
"HERAT","HERAT",3201018,7,308,85,393
"HERAT","HERAT",3201018,8,465,117,582
"HERAT","HERAT",3201018,9,366,113,479
"HERAT","HERAT",3201018,10,125,73,198
"HERAT","HERAT",3201014,1,409,174,583
"HERAT","HERAT",3201014,2,412,157,569
"HERAT","HERAT",3201014,3,431,156,587
"HERAT","HERAT",3201014,4,430,157,587
"HERAT","HERAT",3201014,5,370,104,474
"HERAT","HERAT",3201014,6,405,105,510
"HERAT","HERAT",3201022,3,307,278,585
"HERAT","HERAT",3201022,4,296,280,576
"HERAT","HERAT",3201431,14,574,17,591
"HERAT","HERAT",3201014,9,213,81,294
"HERAT","HERAT",3201019,1,262,310,572
"HERAT","HERAT",3201022,8,209,162,371
"HERAT","HERAT",3201022,9,258,181,439
"HERAT","HERAT",3201022,10,148,110,258
"HERAT","HERAT",3201019,6,162,157,319
"HERAT","HERAT",3201019,7,241,171,412
"HERAT","HERAT",3201015,1,428,130,558
"HERAT","HERAT",3201015,2,420,160,580
"HERAT","HERAT",3201015,3,429,144,573
"HERAT","HERAT",3201015,4,397,163,560
"HERAT","HERAT",3201015,5,288,71,359
"HERAT","HERAT",3201015,6,268,72,340
"HERAT","HERAT",3201015,7,439,128,567
"HERAT","HERAT",3201015,8,449,132,581
"HERAT","HERAT",3201015,9,182,81,263
"HERAT","HERAT",3201020,1,122,54,176
"HERAT","HERAT",3201020,2,157,43,200
"HERAT","HERAT",3201020,3,115,38,153
"HERAT","HERAT",3201020,4,99,32,131
"HERAT","HERAT",3201429,7,62,60,122
"HERAT","HERAT",3201429,8,114,91,205
"HERAT","HERAT",3201429,9,115,85,200
"HERAT","HERAT",3201429,10,168,142,310
"HERAT","HERAT",3201029,1,394,154,548
"HERAT","HERAT",3201017,3,352,222,574
"HERAT","HERAT",3201017,4,323,258,581
"HERAT","HERAT",3201017,5,357,220,577
"HERAT","HERAT",3201017,6,299,237,536
"HERAT","HERAT",3201017,7,315,245,560
"HERAT","HERAT",3201017,8,343,238,581
"HERAT","HERAT",3201017,9,383,199,582
"HERAT","HERAT",3201017,10,384,196,580
"HERAT","HERAT",3201017,11,365,191,556
"HERAT","HERAT",3201431,7,530,55,585
"HERAT","HERAT",3201431,8,566,26,592
"HERAT","HERAT",3201431,9,556,34,590
"HERAT","HERAT",3201014,7,420,151,571
"HERAT","HERAT",3201431,13,577,15,592
"HERAT","HERAT",3201431,12,560,28,588
"HERAT","HERAT",3201473,4,183,64,247
"HERAT","HERAT",3201022,6,279,217,496
"HERAT","HERAT",3201019,2,228,309,537
"HERAT","HERAT",3201019,3,228,280,508
"HERAT","HERAT",3201426,1,285,304,589
"HERAT","HERAT",3201023,1,354,228,582
"HERAT","HERAT",3201426,3,137,373,510
"HERAT","HERAT",3201426,4,175,109,284
"HERAT","HERAT",3201426,5,178,138,316
"HERAT","HERAT",3201426,6,180,145,325
"HERAT","HERAT",3201473,1,320,118,438
"HERAT","HERAT",3201473,2,350,115,465
"HERAT","HERAT",3201473,3,156,43,199
"HERAT","HERAT",3201029,2,251,113,364
"HERAT","HERAT",3201028,7,308,148,456
"HERAT","HERAT",3201028,8,223,76,299
"HERAT","HERAT",3201429,3,76,82,158
"HERAT","HERAT",3201429,4,252,194,446
"HERAT","HERAT",3201429,5,109,89,198
"HERAT","HERAT",3201429,6,82,64,146
"HERAT","HERAT",3201474,3,555,32,587
"HERAT","HERAT",3201474,4,565,30,595
"HERAT","HERAT",3201474,5,353,18,371
"HERAT","HERAT",3201425,1,281,90,371
"HERAT","HERAT",3201425,2,303,80,383
"HERAT","HERAT",3201425,3,302,94,396
"HERAT","HERAT",3201431,3,536,43,579
"HERAT","HERAT",3201425,6,112,19,131
"HERAT","HERAT",3201431,1,547,41,588
"HERAT","HERAT",3201431,2,543,42,585
"HERAT","HERAT",3201431,11,573,20,593
"HERAT","HERAT",3201431,4,540,54,594
"HERAT","HERAT",3201431,5,544,46,590
"HERAT","HERAT",3201431,6,537,49,586
"HERAT","HERAT",3201022,7,358,231,589
"HERAT","HERAT",3201431,17,414,37,451
"HERAT","HERAT",3201431,18,556,30,586
"HERAT","HERAT",3201431,10,571,24,595
"HERAT","HERAT",3201432,4,29,11,40
"HERAT","HERAT",3201474,2,527,60,587
"HERAT","HERAT",3201425,8,149,40,189
"HERAT","HERAT",3201431,15,552,33,585
"HERAT","HERAT",3201474,1,537,55,592
"HERAT","HERAT",3201432,1,172,89,261
"HERAT","HERAT",3201425,7,149,49,198
"HERAT","HERAT",3201426,2,218,286,504
"HERAT","HERAT",3201425,5,163,32,195
"HERAT","HERAT",3201425,4,167,31,198
"HERAT","HERAT",3201431,16,572,19,591
"HERAT","ENJIL",3202061,1,123,50,173
"HERAT","ENJIL",3202036,1,392,185,577
"HERAT","ENJIL",3202061,3,112,57,169
"HERAT","ENJIL",3202079,1,78,34,112
"HERAT","ENJIL",3202434,3,148,2,150
"HERAT","ENJIL",3202435,1,314,181,495
"HERAT","ENJIL",3202047,1,252,322,574
"HERAT","ENJIL",3202032,4,230,48,278
"HERAT","ENJIL",3202435,4,379,204,583
"HERAT","ENJIL",3202032,3,174,53,227
"HERAT","ENJIL",3202061,2,123,50,173
"HERAT","ENJIL",3202047,2,287,290,577
"HERAT","ENJIL",3202032,2,207,53,260
"HERAT","ENJIL",3202036,3,440,143,583
"HERAT","ENJIL",3202042,3,297,26,323
"HERAT","ENJIL",3202434,2,69,7,76
"HERAT","ENJIL",3202036,2,395,182,577
"HERAT","ENJIL",3202039,7,89,29,118
"HERAT","ENJIL",3202036,4,26,14,40
"HERAT","ENJIL",3202435,3,265,160,425
"HERAT","ENJIL",3202434,1,78,6,84
"HERAT","ENJIL",3202037,3,444,133,577
"HERAT","ENJIL",3202037,1,336,132,468
"HERAT","ENJIL",3202435,2,342,226,568
"HERAT","ENJIL",3202056,3,127,24,151
"HERAT","ENJIL",3202039,2,277,114,391
"HERAT","ENJIL",3202037,4,99,6,105
"HERAT","ENJIL",3202037,2,324,147,471
"HERAT","ENJIL",3202079,2,88,20,108
"HERAT","ENJIL",3202039,6,26,16,42
"HERAT","ENJIL",3202047,3,452,139,591
"HERAT","ENJIL",3202048,2,293,38,331
"HERAT","ENJIL",3202078,2,56,16,72
"HERAT","ENJIL",3202034,2,358,230,588
"HERAT","ENJIL",3202034,3,258,195,453
"HERAT","ENJIL",3202047,4,210,156,366
"HERAT","ENJIL",3202047,5,155,92,247
"HERAT","ENJIL",3202435,5,110,45,155
"HERAT","ENJIL",3202436,1,460,65,525
"HERAT","ENJIL",3202034,4,281,172,453
"HERAT","ENJIL",3202034,5,339,138,477
"HERAT","ENJIL",3202039,5,473,114,587
"HERAT","ENJIL",3202078,1,73,19,92
"HERAT","ENJIL",3202476,3,277,78,355
"HERAT","ENJIL",3202032,1,230,62,292
"HERAT","ENJIL",3202042,2,197,35,232
"HERAT","ENJIL",3202042,1,140,31,171
"HERAT","ENJIL",3202045,3,137,12,149
"HERAT","ENJIL",3202046,1,245,53,298
"HERAT","ENJIL",3202046,2,286,82,368
"HERAT","ENJIL",3202046,3,480,88,568
"HERAT","ENJIL",3202036,5,111,56,167
"HERAT","ENJIL",3202436,2,492,72,564
"HERAT","ENJIL",3202436,3,549,34,583
"HERAT","ENJIL",3202039,4,457,130,587
"HERAT","ENJIL",3202068,3,502,85,587
"HERAT","ENJIL",3202068,4,67,9,76
"HERAT","ENJIL",3202074,1,532,53,585
"HERAT","ENJIL",3202074,2,520,67,587
"HERAT","ENJIL",3202074,3,555,27,582
"HERAT","ENJIL",3202074,4,121,23,144
"HERAT","ENJIL",3202041,3,336,71,407
"HERAT","ENJIL",3202048,1,471,118,589
"HERAT","ENJIL",3202077,2,237,195,432
"HERAT","ENJIL",3202072,1,242,334,576
"HERAT","ENJIL",3202039,1,413,175,588
"HERAT","ENJIL",3202039,3,405,184,589
"HERAT","ENJIL",3202076,1,163,71,234
"HERAT","ENJIL",3202076,3,263,60,323
"HERAT","ENJIL",3202051,1,84,49,133
"HERAT","ENJIL",3202033,3,131,19,150
"HERAT","ENJIL",3202033,4,174,29,203
"HERAT","ENJIL",3202034,1,370,205,575
"HERAT","ENJIL",3202052,2,136,23,159
"HERAT","ENJIL",3202052,3,253,44,297
"HERAT","ENJIL",3202049,1,413,79,492
"HERAT","ENJIL",3202049,2,209,21,230
"HERAT","ENJIL",3202034,6,305,97,402
"HERAT","ENJIL",3202034,7,384,205,589
"HERAT","ENJIL",3202035,1,414,150,564
"HERAT","ENJIL",3202035,2,382,129,511
"HERAT","ENJIL",3202436,4,224,24,248
"HERAT","ENJIL",3202476,1,255,91,346
"HERAT","ENJIL",3202476,2,197,72,269
"HERAT","ENJIL",3202035,8,290,65,355
"HERAT","ENJIL",3202035,9,317,72,389
"HERAT","ENJIL",3202056,2,90,11,101
"HERAT","ENJIL",3202073,1,269,148,417
"HERAT","ENJIL",3202073,2,304,119,423
"HERAT","ENJIL",3202073,3,276,53,329
"HERAT","ENJIL",3202073,4,194,59,253
"HERAT","ENJIL",3202073,5,242,53,295
"HERAT","ENJIL",3202081,4,119,48,167
"HERAT","ENJIL",3202063,2,210,59,269
"HERAT","ENJIL",3202063,3,361,85,446
"HERAT","ENJIL",3202066,1,420,67,487
"HERAT","ENJIL",3202066,2,419,23,442
"HERAT","ENJIL",3202057,1,316,37,353
"HERAT","ENJIL",3202057,2,271,45,316
"HERAT","ENJIL",3202057,3,444,54,498
"HERAT","ENJIL",3202041,1,201,50,251
"HERAT","ENJIL",3202074,5,340,21,361
"HERAT","ENJIL",3202077,1,258,322,580
"HERAT","ENJIL",3202060,3,209,354,563
"HERAT","ENJIL",3202062,1,103,27,130
"HERAT","ENJIL",3202048,3,48,15,63
"HERAT","ENJIL",3202043,1,439,109,548
"HERAT","ENJIL",3202043,2,416,104,520
"HERAT","ENJIL",3202076,2,199,64,263
"HERAT","ENJIL",3202033,1,251,61,312
"HERAT","ENJIL",3202051,2,126,56,182
"HERAT","ENJIL",3202051,3,198,107,305
"HERAT","ENJIL",3202052,1,134,24,158
"HERAT","ENJIL",3202071,8,329,75,404
"HERAT","ENJIL",3202064,1,140,14,154
"HERAT","ENJIL",3202064,2,149,47,196
"HERAT","ENJIL",3202064,3,123,44,167
"HERAT","ENJIL",3202044,1,257,19,276
"HERAT","ENJIL",3202044,2,196,18,214
"HERAT","ENJIL",3202044,3,480,42,522
"HERAT","ENJIL",3202038,1,501,84,585
"HERAT","ENJIL",3202035,3,293,107,400
"HERAT","ENJIL",3202035,4,432,135,567
"HERAT","ENJIL",3202035,5,399,94,493
"HERAT","ENJIL",3202035,6,290,97,387
"HERAT","ENJIL",3202035,7,261,72,333
"HERAT","ENJIL",3202045,2,72,15,87
"HERAT","ENJIL",3202056,1,60,13,73
"HERAT","ENJIL",3202080,1,313,35,348
"HERAT","ENJIL",3202080,2,213,38,251
"HERAT","ENJIL",3202080,3,453,71,524
"HERAT","ENJIL",3202054,1,257,58,315
"HERAT","ENJIL",3202063,1,243,72,315
"HERAT","ENJIL",3202054,3,499,95,594
"HERAT","ENJIL",3202081,5,188,50,238
"HERAT","ENJIL",3202081,6,165,84,249
"HERAT","ENJIL",3202068,1,360,174,534
"HERAT","ENJIL",3202068,2,415,163,578
"HERAT","ENJIL",3202053,2,321,71,392
"HERAT","ENJIL",3202053,3,509,67,576
"HERAT","ENJIL",3202058,1,315,126,441
"HERAT","ENJIL",3202041,2,203,64,267
"HERAT","ENJIL",3202060,2,113,313,426
"HERAT","ENJIL",3202050,1,152,64,216
"HERAT","ENJIL",3202050,2,173,42,215
"HERAT","ENJIL",3202050,3,388,103,491
"HERAT","ENJIL",3202072,2,293,108,401
"HERAT","ENJIL",3202072,3,13,27,40
"HERAT","ENJIL",3202043,3,448,59,507
"HERAT","ENJIL",3202043,4,383,55,438
"HERAT","ENJIL",3202033,2,160,28,188
"HERAT","ENJIL",3202071,6,464,120,584
"HERAT","ENJIL",3202071,7,310,119,429
"HERAT","ENJIL",3202038,6,554,43,597
"HERAT","ENJIL",3202065,4,489,92,581
"HERAT","ENJIL",3202065,5,426,67,493
"HERAT","ENJIL",3202070,1,164,72,236
"HERAT","ENJIL",3202067,1,420,167,587
"HERAT","ENJIL",3202067,2,458,138,596
"HERAT","ENJIL",3202075,1,365,44,409
"HERAT","ENJIL",3202075,2,311,50,361
"HERAT","ENJIL",3202075,3,527,62,589
"HERAT","ENJIL",3202038,2,486,96,582
"HERAT","ENJIL",3202038,3,410,58,468
"HERAT","ENJIL",3202038,4,547,38,585
"HERAT","ENJIL",3202045,1,86,11,97
"HERAT","ENJIL",3202038,5,527,50,577
"HERAT","ENJIL",3202065,3,459,115,574
"HERAT","ENJIL",3202058,2,322,113,435
"HERAT","ENJIL",3202058,3,479,113,592
"HERAT","ENJIL",3202070,2,204,108,312
"HERAT","ENJIL",3202070,3,304,134,438
"HERAT","ENJIL",3202054,2,247,60,307
"HERAT","ENJIL",3202081,2,134,347,481
"HERAT","ENJIL",3202081,3,152,333,485
"HERAT","ENJIL",3202055,1,331,16,347
"HERAT","ENJIL",3202055,2,271,10,281
"HERAT","ENJIL",3202055,3,538,12,550
"HERAT","ENJIL",3202053,1,306,79,385
"HERAT","ENJIL",3202069,3,274,34,308
"HERAT","ENJIL",3202065,2,340,108,448
"HERAT","ENJIL",3202071,2,432,159,591
"HERAT","ENJIL",3202069,1,127,29,156
"HERAT","ENJIL",3202062,3,135,32,167
"HERAT","ENJIL",3202060,1,89,347,436
"HERAT","ENJIL",3202071,3,422,161,583
"HERAT","ENJIL",3202062,2,98,12,110
"HERAT","ENJIL",3202071,4,486,102,588
"HERAT","ENJIL",3202059,2,126,29,155
"HERAT","ENJIL",3202071,5,475,111,586
"HERAT","ENJIL",3202081,1,206,362,568
"HERAT","ENJIL",3202069,2,104,15,119
"HERAT","ENJIL",3202071,1,451,131,582
"HERAT","ENJIL",3202059,1,149,42,191
"HERAT","ENJIL",3202065,1,331,82,413
"HERAT","GUZARA",3203087,2,346,237,583
"HERAT","GUZARA",3203084,3,508,56,564
"HERAT","GUZARA",3203084,4,221,28,249
"HERAT","GUZARA",3203088,3,178,33,211
"HERAT","GUZARA",3203088,1,127,37,164
"HERAT","GUZARA",3203087,1,353,176,529
"HERAT","GUZARA",3203086,4,163,142,305
"HERAT","GUZARA",3203087,3,369,196,565
"HERAT","GUZARA",3203106,2,145,124,269
"HERAT","GUZARA",3203106,3,180,151,331
"HERAT","GUZARA",3203088,2,122,33,155
"HERAT","GUZARA",3203106,1,299,224,523
"HERAT","GUZARA",3203091,4,118,88,206
"HERAT","GUZARA",3203090,1,167,114,281
"HERAT","GUZARA",3203084,2,327,49,376
"HERAT","GUZARA",3203091,3,408,170,578
"HERAT","GUZARA",3203116,4,1,7,8
"HERAT","GUZARA",3203108,1,290,176,466
"HERAT","GUZARA",3203108,2,296,113,409
"HERAT","GUZARA",3203107,3,246,250,496
"HERAT","GUZARA",3203109,2,70,208,278
"HERAT","GUZARA",3203118,1,40,409,449
"HERAT","GUZARA",3203118,2,17,413,430
"HERAT","GUZARA",3203109,1,134,373,507
"HERAT","GUZARA",3203438,2,4,96,100
"HERAT","GUZARA",3203437,1,107,92,199
"HERAT","GUZARA",3203082,4,18,259,277
"HERAT","GUZARA",3203084,1,456,56,512
"HERAT","GUZARA",3203083,2,82,91,173
"HERAT","GUZARA",3203086,3,145,129,274
"HERAT","GUZARA",3203105,2,136,39,175
"HERAT","GUZARA",3203085,2,477,94,571
"HERAT","GUZARA",3203085,3,27,8,35
"HERAT","GUZARA",3203085,4,20,1,21
"HERAT","GUZARA",3203098,1,135,39,174
"HERAT","GUZARA",3203098,2,117,34,151
"HERAT","GUZARA",3203438,1,11,99,110
"HERAT","GUZARA",3203082,1,14,127,141
"HERAT","GUZARA",3203082,2,18,120,138
"HERAT","GUZARA",3203437,2,98,67,165
"HERAT","GUZARA",3203086,1,214,211,425
"HERAT","GUZARA",3203086,5,175,117,292
"HERAT","GUZARA",3203096,3,138,127,265
"HERAT","GUZARA",3203096,4,331,250,581
"HERAT","GUZARA",3203096,5,137,98,235
"HERAT","GUZARA",3203102,1,77,47,124
"HERAT","GUZARA",3203106,4,338,239,577
"HERAT","GUZARA",3203091,1,281,192,473
"HERAT","GUZARA",3203091,2,265,223,488
"HERAT","GUZARA",3203111,1,134,23,157
"HERAT","GUZARA",3203111,2,230,6,236
"HERAT","GUZARA",3203090,2,203,127,330
"HERAT","GUZARA",3203082,3,11,133,144
"HERAT","GUZARA",3203096,1,244,211,455
"HERAT","GUZARA",3203096,2,207,181,388
"HERAT","GUZARA",3203116,3,1,11,12
"HERAT","GUZARA",3203093,1,218,69,287
"HERAT","GUZARA",3203093,2,277,37,314
"HERAT","GUZARA",3203103,1,277,130,407
"HERAT","GUZARA",3203103,2,222,86,308
"HERAT","GUZARA",3203104,1,116,364,480
"HERAT","GUZARA",3203104,2,114,359,473
"HERAT","GUZARA",3203099,1,256,180,436
"HERAT","GUZARA",3203088,4,445,84,529
"HERAT","GUZARA",3203089,1,195,99,294
"HERAT","GUZARA",3203089,2,175,103,278
"HERAT","GUZARA",3203092,1,253,240,493
"HERAT","GUZARA",3203083,1,87,76,163
"HERAT","GUZARA",3203086,2,205,182,387
"HERAT","GUZARA",3203085,1,436,123,559
"HERAT","GUZARA",3203097,5,89,11,100
"HERAT","GUZARA",3203100,1,83,122,205
"HERAT","GUZARA",3203100,2,53,66,119
"HERAT","GUZARA",3203094,1,229,67,296
"HERAT","GUZARA",3203094,2,211,49,260
"HERAT","GUZARA",3203094,3,411,122,533
"HERAT","GUZARA",3203114,1,15,167,182
"HERAT","GUZARA",3203114,2,12,179,191
"HERAT","GUZARA",3203113,1,5,42,47
"HERAT","GUZARA",3203098,3,165,30,195
"HERAT","GUZARA",3203092,2,224,149,373
"HERAT","GUZARA",3203107,1,128,180,308
"HERAT","GUZARA",3203107,2,181,179,360
"HERAT","GUZARA",3203105,1,140,59,199
"HERAT","GUZARA",3203097,3,73,9,82
"HERAT","GUZARA",3203101,2,139,64,203
"HERAT","GUZARA",3203097,1,65,10,75
"HERAT","GUZARA",3203106,5,396,165,561
"HERAT","GUZARA",3203106,6,426,126,552
"HERAT","GUZARA",3203113,4,16,83,99
"HERAT","GUZARA",3203116,1,9,77,86
"HERAT","GUZARA",3203110,1,330,27,357
"HERAT","GUZARA",3203110,2,359,23,382
"HERAT","GUZARA",3203102,2,50,37,87
"HERAT","GUZARA",3203101,1,178,106,284
"HERAT","GUZARA",3203116,2,3,41,44
"HERAT","GUZARA",3203097,4,101,13,114
"HERAT","GUZARA",3203095,1,85,260,345
"HERAT","GUZARA",3203095,2,61,169,230
"HERAT","GUZARA",3203099,2,400,188,588
"HERAT","GUZARA",3203099,3,9,10,19
"HERAT","GUZARA",3203117,1,18,29,47
"HERAT","GUZARA",3203097,2,85,18,103
"HERAT","GUZARA",3203095,3,160,362,522
"HERAT","GUZARA",3203092,3,367,187,554
"HERAT","GUZARA",3203117,2,6,16,22
"HERAT","GUZARA",3203113,2,17,22,39
"HERAT","GUZARA",3203113,3,8,34,42
"HERAT","GUZARA",3203090,3,354,142,496
"HERAT","KARRUKH",3204151,3,244,20,264
"HERAT","KARRUKH",3204148,3,188,25,213
"HERAT","KARRUKH",3204151,2,98,20,118
"HERAT","KARRUKH",3204148,2,292,43,335
"HERAT","KARRUKH",3204152,1,257,65,322
"HERAT","KARRUKH",3204151,1,154,23,177
"HERAT","KARRUKH",3204148,1,307,38,345
"HERAT","KARRUKH",3204149,4,448,136,584
"HERAT","KARRUKH",3204157,2,128,36,164
"HERAT","KARRUKH",3204152,2,256,50,306
"HERAT","KARRUKH",3204149,3,128,66,194
"HERAT","KARRUKH",3204157,1,227,40,267
"HERAT","KARRUKH",3204150,2,369,52,421
"HERAT","KARRUKH",3204150,3,544,33,577
"HERAT","KARRUKH",3204152,3,388,34,422
"HERAT","KARRUKH",3204160,2,28,10,38
"HERAT","KARRUKH",3204156,1,156,109,265
"HERAT","KARRUKH",3204160,3,26,7,33
"HERAT","KARRUKH",3204160,4,9,9,18
"HERAT","KARRUKH",3204160,5,9,6,15
"HERAT","KARRUKH",3204158,1,191,83,274
"HERAT","KARRUKH",3204158,2,149,35,184
"HERAT","KARRUKH",3204442,1,278,53,331
"HERAT","KARRUKH",3204160,1,49,19,68
"HERAT","KARRUKH",3204159,2,557,17,574
"HERAT","KARRUKH",3204153,3,149,27,176
"HERAT","KARRUKH",3204163,1,387,17,404
"HERAT","KARRUKH",3204156,2,131,111,242
"HERAT","KARRUKH",3204155,1,383,38,421
"HERAT","KARRUKH",3204149,2,128,69,197
"HERAT","KARRUKH",3204148,5,146,27,173
"HERAT","KARRUKH",3204163,2,115,8,123
"HERAT","KARRUKH",3204157,3,328,52,380
"HERAT","KARRUKH",3204155,2,232,5,237
"HERAT","KARRUKH",3204162,2,34,26,60
"HERAT","KARRUKH",3204148,6,435,42,477
"HERAT","KARRUKH",3204442,2,165,22,187
"HERAT","KARRUKH",3204149,1,92,52,144
"HERAT","KARRUKH",3204150,1,255,57,312
"HERAT","KARRUKH",3204154,2,115,25,140
"HERAT","KARRUKH",3204164,1,54,33,87
"HERAT","KARRUKH",3204162,1,68,29,97
"HERAT","KARRUKH",3204164,3,22,15,37
"HERAT","KARRUKH",3204154,1,191,82,273
"HERAT","KARRUKH",3204161,2,127,14,141
"HERAT","KARRUKH",3204161,1,97,20,117
"HERAT","KARRUKH",3204161,4,57,1,58
"HERAT","KARRUKH",3204159,1,473,29,502
"HERAT","KARRUKH",3204148,7,375,19,394
"HERAT","KARRUKH",3204164,2,33,23,56
"HERAT","KARRUKH",3204153,1,65,15,80
"HERAT","KARRUKH",3204153,2,60,17,77
"HERAT","KARRUKH",3204163,3,134,16,150
"HERAT","KARRUKH",3204161,3,46,6,52
"HERAT","KARRUKH",3204148,4,209,22,231
"HERAT","ZENDAJAN",3205266,1,40,170,210
"HERAT","ZENDAJAN",3205268,1,152,112,264
"HERAT","ZENDAJAN",3205266,2,45,171,216
"HERAT","ZENDAJAN",3205266,3,101,386,487
"HERAT","ZENDAJAN",3205478,3,411,42,453
"HERAT","ZENDAJAN",3205268,2,139,275,414
"HERAT","ZENDAJAN",3205262,3,452,127,579
"HERAT","ZENDAJAN",3205458,1,380,31,411
"HERAT","ZENDAJAN",3205264,2,51,35,86
"HERAT","ZENDAJAN",3205264,3,158,122,280
"HERAT","ZENDAJAN",3205265,3,135,250,385
"HERAT","ZENDAJAN",3205264,1,60,59,119
"HERAT","ZENDAJAN",3205268,4,115,161,276
"HERAT","ZENDAJAN",3205274,1,125,110,235
"HERAT","ZENDAJAN",3205265,1,43,143,186
"HERAT","ZENDAJAN",3205265,2,49,128,177
"HERAT","ZENDAJAN",3205262,2,115,107,222
"HERAT","ZENDAJAN",3205272,3,69,52,121
"HERAT","ZENDAJAN",3205269,3,114,97,211
"HERAT","ZENDAJAN",3205268,3,51,112,163
"HERAT","ZENDAJAN",3205458,3,315,15,330
"HERAT","ZENDAJAN",3205263,2,260,14,274
"HERAT","ZENDAJAN",3205269,2,35,20,55
"HERAT","ZENDAJAN",3205458,2,285,131,416
"HERAT","ZENDAJAN",3205263,1,305,52,357
"HERAT","ZENDAJAN",3205271,2,69,139,208
"HERAT","ZENDAJAN",3205272,1,90,132,222
"HERAT","ZENDAJAN",3205261,3,230,86,316
"HERAT","ZENDAJAN",3205273,3,497,46,543
"HERAT","ZENDAJAN",3205267,1,59,31,90
"HERAT","ZENDAJAN",3205274,2,149,8,157
"HERAT","ZENDAJAN",3205272,2,72,84,156
"HERAT","ZENDAJAN",3205261,2,196,55,251
"HERAT","ZENDAJAN",3205478,2,198,87,285
"HERAT","ZENDAJAN",3205262,1,72,58,130
"HERAT","ZENDAJAN",3205263,3,259,28,287
"HERAT","ZENDAJAN",3205478,1,259,39,298
"HERAT","ZENDAJAN",3205273,1,278,108,386
"HERAT","ZENDAJAN",3205261,4,463,114,577
"HERAT","ZENDAJAN",3205269,1,89,30,119
"HERAT","ZENDAJAN",3205261,1,247,93,340
"HERAT","ZENDAJAN",3205267,2,32,7,39
"HERAT","ZENDAJAN",3205273,2,191,42,233
"HERAT","ZENDAJAN",3205271,1,130,160,290
"HERAT","ZENDAJAN",3205274,3,397,143,540
"HERAT","ZENDAJAN",3205270,1,194,112,306
"HERAT","ZENDAJAN",3205270,2,236,98,334
"HERAT","PASHTUN ZARG",3206128,3,38,72,110
"HERAT","PASHTUN ZARG",3206133,2,39,34,73
"HERAT","PASHTUN ZARG",3206145,1,84,52,136
"HERAT","PASHTUN ZARG",3206144,2,103,37,140
"HERAT","PASHTUN ZARG",3206128,4,179,91,270
"HERAT","PASHTUN ZARG",3206128,2,58,81,139
"HERAT","PASHTUN ZARG",3206144,1,82,65,147
"HERAT","PASHTUN ZARG",3206135,3,15,94,109
"HERAT","PASHTUN ZARG",3206145,2,31,524,555
"HERAT","PASHTUN ZARG",3206141,2,90,58,148
"HERAT","PASHTUN ZARG",3206129,2,132,98,230
"HERAT","PASHTUN ZARG",3206129,3,211,159,370
"HERAT","PASHTUN ZARG",3206441,1,202,363,565
"HERAT","PASHTUN ZARG",3206135,1,91,170,261
"HERAT","PASHTUN ZARG",3206140,2,163,84,247
"HERAT","PASHTUN ZARG",3206132,3,305,51,356
"HERAT","PASHTUN ZARG",3206128,1,170,138,308
"HERAT","PASHTUN ZARG",3206129,1,146,122,268
"HERAT","PASHTUN ZARG",3206119,3,162,370,532
"HERAT","PASHTUN ZARG",3206135,2,30,31,61
"HERAT","PASHTUN ZARG",3206128,5,137,139,276
"HERAT","PASHTUN ZARG",3206119,2,194,376,570
"HERAT","PASHTUN ZARG",3206130,2,25,207,232
"HERAT","PASHTUN ZARG",3206138,1,70,110,180
"HERAT","PASHTUN ZARG",3206138,2,31,67,98
"HERAT","PASHTUN ZARG",3206130,1,72,172,244
"HERAT","PASHTUN ZARG",3206123,1,158,40,198
"HERAT","PASHTUN ZARG",3206123,2,120,35,155
"HERAT","PASHTUN ZARG",3206142,2,301,58,359
"HERAT","PASHTUN ZARG",3206141,1,279,96,375
"HERAT","PASHTUN ZARG",3206136,2,59,95,154
"HERAT","PASHTUN ZARG",3206136,3,132,145,277
"HERAT","PASHTUN ZARG",3206119,4,134,260,394
"HERAT","PASHTUN ZARG",3206119,5,341,193,534
"HERAT","PASHTUN ZARG",3206119,6,368,162,530
"HERAT","PASHTUN ZARG",3206137,1,185,70,255
"HERAT","PASHTUN ZARG",3206137,2,178,171,349
"HERAT","PASHTUN ZARG",3206147,1,100,393,493
"HERAT","PASHTUN ZARG",3206138,3,42,38,80
"HERAT","PASHTUN ZARG",3206147,3,105,438,543
"HERAT","PASHTUN ZARG",3206140,1,202,187,389
"HERAT","PASHTUN ZARG",3206131,2,278,50,328
"HERAT","PASHTUN ZARG",3206136,1,90,98,188
"HERAT","PASHTUN ZARG",3206133,1,64,34,98
"HERAT","PASHTUN ZARG",3206146,2,35,522,557
"HERAT","PASHTUN ZARG",3206441,2,113,222,335
"HERAT","PASHTUN ZARG",3206143,1,100,212,312
"HERAT","PASHTUN ZARG",3206143,2,86,120,206
"HERAT","PASHTUN ZARG",3206440,2,145,133,278
"HERAT","PASHTUN ZARG",3206132,1,138,56,194
"HERAT","PASHTUN ZARG",3206440,1,148,153,301
"HERAT","PASHTUN ZARG",3206147,2,103,428,531
"HERAT","PASHTUN ZARG",3206119,1,242,292,534
"HERAT","PASHTUN ZARG",3206146,1,48,458,506
"HERAT","PASHTUN ZARG",3206132,2,129,52,181
"HERAT","PASHTUN ZARG",3206122,2,135,62,197
"HERAT","PASHTUN ZARG",3206126,2,19,63,82
"HERAT","PASHTUN ZARG",3206124,3,274,20,294
"HERAT","PASHTUN ZARG",3206126,4,51,117,168
"HERAT","PASHTUN ZARG",3206126,1,25,54,79
"HERAT","PASHTUN ZARG",3206124,2,166,25,191
"HERAT","PASHTUN ZARG",3206138,5,66,80,146
"HERAT","PASHTUN ZARG",3206125,1,144,41,185
"HERAT","PASHTUN ZARG",3206124,1,167,14,181
"HERAT","PASHTUN ZARG",3206142,1,229,15,244
"HERAT","PASHTUN ZARG",3206121,2,92,138,230
"HERAT","PASHTUN ZARG",3206134,2,37,15,52
"HERAT","PASHTUN ZARG",3206138,4,48,57,105
"HERAT","PASHTUN ZARG",3206121,1,79,118,197
"HERAT","PASHTUN ZARG",3206131,1,278,124,402
"HERAT","PASHTUN ZARG",3206120,3,250,204,454
"HERAT","PASHTUN ZARG",3206126,3,38,58,96
"HERAT","PASHTUN ZARG",3206125,2,134,30,164
"HERAT","PASHTUN ZARG",3206120,2,88,85,173
"HERAT","PASHTUN ZARG",3206122,1,123,48,171
"HERAT","PASHTUN ZARG",3206120,1,138,105,243
"HERAT","PASHTUN ZARG",3206134,1,43,16,59
"HERAT","PASHTUN ZARG",3206121,3,184,230,414
"HERAT","KUSHK (RUBAT-E",3207179,2,162,31,193
"HERAT","KUSHK (RUBAT-E",3207171,1,302,12,314
"HERAT","KUSHK (RUBAT-E",3207179,3,291,18,309
"HERAT","KUSHK (RUBAT-E",3207179,1,278,9,287
"HERAT","KUSHK (RUBAT-E",3207192,3,19,163,182
"HERAT","KUSHK (RUBAT-E",3207182,1,125,115,240
"HERAT","KUSHK (RUBAT-E",3207171,2,289,17,306
"HERAT","KUSHK (RUBAT-E",3207171,3,568,18,586
"HERAT","KUSHK (RUBAT-E",3207190,1,234,122,356
"HERAT","KUSHK (RUBAT-E",3207190,3,203,156,359
"HERAT","KUSHK (RUBAT-E",3207168,1,164,7,171
"HERAT","KUSHK (RUBAT-E",3207182,2,141,226,367
"HERAT","KUSHK (RUBAT-E",3207173,1,270,5,275
"HERAT","KUSHK (RUBAT-E",3207173,2,277,3,280
"HERAT","KUSHK (RUBAT-E",3207172,3,133,24,157
"HERAT","KUSHK (RUBAT-E",3207172,4,376,39,415
"HERAT","KUSHK (RUBAT-E",3207167,1,280,30,310
"HERAT","KUSHK (RUBAT-E",3207191,3,232,310,542
"HERAT","KUSHK (RUBAT-E",3207169,1,97,2,99
"HERAT","KUSHK (RUBAT-E",3207169,2,74,1,75
"HERAT","KUSHK (RUBAT-E",3207192,1,12,300,312
"HERAT","KUSHK (RUBAT-E",3207167,2,310,18,328
"HERAT","KUSHK (RUBAT-E",3207170,1,245,17,262
"HERAT","KUSHK (RUBAT-E",3207170,2,17,9,26
"HERAT","KUSHK (RUBAT-E",3207184,3,187,61,248
"HERAT","KUSHK (RUBAT-E",3207192,2,8,161,169
"HERAT","KUSHK (RUBAT-E",3207193,2,29,555,584
"HERAT","KUSHK (RUBAT-E",3207193,3,27,564,591
"HERAT","KUSHK (RUBAT-E",3207193,4,50,505,555
"HERAT","KUSHK (RUBAT-E",3207193,1,39,548,587
"HERAT","KUSHK (RUBAT-E",3207168,2,151,8,159
"HERAT","KUSHK (RUBAT-E",3207168,3,340,7,347
"HERAT","KUSHK (RUBAT-E",3207182,3,98,207,305
"HERAT","KUSHK (RUBAT-E",3207193,5,16,396,412
"HERAT","KUSHK (RUBAT-E",3207178,3,277,1,278
"HERAT","KUSHK (RUBAT-E",3207176,1,534,63,597
"HERAT","KUSHK (RUBAT-E",3207176,2,495,5,500
"HERAT","KUSHK (RUBAT-E",3207190,2,176,136,312
"HERAT","KUSHK (RUBAT-E",3207190,4,151,151,302
"HERAT","KUSHK (RUBAT-E",3207177,1,242,33,275
"HERAT","KUSHK (RUBAT-E",3207177,2,176,25,201
"HERAT","KUSHK (RUBAT-E",3207177,3,404,31,435
"HERAT","KUSHK (RUBAT-E",3207183,1,210,38,248
"HERAT","KUSHK (RUBAT-E",3207183,2,132,28,160
"HERAT","KUSHK (RUBAT-E",3207183,3,138,37,175
"HERAT","KUSHK (RUBAT-E",3207178,1,110,7,117
"HERAT","KUSHK (RUBAT-E",3207182,4,95,406,501
"HERAT","KUSHK (RUBAT-E",3207191,1,169,414,583
"HERAT","KUSHK (RUBAT-E",3207191,2,114,207,321
"HERAT","KUSHK (RUBAT-E",3207172,1,184,25,209
"HERAT","KUSHK (RUBAT-E",3207172,2,148,28,176
"HERAT","KUSHK (RUBAT-E",3207189,4,268,312,580
"HERAT","KUSHK (RUBAT-E",3207174,1,342,15,357
"HERAT","KUSHK (RUBAT-E",3207174,2,292,9,301
"HERAT","KUSHK (RUBAT-E",3207445,1,81,8,89
"HERAT","KUSHK (RUBAT-E",3207445,2,69,1,70
"HERAT","KUSHK (RUBAT-E",3207166,1,278,69,347
"HERAT","KUSHK (RUBAT-E",3207188,2,424,9,433
"HERAT","KUSHK (RUBAT-E",3207194,1,125,118,243
"HERAT","KUSHK (RUBAT-E",3207178,2,103,9,112
"HERAT","KUSHK (RUBAT-E",3207165,1,225,125,350
"HERAT","KUSHK (RUBAT-E",3207165,2,294,122,416
"HERAT","KUSHK (RUBAT-E",3207184,1,90,58,148
"HERAT","KUSHK (RUBAT-E",3207184,2,151,82,233
"HERAT","KUSHK (RUBAT-E",3207446,2,175,202,377
"HERAT","KUSHK (RUBAT-E",3207187,1,351,26,377
"HERAT","KUSHK (RUBAT-E",3207186,1,117,10,127
"HERAT","KUSHK (RUBAT-E",3207186,2,85,9,94
"HERAT","KUSHK (RUBAT-E",3207186,3,106,16,122
"HERAT","KUSHK (RUBAT-E",3207479,1,371,1,372
"HERAT","KUSHK (RUBAT-E",3207187,2,285,10,295
"HERAT","KUSHK (RUBAT-E",3207187,3,323,7,330
"HERAT","KUSHK (RUBAT-E",3207166,4,179,38,217
"HERAT","KUSHK (RUBAT-E",3207189,3,198,377,575
"HERAT","KUSHK (RUBAT-E",3207479,2,198,3,201
"HERAT","KUSHK (RUBAT-E",3207479,3,595,3,598
"HERAT","KUSHK (RUBAT-E",3207446,1,163,214,377
"HERAT","KUSHK (RUBAT-E",3207194,2,36,12,48
"HERAT","KUSHK (RUBAT-E",3207181,2,220,13,233
"HERAT","KUSHK (RUBAT-E",3207445,3,186,3,189
"HERAT","KUSHK (RUBAT-E",3207188,1,425,38,463
"HERAT","KUSHK (RUBAT-E",3207189,2,231,353,584
"HERAT","KUSHK (RUBAT-E",3207165,4,446,129,575
"HERAT","KUSHK (RUBAT-E",3207187,4,331,7,338
"HERAT","KUSHK (RUBAT-E",3207189,1,257,327,584
"HERAT","KUSHK (RUBAT-E",3207165,3,231,120,351
"HERAT","KUSHK (RUBAT-E",3207166,2,205,27,232
"HERAT","KUSHK (RUBAT-E",3207166,3,278,46,324
"HERAT","KUSHK (RUBAT-E",3207181,1,263,35,298
"HERAT","GULRAN",3208197,3,303,0,303
"HERAT","GULRAN",3208214,1,220,13,233
"HERAT","GULRAN",3208214,2,215,5,220
"HERAT","GULRAN",3208214,3,504,12,516
"HERAT","GULRAN",3208197,2,162,15,177
"HERAT","GULRAN",3208221,3,565,2,567
"HERAT","GULRAN",3208196,5,80,128,208
"HERAT","GULRAN",3208196,6,487,96,583
"HERAT","GULRAN",3208197,1,101,17,118
"HERAT","GULRAN",3208200,1,105,10,115
"HERAT","GULRAN",3208200,2,53,10,63
"HERAT","GULRAN",3208217,2,449,75,524
"HERAT","GULRAN",3208211,1,517,79,596
"HERAT","GULRAN",3208209,1,145,10,155
"HERAT","GULRAN",3208196,1,243,86,329
"HERAT","GULRAN",3208215,1,345,238,583
"HERAT","GULRAN",3208217,3,558,42,600
"HERAT","GULRAN",3208196,4,176,146,322
"HERAT","GULRAN",3208211,2,454,135,589
"HERAT","GULRAN",3208217,1,457,54,511
"HERAT","GULRAN",3208215,2,351,222,573
"HERAT","GULRAN",3208223,1,510,7,517
"HERAT","GULRAN",3208202,2,124,8,132
"HERAT","GULRAN",3208202,3,135,6,141
"HERAT","GULRAN",3208205,3,70,15,85
"HERAT","GULRAN",3208205,4,92,29,121
"HERAT","GULRAN",3208203,3,290,1,291
"HERAT","GULRAN",3208204,3,397,52,449
"HERAT","GULRAN",3208212,3,303,101,404
"HERAT","GULRAN",3208212,2,120,44,164
"HERAT","GULRAN",3208228,1,19,34,53
"HERAT","GULRAN",3208222,1,44,8,52
"HERAT","GULRAN",3208222,2,50,11,61
"HERAT","GULRAN",3208222,3,184,0,184
"HERAT","GULRAN",3208203,1,275,27,302
"HERAT","GULRAN",3208228,2,33,15,48
"HERAT","GULRAN",3208200,3,160,0,160
"HERAT","GULRAN",3208224,1,3,597,600
"HERAT","GULRAN",3208196,2,309,67,376
"HERAT","GULRAN",3208203,2,152,1,153
"HERAT","GULRAN",3208221,2,140,25,165
"HERAT","GULRAN",3208210,1,6,4,10
"HERAT","GULRAN",3208205,1,54,39,93
"HERAT","GULRAN",3208205,2,47,53,100
"HERAT","GULRAN",3208213,1,249,51,300
"HERAT","GULRAN",3208227,1,213,124,337
"HERAT","GULRAN",3208209,2,68,2,70
"HERAT","GULRAN",3208224,2,9,587,596
"HERAT","GULRAN",3208225,1,164,78,242
"HERAT","GULRAN",3208196,3,194,128,322
"HERAT","GULRAN",3208220,3,587,11,598
"HERAT","GULRAN",3208212,1,167,34,201
"HERAT","GULRAN",3208223,2,512,45,557
"HERAT","GULRAN",3208223,3,276,17,293
"HERAT","GULRAN",3208213,2,354,7,361
"HERAT","GULRAN",3208202,1,96,11,107
"HERAT","GULRAN",3208209,3,194,4,198
"HERAT","GULRAN",3208204,1,207,83,290
"HERAT","GULRAN",3208204,2,242,97,339
"HERAT","GULRAN",3208225,2,93,38,131
"HERAT","GULRAN",3208225,3,123,98,221
"HERAT","GULRAN",3208220,1,290,9,299
"HERAT","GULRAN",3208227,2,342,154,496
"HERAT","GULRAN",3208221,1,98,18,116
"HERAT","GULRAN",3208220,2,208,8,216
"HERAT","ADRASKAN",3209275,4,22,154,176
"HERAT","ADRASKAN",3209290,1,131,440,571
"HERAT","ADRASKAN",3209290,2,56,520,576
"HERAT","ADRASKAN",3209293,2,4,550,554
"HERAT","ADRASKAN",3209275,2,48,287,335
"HERAT","ADRASKAN",3209280,1,3,51,54
"HERAT","ADRASKAN",3209275,1,47,211,258
"HERAT","ADRASKAN",3209481,1,46,391,437
"HERAT","ADRASKAN",3209481,2,61,421,482
"HERAT","ADRASKAN",3209284,2,155,441,596
"HERAT","ADRASKAN",3209280,2,3,52,55
"HERAT","ADRASKAN",3209461,2,52,368,420
"HERAT","ADRASKAN",3209460,1,103,6,109
"HERAT","ADRASKAN",3209284,1,229,343,572
"HERAT","ADRASKAN",3209275,3,30,184,214
"HERAT","ADRASKAN",3209285,1,51,367,418
"HERAT","ADRASKAN",3209289,3,45,532,577
"HERAT","ADRASKAN",3209285,3,308,245,553
"HERAT","ADRASKAN",3209277,2,161,337,498
"HERAT","ADRASKAN",3209462,1,235,363,598
"HERAT","ADRASKAN",3209285,2,148,347,495
"HERAT","ADRASKAN",3209482,1,2,9,11
"HERAT","ADRASKAN",3209293,1,20,492,512
"HERAT","ADRASKAN",3209482,2,0,9,9
"HERAT","ADRASKAN",3209462,2,227,370,597
"HERAT","ADRASKAN",3209286,2,22,98,120
"HERAT","ADRASKAN",3209282,1,248,338,586
"HERAT","ADRASKAN",3209277,1,124,474,598
"HERAT","ADRASKAN",3209481,3,13,221,234
"HERAT","ADRASKAN",3209461,1,54,378,432
"HERAT","ADRASKAN",3209278,3,268,301,569
"HERAT","ADRASKAN",3209287,1,268,328,596
"HERAT","ADRASKAN",3209289,1,18,145,163
"HERAT","ADRASKAN",3209289,2,13,324,337
"HERAT","ADRASKAN",3209277,3,363,235,598
"HERAT","ADRASKAN",3209286,1,27,89,116
"HERAT","ADRASKAN",3209287,2,213,338,551
"HERAT","ADRASKAN",3209280,3,3,75,78
"HERAT","ADRASKAN",3209288,2,30,44,74
"HERAT","ADRASKAN",3209280,4,0,87,87
"HERAT","ADRASKAN",3209459,1,52,373,425
"HERAT","ADRASKAN",3209278,1,41,554,595
"HERAT","ADRASKAN",3209278,2,392,204,596
"HERAT","ADRASKAN",3209288,1,56,34,90
"HERAT","ADRASKAN",3209279,3,27,114,141
"HERAT","ADRASKAN",3209459,2,58,248,306
"HERAT","ADRASKAN",3209279,1,95,300,395
"HERAT","ADRASKAN",3209294,2,6,153,159
"HERAT","ADRASKAN",3209275,5,20,124,144
"HERAT","ADRASKAN",3209276,1,19,98,117
"HERAT","ADRASKAN",3209282,2,244,352,596
"HERAT","ADRASKAN",3209276,2,9,70,79
"HERAT","ADRASKAN",3209279,2,65,243,308
"HERAT","ADRASKAN",3209460,3,94,6,100
"HERAT","ADRASKAN",3209294,1,16,99,115
"HERAT","ADRASKAN",3209276,3,17,185,202
"HERAT","ADRASKAN",3209460,2,97,3,100
"HERAT","KUSHK-E-KUHN",3210419,2,30,22,52
"HERAT","KUSHK-E-KUHN",3210419,5,13,5,18
"HERAT","KUSHK-E-KUHN",3210412,2,285,17,302
"HERAT","KUSHK-E-KUHN",3210419,3,49,24,73
"HERAT","KUSHK-E-KUHN",3210421,1,562,32,594
"HERAT","KUSHK-E-KUHN",3210415,1,299,300,599
"HERAT","KUSHK-E-KUHN",3210414,1,258,8,266
"HERAT","KUSHK-E-KUHN",3210419,4,17,21,38
"HERAT","KUSHK-E-KUHN",3210406,1,358,47,405
"HERAT","KUSHK-E-KUHN",3210421,2,431,169,600
"HERAT","KUSHK-E-KUHN",3210409,1,283,21,304
"HERAT","KUSHK-E-KUHN",3210414,2,190,3,193
"HERAT","KUSHK-E-KUHN",3210406,3,368,53,421
"HERAT","KUSHK-E-KUHN",3210423,1,557,39,596
"HERAT","KUSHK-E-KUHN",3210419,1,68,47,115
"HERAT","KUSHK-E-KUHN",3210415,2,360,212,572
"HERAT","KUSHK-E-KUHN",3210405,6,13,21,34
"HERAT","KUSHK-E-KUHN",3210412,3,253,19,272
"HERAT","KUSHK-E-KUHN",3210410,1,486,0,486
"HERAT","KUSHK-E-KUHN",3210418,3,597,0,597
"HERAT","KUSHK-E-KUHN",3210422,1,270,0,270
"HERAT","KUSHK-E-KUHN",3210422,2,216,4,220
"HERAT","KUSHK-E-KUHN",3210417,1,369,109,478
"HERAT","KUSHK-E-KUHN",3210410,2,467,0,467
"HERAT","KUSHK-E-KUHN",3210423,3,555,44,599
"HERAT","KUSHK-E-KUHN",3210423,4,330,75,405
"HERAT","KUSHK-E-KUHN",3210423,5,71,0,71
"HERAT","KUSHK-E-KUHN",3210412,1,247,9,256
"HERAT","KUSHK-E-KUHN",3210405,5,7,12,19
"HERAT","KUSHK-E-KUHN",3210417,3,274,89,363
"HERAT","KUSHK-E-KUHN",3210409,2,295,3,298
"HERAT","KUSHK-E-KUHN",3210409,3,85,0,85
"HERAT","KUSHK-E-KUHN",3210423,2,413,117,530
"HERAT","KUSHK-E-KUHN",3210418,2,584,1,585
"HERAT","KUSHK-E-KUHN",3210405,2,4,26,30
"HERAT","KUSHK-E-KUHN",3210405,3,40,3,43
"HERAT","KUSHK-E-KUHN",3210405,4,21,30,51
"HERAT","KUSHK-E-KUHN",3210418,1,586,11,597
"HERAT","KUSHK-E-KUHN",3210407,1,384,70,454
"HERAT","KUSHK-E-KUHN",3210406,2,359,67,426
"HERAT","KUSHK-E-KUHN",3210407,2,357,104,461
"HERAT","KUSHK-E-KUHN",3210405,1,18,92,110
"HERAT","KUSHK-E-KUHN",3210417,2,365,133,498
"HERAT","GHORYAN",3211247,4,246,131,377
"HERAT","GHORYAN",3211247,3,232,133,365
"HERAT","GHORYAN",3211256,2,263,130,393
"HERAT","GHORYAN",3211250,1,341,174,515
"HERAT","GHORYAN",3211246,1,148,238,386
"HERAT","GHORYAN",3211259,1,28,94,122
"HERAT","GHORYAN",3211246,2,99,169,268
"HERAT","GHORYAN",3211246,3,270,310,580
"HERAT","GHORYAN",3211250,2,336,73,409
"HERAT","GHORYAN",3211257,2,235,66,301
"HERAT","GHORYAN",3211257,3,210,140,350
"HERAT","GHORYAN",3211257,4,403,181,584
"HERAT","GHORYAN",3211247,2,193,101,294
"HERAT","GHORYAN",3211249,1,279,251,530
"HERAT","GHORYAN",3211456,3,273,266,539
"HERAT","GHORYAN",3211254,4,59,49,108
"HERAT","GHORYAN",3211254,1,113,76,189
"HERAT","GHORYAN",3211256,1,326,171,497
"HERAT","GHORYAN",3211254,2,87,91,178
"HERAT","GHORYAN",3211452,1,98,76,174
"HERAT","GHORYAN",3211247,1,215,216,431
"HERAT","GHORYAN",3211256,4,404,189,593
"HERAT","GHORYAN",3211249,3,246,320,566
"HERAT","GHORYAN",3211254,3,71,47,118
"HERAT","GHORYAN",3211256,3,237,86,323
"HERAT","GHORYAN",3211249,2,246,252,498
"HERAT","GHORYAN",3211248,1,89,225,314
"HERAT","GHORYAN",3211248,2,72,425,497
"HERAT","GHORYAN",3211245,1,143,109,252
"HERAT","GHORYAN",3211251,3,510,47,557
"HERAT","GHORYAN",3211452,2,56,68,124
"HERAT","GHORYAN",3211256,5,386,187,573
"HERAT","GHORYAN",3211248,3,251,336,587
"HERAT","GHORYAN",3211259,3,14,78,92
"HERAT","GHORYAN",3211259,4,11,98,109
"HERAT","GHORYAN",3211255,1,143,197,340
"HERAT","GHORYAN",3211256,6,433,155,588
"HERAT","GHORYAN",3211257,1,162,74,236
"HERAT","GHORYAN",3211245,5,311,269,580
"HERAT","GHORYAN",3211252,2,308,20,328
"HERAT","GHORYAN",3211252,3,554,41,595
"HERAT","GHORYAN",3211455,1,97,370,467
"HERAT","GHORYAN",3211455,2,116,470,586
"HERAT","GHORYAN",3211451,1,21,35,56
"HERAT","GHORYAN",3211452,3,240,211,451
"HERAT","GHORYAN",3211251,1,230,16,246
"HERAT","GHORYAN",3211251,2,151,11,162
"HERAT","GHORYAN",3211456,1,293,281,574
"HERAT","GHORYAN",3211253,1,38,94,132
"HERAT","GHORYAN",3211453,1,139,371,510
"HERAT","GHORYAN",3211453,2,196,194,390
"HERAT","GHORYAN",3211259,2,10,100,110
"HERAT","GHORYAN",3211456,2,356,85,441
"HERAT","GHORYAN",3211451,2,19,28,47
"HERAT","GHORYAN",3211253,2,25,76,101
"HERAT","GHORYAN",3211253,3,82,180,262
"HERAT","GHORYAN",3211245,4,131,78,209
"HERAT","GHORYAN",3211454,2,155,440,595
"HERAT","GHORYAN",3211454,1,105,384,489
"HERAT","GHORYAN",3211451,3,33,96,129
"HERAT","GHORYAN",3211255,2,57,453,510
"HERAT","GHORYAN",3211255,3,160,183,343
"HERAT","GHORYAN",3211252,1,278,37,315
"HERAT","GHORYAN",3211245,2,94,80,174
"HERAT","GHORYAN",3211245,3,102,99,201
"HERAT","OBE",3212369,3,106,2,108
"HERAT","OBE",3212376,5,77,9,86
"HERAT","OBE",3212369,2,66,6,72
"HERAT","OBE",3212366,1,105,481,586
"HERAT","OBE",3212369,1,62,11,73
"HERAT","OBE",3212377,4,39,100,139
"HERAT","OBE",3212380,2,41,13,54
"HERAT","OBE",3212381,2,41,4,45
"HERAT","OBE",3212381,1,75,17,92
"HERAT","OBE",3212370,2,58,5,63
"HERAT","OBE",3212370,3,45,41,86
"HERAT","OBE",3212377,5,31,51,82
"HERAT","OBE",3212365,5,328,100,428
"HERAT","OBE",3212366,2,77,493,570
"HERAT","OBE",3212388,1,215,383,598
"HERAT","OBE",3212368,2,53,27,80
"HERAT","OBE",3212374,1,197,72,269
"HERAT","OBE",3212370,1,52,8,60
"HERAT","OBE",3212380,1,52,17,69
"HERAT","OBE",3212385,2,16,23,39
"HERAT","OBE",3212365,1,108,55,163
"HERAT","OBE",3212365,2,154,85,239
"HERAT","OBE",3212385,1,37,68,105
"HERAT","OBE",3212377,3,44,88,132
"HERAT","OBE",3212388,2,116,484,600
"HERAT","OBE",3212367,1,71,127,198
"HERAT","OBE",3212365,6,303,83,386
"HERAT","OBE",3212368,1,156,136,292
"HERAT","OBE",3212376,3,34,20,54
"HERAT","OBE",3212376,4,64,12,76
"HERAT","OBE",3212383,3,24,118,142
"HERAT","OBE",3212372,1,15,2,17
"HERAT","OBE",3212372,2,17,0,17
"HERAT","OBE",3212385,3,20,47,67
"HERAT","OBE",3212377,1,61,160,221
"HERAT","OBE",3212377,2,82,148,230
"HERAT","OBE",3212379,2,194,30,224
"HERAT","OBE",3212468,2,70,71,141
"HERAT","OBE",3212371,2,93,9,102
"HERAT","OBE",3212382,1,64,117,181
"HERAT","OBE",3212382,2,67,97,164
"HERAT","OBE",3212376,1,33,5,38
"HERAT","OBE",3212376,2,62,5,67
"HERAT","OBE",3212384,1,122,14,136
"HERAT","OBE",3212384,2,84,5,89
"HERAT","OBE",3212382,3,70,53,123
"HERAT","OBE",3212374,3,392,79,471
"HERAT","OBE",3212365,4,182,77,259
"HERAT","OBE",3212383,1,74,34,108
"HERAT","OBE",3212365,3,190,67,257
"HERAT","OBE",3212371,1,86,9,95
"HERAT","OBE",3212387,1,14,17,31
"HERAT","OBE",3212387,2,12,8,20
"HERAT","OBE",3212383,2,60,9,69
"HERAT","OBE",3212374,2,96,37,133
"HERAT","OBE",3212468,1,232,252,484
"HERAT","OBE",3212386,2,27,11,38
"HERAT","OBE",3212379,1,106,94,200
"HERAT","OBE",3212384,3,64,3,67
"HERAT","OBE",3212378,2,232,107,339
"HERAT","OBE",3212386,1,15,12,27
"HERAT","OBE",3212367,2,45,426,471
"HERAT","OBE",3212378,1,258,113,371
"HERAT","KOHSAN",3213233,3,40,331,371
"HERAT","KOHSAN",3213233,4,45,318,363
"HERAT","KOHSAN",3213233,2,36,556,592
"HERAT","KOHSAN",3213230,8,428,41,469
"HERAT","KOHSAN",3213236,5,388,197,585
"HERAT","KOHSAN",3213237,1,36,546,582
"HERAT","KOHSAN",3213237,2,24,204,228
"HERAT","KOHSAN",3213244,1,82,18,100
"HERAT","KOHSAN",3213237,3,20,204,224
"HERAT","KOHSAN",3213236,6,378,202,580
"HERAT","KOHSAN",3213236,7,303,181,484
"HERAT","KOHSAN",3213231,2,142,442,584
"HERAT","KOHSAN",3213233,1,26,543,569
"HERAT","KOHSAN",3213234,2,180,186,366
"HERAT","KOHSAN",3213234,1,181,168,349
"HERAT","KOHSAN",3213230,5,142,14,156
"HERAT","KOHSAN",3213242,1,20,255,275
"HERAT","KOHSAN",3213239,1,25,492,517
"HERAT","KOHSAN",3213239,2,6,350,356
"HERAT","KOHSAN",3213239,3,13,310,323
"HERAT","KOHSAN",3213232,1,116,34,150
"HERAT","KOHSAN",3213242,2,7,206,213
"HERAT","KOHSAN",3213243,1,193,60,253
"HERAT","KOHSAN",3213231,1,191,397,588
"HERAT","KOHSAN",3213230,2,271,29,300
"HERAT","KOHSAN",3213230,3,252,40,292
"HERAT","KOHSAN",3213230,6,450,34,484
"HERAT","KOHSAN",3213230,1,87,16,103
"HERAT","KOHSAN",3213240,2,132,40,172
"HERAT","KOHSAN",3213240,3,338,54,392
"HERAT","KOHSAN",3213235,1,37,5,42
"HERAT","KOHSAN",3213240,1,75,44,119
"HERAT","KOHSAN",3213235,3,202,17,219
"HERAT","KOHSAN",3213236,2,299,284,583
"HERAT","KOHSAN",3213231,3,122,454,576
"HERAT","KOHSAN",3213235,2,343,12,355
"HERAT","KOHSAN",3213236,1,264,272,536
"HERAT","KOHSAN",3213230,7,485,49,534
"HERAT","KOHSAN",3213236,3,208,187,395
"HERAT","KOHSAN",3213236,4,267,241,508
"HERAT","KOHSAN",3213230,4,181,39,220
"HERAT","KOHSAN",3213244,2,92,0,92
"HERAT","KOHSAN",3213238,2,14,579,593
"HERAT","KOHSAN",3213238,3,32,568,600
"HERAT","KOHSAN",3213231,4,233,350,583
"HERAT","KOHSAN",3213238,1,44,553,597
"HERAT","KOHSAN",3213447,3,236,150,386
"HERAT","KOHSAN",3213243,3,125,44,169
"HERAT","KOHSAN",3213234,3,294,283,577
"HERAT","KOHSAN",3213238,4,32,558,590
"HERAT","KOHSAN",3213243,2,135,34,169
"HERAT","KOHSAN",3213232,3,256,96,352
"HERAT","KOHSAN",3213447,1,67,30,97
"HERAT","KOHSAN",3213232,2,110,42,152
"HERAT","KOHSAN",3213447,2,69,94,163
"HERAT","SHINDAND",3214299,4,63,20,83
"HERAT","SHINDAND",3214330,1,40,530,570
"HERAT","SHINDAND",3214330,2,0,599,599
"HERAT","SHINDAND",3214299,5,72,428,500
"HERAT","SHINDAND",3214347,2,40,554,594
"HERAT","SHINDAND",3214324,2,7,133,140
"HERAT","SHINDAND",3214298,1,72,470,542
"HERAT","SHINDAND",3214347,1,25,575,600
"HERAT","SHINDAND",3214324,1,13,453,466
"HERAT","SHINDAND",3214301,1,66,480,546
"HERAT","SHINDAND",3214464,1,6,57,63
"HERAT","SHINDAND",3214298,2,69,447,516
"HERAT","SHINDAND",3214325,1,127,467,594
"HERAT","SHINDAND",3214301,5,36,520,556
"HERAT","SHINDAND",3214301,2,135,418,553
"HERAT","SHINDAND",3214301,3,20,560,580
"HERAT","SHINDAND",3214301,4,108,377,485
"HERAT","SHINDAND",3214464,2,4,28,32
"HERAT","SHINDAND",3214325,2,22,577,599
"HERAT","SHINDAND",3214350,2,487,12,499
"HERAT","SHINDAND",3214302,3,226,327,553
"HERAT","SHINDAND",3214299,3,83,17,100
"HERAT","SHINDAND",3214326,1,92,506,598
"HERAT","SHINDAND",3214326,2,62,480,542
"HERAT","SHINDAND",3214328,2,0,600,600
"HERAT","SHINDAND",3214351,1,568,14,582
"HERAT","SHINDAND",3214351,2,591,3,594
"HERAT","SHINDAND",3214302,1,87,6,93
"HERAT","SHINDAND",3214302,2,93,506,599
"HERAT","SHINDAND",3214300,3,92,27,119
"HERAT","SHINDAND",3214349,1,238,65,303
"HERAT","SHINDAND",3214345,1,55,128,183
"HERAT","SHINDAND",3214345,2,58,146,204
"HERAT","SHINDAND",3214345,3,82,78,160
"HERAT","SHINDAND",3214337,1,14,262,276
"HERAT","SHINDAND",3214329,2,5,119,124
"HERAT","SHINDAND",3214329,3,2,256,258
"HERAT","SHINDAND",3214323,1,14,326,340
"HERAT","SHINDAND",3214323,2,8,450,458
"HERAT","SHINDAND",3214323,3,0,354,354
"HERAT","SHINDAND",3214351,3,594,1,595
"HERAT","SHINDAND",3214350,1,147,28,175
"HERAT","SHINDAND",3214298,5,30,469,499
"HERAT","SHINDAND",3214298,6,121,452,573
"HERAT","SHINDAND",3214336,1,0,15,15
"HERAT","SHINDAND",3214346,1,538,55,593
"HERAT","SHINDAND",3214346,2,550,9,559
"HERAT","SHINDAND",3214346,3,573,7,580
"HERAT","SHINDAND",3214299,2,45,25,70
"HERAT","SHINDAND",3214327,1,18,578,596
"HERAT","SHINDAND",3214327,2,11,539,550
"HERAT","SHINDAND",3214304,3,88,20,108
"HERAT","SHINDAND",3214328,3,0,600,600
"HERAT","SHINDAND",3214304,1,29,17,46
"HERAT","SHINDAND",3214304,2,32,41,73
"HERAT","SHINDAND",3214303,3,56,0,56
"HERAT","SHINDAND",3214304,4,56,18,74
"HERAT","SHINDAND",3214303,1,75,5,80
"HERAT","SHINDAND",3214303,2,82,5,87
"HERAT","SHINDAND",3214328,1,0,596,596
"HERAT","SHINDAND",3214303,4,69,1,70
"HERAT","SHINDAND",3214466,1,22,491,513
"HERAT","SHINDAND",3214466,2,39,366,405
"HERAT","SHINDAND",3214467,1,6,48,54
"HERAT","SHINDAND",3214298,3,116,435,551
"HERAT","SHINDAND",3214298,4,99,335,434
"HERAT","SHINDAND",3214304,5,196,38,234
"HERAT","SHINDAND",3214349,2,564,11,575
"HERAT","SHINDAND",3214306,1,1,550,551
"HERAT","SHINDAND",3214306,2,81,217,298
"HERAT","SHINDAND",3214307,1,75,66,141
"HERAT","SHINDAND",3214307,2,82,368,450
"HERAT","SHINDAND",3214329,1,6,132,138
"HERAT","SHINDAND",3214308,2,4,468,472
"HERAT","SHINDAND",3214467,2,2,10,12
"HERAT","SHINDAND",3214322,3,1,595,596
"HERAT","SHINDAND",3214308,1,3,279,282
"HERAT","SHINDAND",3214299,1,50,18,68
"HERAT","SHINDAND",3214344,1,3,13,16
"HERAT","SHINDAND",3214335,2,0,3,3
"HERAT","SHINDAND",3214333,1,135,110,245
"HERAT","SHINDAND",3214305,2,4,65,69
"HERAT","SHINDAND",3214300,4,137,235,372
"HERAT","SHINDAND",3214300,5,109,224,333
"HERAT","SHINDAND",3214322,1,25,563,588
"HERAT","SHINDAND",3214335,1,8,33,41
"HERAT","SHINDAND",3214308,3,0,269,269
"HERAT","SHINDAND",3214300,2,121,446,567
"HERAT","SHINDAND",3214305,1,46,59,105
"HERAT","SHINDAND",3214300,1,78,436,514
"HERAT","FERSI",3215353,2,344,144,488
"HERAT","FERSI",3215354,4,301,7,308
"HERAT","FERSI",3215359,3,235,70,305
"HERAT","FERSI",3215356,1,259,32,291
"HERAT","FERSI",3215353,1,449,78,527
"HERAT","FERSI",3215354,3,250,96,346
"HERAT","FERSI",3215359,2,343,27,370
"HERAT","FERSI",3215354,2,233,45,278
"HERAT","FERSI",3215355,1,461,11,472
"HERAT","FERSI",3215355,2,407,29,436
"HERAT","FERSI",3215353,3,155,268,423
"HERAT","FERSI",3215355,3,429,100,529
"HERAT","FERSI",3215361,4,267,12,279
"HERAT","FERSI",3215362,1,171,6,177
"HERAT","FERSI",3215361,2,84,82,166
"HERAT","FERSI",3215354,1,207,61,268
"HERAT","FERSI",3215360,2,303,40,343
"HERAT","FERSI",3215361,1,138,9,147
"HERAT","FERSI",3215352,5,118,6,124
"HERAT","FERSI",3215362,2,137,5,142
"HERAT","FERSI",3215359,1,123,20,143
"HERAT","FERSI",3215364,2,221,379,600
"HERAT","FERSI",3215364,3,220,380,600
"HERAT","FERSI",3215356,2,329,7,336
"HERAT","FERSI",3215364,1,320,274,594
"HERAT","FERSI",3215358,2,159,50,209
"HERAT","FERSI",3215360,1,187,27,214
"HERAT","FERSI",3215358,3,192,30,222
"HERAT","FERSI",3215352,4,51,30,81
"HERAT","FERSI",3215356,3,587,12,599
"HERAT","FERSI",3215352,1,78,8,86
"HERAT","FERSI",3215352,2,113,4,117
"HERAT","FERSI",3215363,1,146,0,146
"HERAT","FERSI",3215358,1,162,41,203
"HERAT","FERSI",3215361,5,254,14,268
"HERAT","FERSI",3215361,3,116,4,120
"HERAT","FERSI",3215352,3,85,8,93
"HERAT","FERSI",3215357,3,149,110,259
"HERAT","FERSI",3215357,1,305,144,449
"HERAT","FERSI",3215357,2,170,85,255
"HERAT","FERSI",3215363,2,89,2,91
"HERAT","CHISHT-E-SHAR",3216391,2,31,515,546
"HERAT","CHISHT-E-SHAR",3216390,1,188,107,295
"HERAT","CHISHT-E-SHAR",3216398,1,51,8,59
"HERAT","CHISHT-E-SHAR",3216395,1,162,4,166
"HERAT","CHISHT-E-SHAR",3216395,2,65,7,72
"HERAT","CHISHT-E-SHAR",3216402,1,108,21,129
"HERAT","CHISHT-E-SHAR",3216394,3,27,8,35
"HERAT","CHISHT-E-SHAR",3216398,2,2,5,7
"HERAT","CHISHT-E-SHAR",3216396,2,84,1,85
"HERAT","CHISHT-E-SHAR",3216394,2,101,14,115
"HERAT","CHISHT-E-SHAR",3216470,1,300,37,337
"HERAT","CHISHT-E-SHAR",3216402,2,104,41,145
"HERAT","CHISHT-E-SHAR",3216390,2,216,115,331
"HERAT","CHISHT-E-SHAR",3216403,2,400,197,597
"HERAT","CHISHT-E-SHAR",3216389,3,100,214,314
"HERAT","CHISHT-E-SHAR",3216470,2,243,64,307
"HERAT","CHISHT-E-SHAR",3216403,1,454,140,594
"HERAT","CHISHT-E-SHAR",3216389,2,128,120,248
"HERAT","CHISHT-E-SHAR",3216392,2,67,32,99
"HERAT","CHISHT-E-SHAR",3216483,1,368,211,579
"HERAT","CHISHT-E-SHAR",3216389,1,176,126,302
"HERAT","CHISHT-E-SHAR",3216391,1,94,330,424
"HERAT","CHISHT-E-SHAR",3216401,1,98,195,293
"HERAT","CHISHT-E-SHAR",3216404,1,327,273,600
"HERAT","CHISHT-E-SHAR",3216483,2,375,140,515
"HERAT","CHISHT-E-SHAR",3216483,3,464,69,533
"HERAT","CHISHT-E-SHAR",3216403,3,400,154,554
"HERAT","CHISHT-E-SHAR",3216396,1,261,5,266
"HERAT","CHISHT-E-SHAR",3216399,1,487,103,590
"HERAT","CHISHT-E-SHAR",3216397,2,52,548,600
"HERAT","CHISHT-E-SHAR",3216394,1,86,5,91
"HERAT","CHISHT-E-SHAR",3216392,1,100,5,105
"HERAT","CHISHT-E-SHAR",3216393,2,68,311,379
"HERAT","CHISHT-E-SHAR",3216404,2,381,215,596
"HERAT","CHISHT-E-SHAR",3216397,1,123,322,445
"HERAT","CHISHT-E-SHAR",3216400,1,287,42,329
"HERAT","CHISHT-E-SHAR",3216400,2,483,16,499
"HERAT","CHISHT-E-SHAR",3216393,1,121,237,358
"HERAT","CHISHT-E-SHAR",3216389,4,214,223,437
"HERAT","CHISHT-E-SHAR",3216399,2,396,155,551
"HERAT","CHISHT-E-SHAR",3216399,3,275,219,494
"HERAT","CHISHT-E-SHAR",3216401,2,112,150,262
"FARAH","FARAH",3301009,4,16,81,97
"FARAH","FARAH",3301010,1,129,177,306
"FARAH","FARAH",3301010,2,122,110,232
"FARAH","FARAH",3301010,3,93,104,197
"FARAH","FARAH",3301010,4,121,109,230
"FARAH","FARAH",3301003,6,29,76,105
"FARAH","FARAH",3301016,1,28,56,84
"FARAH","FARAH",3301001,2,33,131,164
"FARAH","FARAH",3301003,5,35,76,111
"FARAH","FARAH",3301001,4,55,128,183
"FARAH","FARAH",3301001,1,92,291,383
"FARAH","FARAH",3301009,2,12,112,124
"FARAH","FARAH",3301001,3,38,111,149
"FARAH","FARAH",3301006,4,34,152,186
"FARAH","FARAH",3301006,5,62,132,194
"FARAH","FARAH",3301008,1,54,83,137
"FARAH","FARAH",3301009,3,6,46,52
"FARAH","FARAH",3301008,3,42,70,112
"FARAH","FARAH",3301008,4,88,113,201
"FARAH","FARAH",3301001,5,115,225,340
"FARAH","FARAH",3301008,2,46,68,114
"FARAH","FARAH",3301019,2,4,21,25
"FARAH","FARAH",3301019,3,0,7,7
"FARAH","FARAH",3301019,4,0,4,4
"FARAH","FARAH",3301003,3,83,201,284
"FARAH","FARAH",3301003,4,98,218,316
"FARAH","FARAH",3301018,3,70,44,114
"FARAH","FARAH",3301018,4,65,61,126
"FARAH","FARAH",3301015,1,28,71,99
"FARAH","FARAH",3301015,2,54,113,167
"FARAH","FARAH",3301015,3,9,49,58
"FARAH","FARAH",3301022,4,20,51,71
"FARAH","FARAH",3301015,4,5,64,69
"FARAH","FARAH",3301016,2,21,73,94
"FARAH","FARAH",3301016,3,43,82,125
"FARAH","FARAH",3301013,4,4,30,34
"FARAH","FARAH",3301016,4,21,43,64
"FARAH","FARAH",3301009,1,23,140,163
"FARAH","FARAH",3301018,2,77,35,112
"FARAH","FARAH",3301021,1,5,68,73
"FARAH","FARAH",3301021,2,3,88,91
"FARAH","FARAH",3301021,3,3,93,96
"FARAH","FARAH",3301021,4,5,64,69
"FARAH","FARAH",3301020,1,24,35,59
"FARAH","FARAH",3301020,2,27,57,84
"FARAH","FARAH",3301020,3,37,59,96
"FARAH","FARAH",3301020,4,73,98,171
"FARAH","FARAH",3301004,1,52,72,124
"FARAH","FARAH",3301004,2,35,45,80
"FARAH","FARAH",3301004,3,32,63,95
"FARAH","FARAH",3301004,4,53,48,101
"FARAH","FARAH",3301016,5,23,45,68
"FARAH","FARAH",3301006,2,19,108,127
"FARAH","FARAH",3301006,3,28,101,129
"FARAH","FARAH",3301014,1,32,113,145
"FARAH","FARAH",3301014,2,32,82,114
"FARAH","FARAH",3301012,1,20,75,95
"FARAH","FARAH",3301012,2,18,43,61
"FARAH","FARAH",3301012,3,14,61,75
"FARAH","FARAH",3301008,5,49,75,124
"FARAH","FARAH",3301019,1,11,22,33
"FARAH","FARAH",3301011,2,168,157,325
"FARAH","FARAH",3301011,3,139,98,237
"FARAH","FARAH",3301011,4,169,135,304
"FARAH","FARAH",3301018,1,118,61,179
"FARAH","FARAH",3301002,3,65,267,332
"FARAH","FARAH",3301002,4,125,131,256
"FARAH","FARAH",3301002,5,109,377,486
"FARAH","FARAH",3301022,1,17,42,59
"FARAH","FARAH",3301022,2,16,26,42
"FARAH","FARAH",3301022,3,6,24,30
"FARAH","FARAH",3301028,2,5,181,186
"FARAH","FARAH",3301005,1,16,181,197
"FARAH","FARAH",3301013,2,23,38,61
"FARAH","FARAH",3301013,3,14,40,54
"FARAH","FARAH",3301005,4,14,37,51
"FARAH","FARAH",3301005,5,15,38,53
"FARAH","FARAH",3301003,1,111,378,489
"FARAH","FARAH",3301003,2,90,170,260
"FARAH","FARAH",3301027,3,24,42,66
"FARAH","FARAH",3301024,1,28,131,159
"FARAH","FARAH",3301024,2,26,81,107
"FARAH","FARAH",3301024,3,15,46,61
"FARAH","FARAH",3301024,4,43,108,151
"FARAH","FARAH",3301024,5,73,318,391
"FARAH","FARAH",3301033,1,273,316,589
"FARAH","FARAH",3301033,2,236,343,579
"FARAH","FARAH",3301033,3,250,247,497
"FARAH","FARAH",3301246,4,35,82,117
"FARAH","FARAH",3301033,4,259,233,492
"FARAH","FARAH",3301023,1,150,45,195
"FARAH","FARAH",3301004,5,49,47,96
"FARAH","FARAH",3301006,1,26,144,170
"FARAH","FARAH",3301023,4,185,53,238
"FARAH","FARAH",3301029,4,74,293,367
"FARAH","FARAH",3301034,1,102,104,206
"FARAH","FARAH",3301014,3,37,104,141
"FARAH","FARAH",3301014,4,62,122,184
"FARAH","FARAH",3301026,1,6,51,57
"FARAH","FARAH",3301012,4,17,68,85
"FARAH","FARAH",3301011,1,204,166,370
"FARAH","FARAH",3301007,1,66,70,136
"FARAH","FARAH",3301007,2,45,67,112
"FARAH","FARAH",3301007,3,60,71,131
"FARAH","FARAH",3301007,4,60,56,116
"FARAH","FARAH",3301002,1,63,249,312
"FARAH","FARAH",3301002,2,63,309,372
"FARAH","FARAH",3301247,3,58,144,202
"FARAH","FARAH",3301032,2,47,175,222
"FARAH","FARAH",3301032,3,45,158,203
"FARAH","FARAH",3301032,4,105,153,258
"FARAH","FARAH",3301032,5,90,192,282
"FARAH","FARAH",3301028,3,4,36,40
"FARAH","FARAH",3301013,1,21,51,72
"FARAH","FARAH",3301005,2,21,63,84
"FARAH","FARAH",3301005,3,9,45,54
"FARAH","FARAH",3301031,2,3,21,24
"FARAH","FARAH",3301031,3,3,15,18
"FARAH","FARAH",3301027,2,15,49,64
"FARAH","FARAH",3301027,1,21,102,123
"FARAH","FARAH",3301027,4,18,56,74
"FARAH","FARAH",3301030,1,159,267,426
"FARAH","FARAH",3301030,2,179,308,487
"FARAH","FARAH",3301030,3,128,227,355
"FARAH","FARAH",3301030,4,173,299,472
"FARAH","FARAH",3301246,1,11,46,57
"FARAH","FARAH",3301246,2,14,24,38
"FARAH","FARAH",3301246,3,9,28,37
"FARAH","FARAH",3301026,3,2,4,6
"FARAH","FARAH",3301029,1,97,481,578
"FARAH","FARAH",3301029,2,83,486,569
"FARAH","FARAH",3301023,2,126,38,164
"FARAH","FARAH",3301023,3,94,38,132
"FARAH","FARAH",3301029,3,58,296,354
"FARAH","FARAH",3301032,1,101,323,424
"FARAH","FARAH",3301247,2,40,141,181
"FARAH","FARAH",3301034,2,71,84,155
"FARAH","FARAH",3301034,3,66,54,120
"FARAH","FARAH",3301034,4,44,74,118
"FARAH","FARAH",3301026,2,4,42,46
"FARAH","FARAH",3301035,2,105,155,260
"FARAH","FARAH",3301028,4,3,10,13
"FARAH","FARAH",3301026,4,0,18,18
"FARAH","FARAH",3301025,1,36,132,168
"FARAH","FARAH",3301025,2,33,99,132
"FARAH","FARAH",3301025,3,17,64,81
"FARAH","FARAH",3301025,4,20,72,92
"FARAH","FARAH",3301247,1,61,169,230
"FARAH","FARAH",3301028,1,5,57,62
"FARAH","FARAH",3301036,1,96,58,154
"FARAH","FARAH",3301034,5,202,109,311
"FARAH","FARAH",3301031,1,4,28,32
"FARAH","FARAH",3301035,4,251,162,413
"FARAH","FARAH",3301035,1,105,85,190
"FARAH","FARAH",3301031,4,1,4,5
"FARAH","FARAH",3301036,3,10,70,80
"FARAH","FARAH",3301035,3,53,53,106
"FARAH","FARAH",3301036,2,12,42,54
"FARAH","PUSHTRUD",3302043,1,19,66,85
"FARAH","PUSHTRUD",3302043,2,4,7,11
"FARAH","PUSHTRUD",3302041,3,8,57,65
"FARAH","PUSHTRUD",3302041,4,6,69,75
"FARAH","PUSHTRUD",3302049,1,9,39,48
"FARAH","PUSHTRUD",3302041,2,22,163,185
"FARAH","PUSHTRUD",3302049,3,2,24,26
"FARAH","PUSHTRUD",3302234,2,1,2,3
"FARAH","PUSHTRUD",3302231,1,7,42,49
"FARAH","PUSHTRUD",3302049,2,10,36,46
"FARAH","PUSHTRUD",3302234,1,16,46,62
"FARAH","PUSHTRUD",3302050,1,2,25,27
"FARAH","PUSHTRUD",3302040,1,12,66,78
"FARAH","PUSHTRUD",3302041,1,16,126,142
"FARAH","PUSHTRUD",3302050,3,1,12,13
"FARAH","PUSHTRUD",3302045,1,25,187,212
"FARAH","PUSHTRUD",3302039,1,63,115,178
"FARAH","PUSHTRUD",3302050,2,11,46,57
"FARAH","PUSHTRUD",3302231,2,0,66,66
"FARAH","PUSHTRUD",3302042,1,13,66,79
"FARAH","PUSHTRUD",3302039,2,57,210,267
"FARAH","PUSHTRUD",3302039,3,15,64,79
"FARAH","PUSHTRUD",3302045,2,12,99,111
"FARAH","PUSHTRUD",3302040,2,5,38,43
"FARAH","KHAK-E-SAFED",3303051,2,0,549,549
"FARAH","KHAK-E-SAFED",3303052,3,0,4,4
"FARAH","KHAK-E-SAFED",3303051,1,4,570,574
"FARAH","KHAK-E-SAFED",3303052,1,8,43,51
"FARAH","KHAK-E-SAFED",3303052,2,5,35,40
"FARAH","KHAK-E-SAFED",3303055,1,88,507,595
"FARAH","KHAK-E-SAFED",3303055,2,159,436,595
"FARAH","KHAK-E-SAFED",3303051,3,0,583,583
"FARAH","QALA-E-KAH",3304084,1,5,8,13
"FARAH","QALA-E-KAH",3304082,2,24,7,31
"FARAH","QALA-E-KAH",3304074,1,86,5,91
"FARAH","QALA-E-KAH",3304249,3,23,17,40
"FARAH","QALA-E-KAH",3304083,1,44,19,63
"FARAH","QALA-E-KAH",3304084,2,4,1,5
"FARAH","QALA-E-KAH",3304072,1,49,10,59
"FARAH","QALA-E-KAH",3304074,2,8,4,12
"FARAH","QALA-E-KAH",3304082,1,24,11,35
"FARAH","QALA-E-KAH",3304080,2,30,100,130
"FARAH","QALA-E-KAH",3304076,2,31,22,53
"FARAH","QALA-E-KAH",3304072,2,23,2,25
"FARAH","QALA-E-KAH",3304072,3,41,18,59
"FARAH","QALA-E-KAH",3304076,1,77,23,100
"FARAH","QALA-E-KAH",3304249,2,4,9,13
"FARAH","QALA-E-KAH",3304076,3,85,30,115
"FARAH","QALA-E-KAH",3304073,1,75,12,87
"FARAH","QALA-E-KAH",3304080,1,92,22,114
"FARAH","QALA-E-KAH",3304248,3,8,0,8
"FARAH","QALA-E-KAH",3304074,3,125,2,127
"FARAH","QALA-E-KAH",3304248,1,9,12,21
"FARAH","QALA-E-KAH",3304248,2,5,9,14
"FARAH","QALA-E-KAH",3304081,1,28,7,35
"FARAH","QALA-E-KAH",3304249,1,43,13,56
"FARAH","QALA-E-KAH",3304077,2,1,3,4
"FARAH","QALA-E-KAH",3304075,1,275,173,448
"FARAH","QALA-E-KAH",3304081,2,0,2,2
"FARAH","QALA-E-KAH",3304079,2,5,1,6
"FARAH","QALA-E-KAH",3304077,1,6,40,46
"FARAH","QALA-E-KAH",3304079,1,17,17,34
"FARAH","QALA-E-KAH",3304083,2,98,7,105
"FARAH","QALA-E-KAH",3304073,2,6,5,11
"FARAH","QALA-E-KAH",3304075,2,273,120,393
"FARAH","SHIB KOH",3305085,2,100,70,170
"FARAH","SHIB KOH",3305085,3,170,97,267
"FARAH","SHIB KOH",3305092,2,2,9,11
"FARAH","SHIB KOH",3305086,1,57,35,92
"FARAH","SHIB KOH",3305090,1,160,393,553
"FARAH","SHIB KOH",3305086,2,16,11,27
"FARAH","SHIB KOH",3305088,1,234,54,288
"FARAH","SHIB KOH",3305250,1,36,23,59
"FARAH","SHIB KOH",3305085,1,122,73,195
"FARAH","SHIB KOH",3305092,1,41,35,76
"FARAH","SHIB KOH",3305094,1,70,2,72
"FARAH","SHIB KOH",3305088,2,122,27,149
"FARAH","SHIB KOH",3305250,2,26,41,67
"FARAH","SHIB KOH",3305250,3,78,34,112
"FARAH","SHIB KOH",3305251,1,69,11,80
"FARAH","SHIB KOH",3305251,2,65,33,98
"FARAH","SHIB KOH",3305094,2,50,36,86
"FARAH","SHIB KOH",3305087,2,132,5,137
"FARAH","SHIB KOH",3305093,2,8,7,15
"FARAH","SHIB KOH",3305093,1,26,22,48
"FARAH","SHIB KOH",3305090,2,49,190,239
"FARAH","SHIB KOH",3305094,3,33,4,37
"FARAH","SHIB KOH",3305091,1,9,37,46
"FARAH","SHIB KOH",3305089,2,10,100,110
"FARAH","SHIB KOH",3305091,3,1,31,32
"FARAH","SHIB KOH",3305251,3,98,12,110
"FARAH","SHIB KOH",3305087,1,129,9,138
"FARAH","SHIB KOH",3305091,2,0,45,45
"FARAH","SHIB KOH",3305240,1,35,104,139
"FARAH","SHIB KOH",3305088,3,65,14,79
"FARAH","SHIB KOH",3305089,1,34,230,264
"FARAH","SHIB KOH",3305240,2,31,127,158
"FARAH","BALA BULUK",3306134,2,2,20,22
"FARAH","BALA BULUK",3306134,3,4,1,5
"FARAH","BALA BULUK",3306129,1,88,275,363
"FARAH","BALA BULUK",3306130,2,1,18,19
"FARAH","BALA BULUK",3306127,1,5,38,43
"FARAH","BALA BULUK",3306127,3,0,105,105
"FARAH","BALA BULUK",3306130,1,13,96,109
"FARAH","BALA BULUK",3306149,1,10,13,23
"FARAH","BALA BULUK",3306129,2,9,141,150
"FARAH","BALA BULUK",3306134,1,10,10,20
"FARAH","BALA BULUK",3306127,2,0,9,9
"FARAH","BALA BULUK",3306132,1,24,35,59
"FARAH","BALA BULUK",3306244,1,9,15,24
"FARAH","BALA BULUK",3306128,2,1,42,43
"FARAH","BALA BULUK",3306135,2,247,194,441
"FARAH","BALA BULUK",3306136,1,24,34,58
"FARAH","BALA BULUK",3306128,1,5,105,110
"FARAH","BALA BULUK",3306131,3,0,3,3
"FARAH","BALA BULUK",3306133,1,15,23,38
"FARAH","BALA BULUK",3306162,2,404,192,596
"FARAH","BALA BULUK",3306131,2,15,50,65
"FARAH","BALA BULUK",3306132,2,0,12,12
"FARAH","BALA BULUK",3306135,1,240,324,564
"FARAH","BALA BULUK",3306162,3,3,588,591
"FARAH","BALA BULUK",3306136,2,1,3,4
"FARAH","BALA BULUK",3306162,1,250,335,585
"FARAH","BALA BULUK",3306131,1,2,47,49
"FARAH","ANAR DARA",3307062,1,102,44,146
"FARAH","ANAR DARA",3307064,3,445,114,559
"FARAH","ANAR DARA",3307063,1,43,44,87
"FARAH","ANAR DARA",3307066,1,28,7,35
"FARAH","ANAR DARA",3307063,2,40,55,95
"FARAH","ANAR DARA",3307071,2,27,4,31
"FARAH","ANAR DARA",3307067,1,46,4,50
"FARAH","ANAR DARA",3307062,3,260,86,346
"FARAH","ANAR DARA",3307062,2,76,28,104
"FARAH","ANAR DARA",3307068,3,43,44,87
"FARAH","ANAR DARA",3307064,2,182,53,235
"FARAH","ANAR DARA",3307067,2,37,5,42
"FARAH","ANAR DARA",3307066,2,23,8,31
"FARAH","ANAR DARA",3307066,3,11,21,32
"FARAH","ANAR DARA",3307064,1,189,83,272
"FARAH","ANAR DARA",3307071,1,43,24,67
"FARAH","ANAR DARA",3307068,1,32,24,56
"FARAH","ANAR DARA",3307065,1,36,14,50
"FARAH","ANAR DARA",3307065,2,26,8,34
"FARAH","ANAR DARA",3307068,2,22,16,38
"FARAH","BAKWA",3308108,5,27,538,565
"FARAH","BAKWA",3308108,2,9,200,209
"FARAH","BAKWA",3308108,3,8,554,562
"FARAH","BAKWA",3308108,1,23,540,563
"FARAH","BAKWA",3308108,4,8,567,575
"FARAH","LASH-E-JUWAYN",3309102,1,22,8,30
"FARAH","LASH-E-JUWAYN",3309098,1,145,12,157
"FARAH","LASH-E-JUWAYN",3309102,2,23,16,39
"FARAH","LASH-E-JUWAYN",3309106,2,96,45,141
"FARAH","LASH-E-JUWAYN",3309104,2,17,67,84
"FARAH","LASH-E-JUWAYN",3309096,1,42,48,90
"FARAH","LASH-E-JUWAYN",3309104,1,26,51,77
"FARAH","LASH-E-JUWAYN",3309095,3,263,133,396
"FARAH","LASH-E-JUWAYN",3309100,3,76,94,170
"FARAH","LASH-E-JUWAYN",3309095,1,127,89,216
"FARAH","LASH-E-JUWAYN",3309095,2,159,119,278
"FARAH","LASH-E-JUWAYN",3309100,1,43,23,66
"FARAH","LASH-E-JUWAYN",3309100,2,52,32,84
"FARAH","LASH-E-JUWAYN",3309098,2,137,18,155
"FARAH","LASH-E-JUWAYN",3309097,4,15,48,63
"FARAH","LASH-E-JUWAYN",3309252,2,15,32,47
"FARAH","LASH-E-JUWAYN",3309106,1,99,53,152
"FARAH","LASH-E-JUWAYN",3309252,1,24,18,42
"FARAH","LASH-E-JUWAYN",3309107,2,12,34,46
"FARAH","LASH-E-JUWAYN",3309107,3,7,44,51
"FARAH","LASH-E-JUWAYN",3309252,3,33,32,65
"FARAH","LASH-E-JUWAYN",3309105,2,64,6,70
"FARAH","LASH-E-JUWAYN",3309099,2,17,38,55
"FARAH","LASH-E-JUWAYN",3309101,2,16,8,24
"FARAH","LASH-E-JUWAYN",3309097,3,22,48,70
"FARAH","LASH-E-JUWAYN",3309101,1,14,11,25
"FARAH","LASH-E-JUWAYN",3309107,1,8,40,48
"FARAH","LASH-E-JUWAYN",3309103,1,89,65,154
"FARAH","LASH-E-JUWAYN",3309105,1,50,17,67
"FARAH","LASH-E-JUWAYN",3309097,2,17,64,81
"FARAH","LASH-E-JUWAYN",3309096,2,21,30,51
"FARAH","LASH-E-JUWAYN",3309103,2,98,34,132
"FARAH","LASH-E-JUWAYN",3309097,1,17,67,84
"FARAH","LASH-E-JUWAYN",3309099,1,21,42,63
"FARAH","GULISTAN",3310179,1,3,9,12
"FARAH","GULISTAN",3310168,2,26,245,271
"FARAH","GULISTAN",3310179,2,4,16,20
"FARAH","GULISTAN",3310168,3,243,30,273
"FARAH","GULISTAN",3310179,3,1,3,4
"FARAH","GULISTAN",3310177,1,10,12,22
"FARAH","GULISTAN",3310168,1,115,76,191
"FARAH","GULISTAN",3310172,2,69,138,207
"FARAH","GULISTAN",3310172,3,93,163,256
"FARAH","GULISTAN",3310172,1,97,120,217
"FARAH","PUR CHAMAN",3311187,3,232,11,243
"FARAH","PUR CHAMAN",3311191,1,151,48,199
"FARAH","PUR CHAMAN",3311194,1,365,15,380
"FARAH","PUR CHAMAN",3311207,1,277,154,431
"FARAH","PUR CHAMAN",3311189,1,326,39,365
"FARAH","PUR CHAMAN",3311191,2,151,75,226
"FARAH","PUR CHAMAN",3311195,2,231,16,247
"FARAH","PUR CHAMAN",3311187,2,130,1,131
"FARAH","PUR CHAMAN",3311208,2,411,4,415
"FARAH","PUR CHAMAN",3311189,2,362,36,398
"FARAH","PUR CHAMAN",3311189,3,235,1,236
"FARAH","PUR CHAMAN",3311208,1,382,1,383
"FARAH","PUR CHAMAN",3311205,1,416,12,428
"FARAH","PUR CHAMAN",3311193,1,350,130,480
"FARAH","PUR CHAMAN",3311205,2,271,10,281
"FARAH","PUR CHAMAN",3311217,1,463,26,489
"FARAH","PUR CHAMAN",3311217,2,334,19,353
"FARAH","PUR CHAMAN",3311209,2,316,11,327
"FARAH","PUR CHAMAN",3311194,2,316,4,320
"FARAH","PUR CHAMAN",3311245,1,309,20,329
"FARAH","PUR CHAMAN",3311245,2,282,35,317
"FARAH","PUR CHAMAN",3311245,3,247,18,265
"FARAH","PUR CHAMAN",3311208,3,295,1,296
"FARAH","PUR CHAMAN",3311210,1,360,30,390
"FARAH","PUR CHAMAN",3311192,1,330,7,337
"FARAH","PUR CHAMAN",3311193,2,202,88,290
"FARAH","PUR CHAMAN",3311197,1,260,5,265
"FARAH","PUR CHAMAN",3311197,2,198,1,199
"FARAH","PUR CHAMAN",3311195,1,205,10,215
"FARAH","PUR CHAMAN",3311209,1,343,26,369
"FARAH","PUR CHAMAN",3311187,1,378,2,380
"FARAH","PUR CHAMAN",3311203,1,374,27,401
"FARAH","PUR CHAMAN",3311203,2,199,6,205
"FARAH","PUR CHAMAN",3311201,1,487,19,506
"FARAH","PUR CHAMAN",3311191,3,85,51,136
"FARAH","PUR CHAMAN",3311213,2,387,17,404
"FARAH","PUR CHAMAN",3311199,1,286,17,303
"FARAH","PUR CHAMAN",3311210,2,154,20,174
"FARAH","PUR CHAMAN",3311207,2,171,166,337
"FARAH","PUR CHAMAN",3311192,2,367,10,377
"FARAH","PUR CHAMAN",3311188,1,183,12,195
"FARAH","PUR CHAMAN",3311188,2,111,1,112
"FARAH","PUR CHAMAN",3311211,2,471,23,494
"FARAH","PUR CHAMAN",3311198,1,343,10,353
"FARAH","PUR CHAMAN",3311198,2,212,11,223
"FARAH","PUR CHAMAN",3311209,3,418,8,426
"FARAH","PUR CHAMAN",3311186,1,171,5,176
"FARAH","PUR CHAMAN",3311186,2,335,10,345
"FARAH","PUR CHAMAN",3311206,1,222,126,348
"FARAH","PUR CHAMAN",3311213,1,507,10,517
"FARAH","PUR CHAMAN",3311219,1,428,151,579
"FARAH","PUR CHAMAN",3311199,2,54,3,57
"FARAH","PUR CHAMAN",3311212,1,96,25,121
"FARAH","PUR CHAMAN",3311212,2,99,21,120
"FARAH","PUR CHAMAN",3311212,3,83,21,104
"FARAH","PUR CHAMAN",3311196,2,418,12,430
"FARAH","PUR CHAMAN",3311215,2,151,14,165
"FARAH","PUR CHAMAN",3311190,1,182,126,308
"FARAH","PUR CHAMAN",3311190,2,131,104,235
"FARAH","PUR CHAMAN",3311196,1,397,4,401
"FARAH","PUR CHAMAN",3311211,1,495,25,520
"FARAH","PUR CHAMAN",3311201,2,444,33,477
"FARAH","PUR CHAMAN",3311202,2,396,16,412
"FARAH","PUR CHAMAN",3311218,1,414,1,415
"FARAH","PUR CHAMAN",3311218,2,380,15,395
"FARAH","PUR CHAMAN",3311202,1,503,9,512
"FARAH","PUR CHAMAN",3311219,2,428,132,560
"FARAH","PUR CHAMAN",3311206,2,186,116,302
"FARAH","PUR CHAMAN",3311214,1,348,157,505
"FARAH","PUR CHAMAN",3311215,1,65,6,71
"FARAH","PUR CHAMAN",3311204,2,226,14,240
"FARAH","PUR CHAMAN",3311214,2,212,143,355
"FARAH","PUR CHAMAN",3311204,1,214,11,225
"NIMROZ","ZARANJ",3401005,2,208,254,462
"NIMROZ","ZARANJ",3401002,5,208,321,529
"NIMROZ","ZARANJ",3401004,1,134,177,311
"NIMROZ","ZARANJ",3401005,1,192,247,439
"NIMROZ","ZARANJ",3401002,4,183,271,454
"NIMROZ","ZARANJ",3401001,1,186,353,539
"NIMROZ","ZARANJ",3401002,6,146,215,361
"NIMROZ","ZARANJ",3401003,7,85,107,192
"NIMROZ","ZARANJ",3401002,8,160,338,498
"NIMROZ","ZARANJ",3401003,5,324,244,568
"NIMROZ","ZARANJ",3401003,6,262,222,484
"NIMROZ","ZARANJ",3401004,2,152,269,421
"NIMROZ","ZARANJ",3401002,7,176,209,385
"NIMROZ","ZARANJ",3401003,9,12,9,21
"NIMROZ","ZARANJ",3401006,4,159,156,315
"NIMROZ","ZARANJ",3401006,2,142,292,434
"NIMROZ","ZARANJ",3401006,3,152,324,476
"NIMROZ","ZARANJ",3401003,8,48,71,119
"NIMROZ","ZARANJ",3401006,1,190,390,580
"NIMROZ","ZARANJ",3401008,3,143,277,420
"NIMROZ","ZARANJ",3401006,5,154,164,318
"NIMROZ","ZARANJ",3401005,3,180,235,415
"NIMROZ","ZARANJ",3401008,2,128,296,424
"NIMROZ","ZARANJ",3401005,4,113,215,328
"NIMROZ","ZARANJ",3401002,1,203,330,533
"NIMROZ","ZARANJ",3401002,2,165,285,450
"NIMROZ","ZARANJ",3401002,3,193,370,563
"NIMROZ","ZARANJ",3401007,1,5,31,36
"NIMROZ","ZARANJ",3401007,2,12,25,37
"NIMROZ","ZARANJ",3401007,3,7,29,36
"NIMROZ","ZARANJ",3401008,1,169,413,582
"NIMROZ","ZARANJ",3401059,3,12,30,42
"NIMROZ","ZARANJ",3401001,4,169,284,453
"NIMROZ","ZARANJ",3401008,4,163,227,390
"NIMROZ","ZARANJ",3401001,2,101,228,329
"NIMROZ","ZARANJ",3401001,3,118,203,321
"NIMROZ","ZARANJ",3401003,3,207,356,563
"NIMROZ","ZARANJ",3401001,5,236,257,493
"NIMROZ","ZARANJ",3401005,5,187,234,421
"NIMROZ","ZARANJ",3401005,6,169,262,431
"NIMROZ","ZARANJ",3401004,3,200,297,497
"NIMROZ","ZARANJ",3401003,4,242,339,581
"NIMROZ","ZARANJ",3401059,1,17,24,41
"NIMROZ","ZARANJ",3401059,2,26,65,91
"NIMROZ","ZARANJ",3401004,7,155,268,423
"NIMROZ","ZARANJ",3401004,4,193,390,583
"NIMROZ","ZARANJ",3401004,5,48,66,114
"NIMROZ","ZARANJ",3401004,6,141,197,338
"NIMROZ","ZARANJ",3401008,7,7,16,23
"NIMROZ","ZARANJ",3401004,8,23,37,60
"NIMROZ","ZARANJ",3401003,2,230,342,572
"NIMROZ","ZARANJ",3401058,4,46,48,94
"NIMROZ","ZARANJ",3401058,3,188,191,379
"NIMROZ","ZARANJ",3401001,6,221,294,515
"NIMROZ","ZARANJ",3401008,5,178,227,405
"NIMROZ","ZARANJ",3401008,6,78,174,252
"NIMROZ","ZARANJ",3401003,1,256,313,569
"NIMROZ","ZARANJ",3401058,2,221,240,461
"NIMROZ","ZARANJ",3401058,1,258,287,545
"NIMROZ","KANG",3402011,2,5,23,28
"NIMROZ","KANG",3402011,1,13,21,34
"NIMROZ","KANG",3402015,1,5,59,64
"NIMROZ","KANG",3402012,1,15,88,103
"NIMROZ","KANG",3402015,2,3,44,47
"NIMROZ","KANG",3402017,2,25,58,83
"NIMROZ","KANG",3402016,2,22,333,355
"NIMROZ","KANG",3402012,2,4,71,75
"NIMROZ","KANG",3402011,3,11,48,59
"NIMROZ","KANG",3402060,1,7,52,59
"NIMROZ","KANG",3402060,3,27,117,144
"NIMROZ","KANG",3402016,3,9,277,286
"NIMROZ","KANG",3402016,4,10,265,275
"NIMROZ","KANG",3402060,2,8,75,83
"NIMROZ","KANG",3402017,1,29,51,80
"NIMROZ","KANG",3402019,2,20,6,26
"NIMROZ","KANG",3402014,2,6,15,21
"NIMROZ","KANG",3402013,2,77,215,292
"NIMROZ","KANG",3402018,2,22,34,56
"NIMROZ","KANG",3402014,1,11,21,32
"NIMROZ","KANG",3402018,1,12,48,60
"NIMROZ","KANG",3402014,3,14,30,44
"NIMROZ","KANG",3402016,1,32,126,158
"NIMROZ","KANG",3402013,1,31,259,290
"NIMROZ","KANG",3402019,1,12,32,44
"NIMROZ","ASL-E-CHAKHAN",3403033,2,22,13,35
"NIMROZ","ASL-E-CHAKHAN",3403032,2,15,43,58
"NIMROZ","ASL-E-CHAKHAN",3403032,3,20,74,94
"NIMROZ","ASL-E-CHAKHAN",3403029,2,41,78,119
"NIMROZ","ASL-E-CHAKHAN",3403029,1,66,86,152
"NIMROZ","ASL-E-CHAKHAN",3403033,1,21,22,43
"NIMROZ","ASL-E-CHAKHAN",3403037,1,37,59,96
"NIMROZ","ASL-E-CHAKHAN",3403033,3,35,35,70
"NIMROZ","ASL-E-CHAKHAN",3403036,1,6,23,29
"NIMROZ","ASL-E-CHAKHAN",3403036,3,13,60,73
"NIMROZ","ASL-E-CHAKHAN",3403030,3,3,25,28
"NIMROZ","ASL-E-CHAKHAN",3403037,2,71,67,138
"NIMROZ","ASL-E-CHAKHAN",3403061,1,6,81,87
"NIMROZ","ASL-E-CHAKHAN",3403032,1,21,36,57
"NIMROZ","ASL-E-CHAKHAN",3403036,2,10,40,50
"NIMROZ","ASL-E-CHAKHAN",3403038,2,84,201,285
"NIMROZ","ASL-E-CHAKHAN",3403031,1,20,13,33
"NIMROZ","ASL-E-CHAKHAN",3403030,1,4,12,16
"NIMROZ","ASL-E-CHAKHAN",3403029,3,56,61,117
"NIMROZ","ASL-E-CHAKHAN",3403034,3,36,11,47
"NIMROZ","ASL-E-CHAKHAN",3403038,1,76,219,295
"NIMROZ","ASL-E-CHAKHAN",3403035,1,12,107,119
"NIMROZ","ASL-E-CHAKHAN",3403030,2,4,3,7
"NIMROZ","ASL-E-CHAKHAN",3403062,2,5,5,10
"NIMROZ","ASL-E-CHAKHAN",3403062,3,4,2,6
"NIMROZ","ASL-E-CHAKHAN",3403061,2,7,43,50
"NIMROZ","ASL-E-CHAKHAN",3403031,3,56,33,89
"NIMROZ","ASL-E-CHAKHAN",3403034,2,9,15,24
"NIMROZ","ASL-E-CHAKHAN",3403035,2,38,155,193
"NIMROZ","ASL-E-CHAKHAN",3403061,3,7,56,63
"NIMROZ","ASL-E-CHAKHAN",3403034,1,24,7,31
"NIMROZ","ASL-E-CHAKHAN",3403031,2,39,16,55
"NIMROZ","ASL-E-CHAKHAN",3403029,4,68,72,140
"NIMROZ","CHAR BURJAK",3404021,2,21,33,54
"NIMROZ","CHAR BURJAK",3404021,3,8,90,98
"NIMROZ","CHAR BURJAK",3404023,2,4,7,11
"NIMROZ","CHAR BURJAK",3404025,1,16,10,26
"NIMROZ","CHAR BURJAK",3404025,2,6,17,23
"NIMROZ","CHAR BURJAK",3404023,1,11,11,22
"NIMROZ","CHAR BURJAK",3404021,1,18,67,85
"NIMROZ","CHAR BURJAK",3404026,2,37,538,575
"NIMROZ","CHAR BURJAK",3404028,3,0,4,4
"NIMROZ","CHAR BURJAK",3404025,3,38,19,57
"NIMROZ","CHAR BURJAK",3404028,2,6,15,21
"NIMROZ","CHAR BURJAK",3404022,4,38,77,115
"NIMROZ","CHAR BURJAK",3404064,2,9,8,17
"NIMROZ","CHAR BURJAK",3404064,3,7,5,12
"NIMROZ","CHAR BURJAK",3404028,1,6,8,14
"NIMROZ","CHAR BURJAK",3404026,3,35,548,583
"NIMROZ","CHAR BURJAK",3404064,1,32,76,108
"NIMROZ","CHAR BURJAK",3404024,2,11,72,83
"NIMROZ","CHAR BURJAK",3404026,1,46,530,576
"NIMROZ","CHAR BURJAK",3404022,3,7,12,19
"NIMROZ","CHAR BURJAK",3404023,3,7,41,48
"NIMROZ","CHAR BURJAK",3404020,1,2,12,14
"NIMROZ","CHAR BURJAK",3404022,2,15,4,19
"NIMROZ","CHAR BURJAK",3404022,1,13,9,22
"NIMROZ","CHAR BURJAK",3404063,2,7,8,15
"NIMROZ","CHAR BURJAK",3404063,3,17,34,51
"NIMROZ","CHAR BURJAK",3404024,1,26,44,70
"NIMROZ","CHAR BURJAK",3404020,2,68,142,210
"NIMROZ","CHAR BURJAK",3404063,1,8,19,27
"NIMROZ","CHAR BURJAK",3404020,3,11,31,42
"NIMROZ","CHAR BURJAK",3404027,1,35,361,396
"NIMROZ","CHAR BURJAK",3404027,2,30,104,134
"NIMROZ","CHAR BURJAK",3404020,4,10,18,28
"NIMROZ","KHASHROD",3405044,1,10,17,27
"NIMROZ","KHASHROD",3405039,3,13,11,24
"NIMROZ","KHASHROD",3405046,2,3,15,18
"NIMROZ","KHASHROD",3405039,4,9,9,18
"NIMROZ","KHASHROD",3405039,2,17,64,81
"NIMROZ","KHASHROD",3405039,1,102,73,175
"NIMROZ","KHASHROD",3405046,1,1,18,19
"NIMROZ","KHASHROD",3405044,2,4,3,7
NA,NA,3406048,1,27,64,91
NA,NA,3406048,2,8,28,36
NA,NA,3406047,1,4,27,31
NA,NA,3406047,2,6,7,13
NA,NA,3406049,1,22,82,104
NA,NA,3406052,1,72,71,143
NA,NA,3406052,2,20,29,49
"WARDAK","MAYDAN SHAH",401010,2,1,597,598
"WARDAK","MAYDAN SHAH",401005,4,2,121,123
"WARDAK","MAYDAN SHAH",401006,2,153,415,568
"WARDAK","MAYDAN SHAH",401010,3,0,598,598
"WARDAK","MAYDAN SHAH",401010,4,1,599,600
"WARDAK","MAYDAN SHAH",401011,1,57,292,349
"WARDAK","MAYDAN SHAH",401011,2,16,144,160
"WARDAK","MAYDAN SHAH",401011,3,50,550,600
"WARDAK","MAYDAN SHAH",401006,3,30,503,533
"WARDAK","MAYDAN SHAH",401010,5,3,594,597
"WARDAK","MAYDAN SHAH",401006,1,43,554,597
"WARDAK","MAYDAN SHAH",401001,8,15,498,513
"WARDAK","MAYDAN SHAH",401005,3,3,92,95
"WARDAK","MAYDAN SHAH",401001,1,100,340,440
"WARDAK","MAYDAN SHAH",401001,2,28,293,321
"WARDAK","MAYDAN SHAH",401001,3,24,306,330
"WARDAK","MAYDAN SHAH",401001,4,88,432,520
"WARDAK","MAYDAN SHAH",401001,5,57,129,186
"WARDAK","MAYDAN SHAH",401001,6,1,307,308
"WARDAK","MAYDAN SHAH",401001,7,4,186,190
"WARDAK","MAYDAN SHAH",401011,6,130,470,600
"WARDAK","MAYDAN SHAH",401001,9,2,592,594
"WARDAK","MAYDAN SHAH",401006,4,7,590,597
"WARDAK","MAYDAN SHAH",401005,1,4,170,174
"WARDAK","MAYDAN SHAH",401005,2,0,161,161
"WARDAK","MAYDAN SHAH",401003,3,6,593,599
"WARDAK","MAYDAN SHAH",401003,4,10,590,600
"WARDAK","MAYDAN SHAH",401003,5,12,588,600
"WARDAK","MAYDAN SHAH",401010,1,10,172,182
"WARDAK","MAYDAN SHAH",401012,1,49,231,280
"WARDAK","MAYDAN SHAH",401012,2,25,115,140
"WARDAK","MAYDAN SHAH",401011,4,3,50,53
"WARDAK","MAYDAN SHAH",401011,5,30,570,600
"WARDAK","MAYDAN SHAH",401013,2,0,11,11
"WARDAK","MAYDAN SHAH",401009,1,70,166,236
"WARDAK","MAYDAN SHAH",401001,10,0,598,598
"WARDAK","MAYDAN SHAH",401003,1,25,211,236
"WARDAK","MAYDAN SHAH",401003,2,0,17,17
"WARDAK","MAYDAN SHAH",401008,1,11,130,141
"WARDAK","MAYDAN SHAH",401008,2,3,597,600
"WARDAK","MAYDAN SHAH",401008,4,1,599,600
"WARDAK","MAYDAN SHAH",401008,5,2,598,600
"WARDAK","MAYDAN SHAH",401007,1,16,244,260
"WARDAK","MAYDAN SHAH",401004,1,4,152,156
"WARDAK","MAYDAN SHAH",401012,4,4,128,132
"WARDAK","MAYDAN SHAH",401013,1,4,74,78
"WARDAK","MAYDAN SHAH",401004,4,1,116,117
"WARDAK","MAYDAN SHAH",401002,1,14,575,589
"WARDAK","MAYDAN SHAH",401004,2,10,97,107
"WARDAK","MAYDAN SHAH",401004,3,1,112,113
"WARDAK","MAYDAN SHAH",401002,4,28,568,596
"WARDAK","MAYDAN SHAH",401009,3,7,211,218
"WARDAK","MAYDAN SHAH",401002,2,18,578,596
"WARDAK","MAYDAN SHAH",401002,3,11,582,593
"WARDAK","MAYDAN SHAH",401009,2,5,261,266
"WARDAK","MAYDAN SHAH",401009,4,13,180,193
"WARDAK","NERKH",402156,2,20,540,560
"WARDAK","NERKH",402144,1,36,564,600
"WARDAK","NERKH",402145,1,34,566,600
"WARDAK","NERKH",402156,1,3,41,44
"WARDAK","NERKH",402152,3,36,548,584
"WARDAK","NERKH",402145,2,14,586,600
"WARDAK","NERKH",402144,2,75,500,575
"WARDAK","NERKH",402144,3,36,564,600
"WARDAK","NERKH",402144,4,0,600,600
"WARDAK","NERKH",402149,1,13,547,560
"WARDAK","NERKH",402149,2,16,510,526
"WARDAK","NERKH",402152,1,29,215,244
"WARDAK","NERKH",402152,2,30,570,600
"WARDAK","NERKH",402159,3,35,565,600
"WARDAK","NERKH",402160,1,1,0,1
"WARDAK","NERKH",402160,2,17,540,557
"WARDAK","NERKH",402160,3,11,553,564
"WARDAK","NERKH",402155,1,0,600,600
"WARDAK","NERKH",402155,2,33,567,600
"WARDAK","NERKH",402143,1,19,578,597
"WARDAK","NERKH",402143,2,11,583,594
"WARDAK","NERKH",402143,3,18,579,597
"WARDAK","NERKH",402158,3,34,546,580
"WARDAK","NERKH",402148,1,50,250,300
"WARDAK","NERKH",402148,2,0,500,500
"WARDAK","NERKH",402157,2,28,214,242
"WARDAK","NERKH",402159,2,10,587,597
"WARDAK","NERKH",402154,2,24,576,600
"WARDAK","NERKH",402146,1,20,580,600
"WARDAK","NERKH",402146,2,43,557,600
"WARDAK","NERKH",402154,1,35,565,600
"WARDAK","NERKH",402147,1,54,546,600
"WARDAK","NERKH",402155,3,41,259,300
"WARDAK","NERKH",402158,1,7,14,21
"WARDAK","NERKH",402158,2,28,572,600
"WARDAK","NERKH",402153,3,60,540,600
"WARDAK","NERKH",402147,2,60,540,600
"WARDAK","NERKH",402151,1,52,78,130
"WARDAK","NERKH",402159,1,374,219,593
"WARDAK","NERKH",402153,1,11,589,600
"WARDAK","NERKH",402153,2,27,573,600
"WARDAK","JALREZ",403016,1,167,26,193
"WARDAK","JALREZ",403016,2,77,11,88
"WARDAK","JALREZ",403022,1,198,108,306
"WARDAK","JALREZ",403022,2,212,92,304
"WARDAK","JALREZ",403022,3,240,13,253
"WARDAK","JALREZ",403016,3,92,0,92
"WARDAK","JALREZ",403014,2,6,235,241
"WARDAK","JALREZ",403014,3,1,40,41
"WARDAK","JALREZ",403014,4,12,588,600
"WARDAK","JALREZ",403014,1,2,155,157
"WARDAK","JALREZ",403020,2,118,28,146
"WARDAK","JALREZ",403020,3,306,61,367
"WARDAK","JALREZ",403024,2,33,500,533
"WARDAK","JALREZ",403024,3,9,591,600
"WARDAK","JALREZ",403015,1,1,56,57
"WARDAK","JALREZ",403021,1,201,39,240
"WARDAK","JALREZ",403021,2,153,40,193
"WARDAK","JALREZ",403021,3,372,82,454
"WARDAK","JALREZ",403023,1,11,308,319
"WARDAK","JALREZ",403023,3,8,181,189
"WARDAK","JALREZ",403018,1,52,12,64
"WARDAK","JALREZ",403018,2,94,10,104
"WARDAK","JALREZ",403018,3,101,3,104
"WARDAK","JALREZ",403020,1,134,71,205
"WARDAK","JALREZ",403024,1,13,250,263
"WARDAK","JALREZ",403015,3,0,6,6
"WARDAK","JALREZ",403017,1,2,198,200
"WARDAK","JALREZ",403017,2,9,285,294
"WARDAK","JALREZ",403015,2,3,66,69
"WARDAK","JALREZ",403019,2,48,1,49
"WARDAK","JALREZ",403019,3,38,1,39
"WARDAK","JALREZ",403019,1,74,6,80
"WARDAK","CHAKI WARDAK",404102,1,199,401,600
"WARDAK","CHAKI WARDAK",404090,4,137,463,600
"WARDAK","CHAKI WARDAK",404101,3,194,406,600
"WARDAK","CHAKI WARDAK",404092,4,26,574,600
"WARDAK","CHAKI WARDAK",404092,1,10,590,600
"WARDAK","CHAKI WARDAK",404092,2,46,554,600
"WARDAK","CHAKI WARDAK",404092,3,2,598,600
"WARDAK","CHAKI WARDAK",404091,3,193,407,600
"WARDAK","CHAKI WARDAK",404091,4,200,400,600
"WARDAK","CHAKI WARDAK",404090,1,0,600,600
"WARDAK","CHAKI WARDAK",404090,2,10,590,600
"WARDAK","CHAKI WARDAK",404090,3,178,421,599
"WARDAK","CHAKI WARDAK",404083,1,99,501,600
"WARDAK","CHAKI WARDAK",404083,2,142,458,600
"WARDAK","CHAKI WARDAK",404083,3,3,597,600
"WARDAK","CHAKI WARDAK",404083,4,50,550,600
"WARDAK","CHAKI WARDAK",404087,1,7,593,600
"WARDAK","CHAKI WARDAK",404087,2,131,469,600
"WARDAK","CHAKI WARDAK",404107,1,25,575,600
"WARDAK","CHAKI WARDAK",404107,2,17,583,600
"WARDAK","CHAKI WARDAK",404107,3,36,564,600
"WARDAK","CHAKI WARDAK",404107,4,23,577,600
"WARDAK","CHAKI WARDAK",404107,5,75,525,600
"WARDAK","CHAKI WARDAK",404101,1,145,455,600
"WARDAK","CHAKI WARDAK",404101,2,203,397,600
"WARDAK","CHAKI WARDAK",404086,1,11,589,600
"WARDAK","CHAKI WARDAK",404086,2,0,600,600
"WARDAK","CHAKI WARDAK",404102,2,257,343,600
"WARDAK","CHAKI WARDAK",404102,3,223,377,600
"WARDAK","CHAKI WARDAK",404103,1,40,560,600
"WARDAK","CHAKI WARDAK",404103,2,142,458,600
"WARDAK","CHAKI WARDAK",404103,3,0,600,600
"WARDAK","CHAKI WARDAK",404106,1,0,600,600
"WARDAK","CHAKI WARDAK",404106,2,0,600,600
"WARDAK","CHAKI WARDAK",404104,2,0,600,600
"WARDAK","CHAKI WARDAK",404104,3,31,569,600
"WARDAK","CHAKI WARDAK",404105,1,0,600,600
"WARDAK","CHAKI WARDAK",404105,2,0,600,600
"WARDAK","CHAKI WARDAK",404105,3,0,600,600
"WARDAK","CHAKI WARDAK",404098,1,56,544,600
"WARDAK","CHAKI WARDAK",404098,2,121,479,600
"WARDAK","CHAKI WARDAK",404096,1,0,600,600
"WARDAK","CHAKI WARDAK",404096,2,100,500,600
"WARDAK","CHAKI WARDAK",404096,3,170,430,600
"WARDAK","CHAKI WARDAK",404100,1,37,563,600
"WARDAK","CHAKI WARDAK",404100,2,34,566,600
"WARDAK","CHAKI WARDAK",404100,3,68,532,600
"WARDAK","CHAKI WARDAK",404100,4,56,544,600
"WARDAK","CHAKI WARDAK",404095,1,0,600,600
"WARDAK","CHAKI WARDAK",404095,2,62,538,600
"WARDAK","CHAKI WARDAK",404095,3,5,595,600
"WARDAK","CHAKI WARDAK",404099,1,40,556,596
"WARDAK","CHAKI WARDAK",404099,2,54,546,600
"WARDAK","CHAKI WARDAK",404093,1,178,422,600
"WARDAK","CHAKI WARDAK",404093,2,100,500,600
"WARDAK","CHAKI WARDAK",404093,3,33,567,600
"WARDAK","CHAKI WARDAK",404097,1,7,593,600
"WARDAK","CHAKI WARDAK",404097,2,0,599,599
"WARDAK","CHAKI WARDAK",404097,3,7,593,600
"WARDAK","CHAKI WARDAK",404087,3,121,479,600
"WARDAK","CHAKI WARDAK",404087,4,8,521,529
"WARDAK","CHAKI WARDAK",404084,1,141,459,600
"WARDAK","CHAKI WARDAK",404084,2,38,562,600
"WARDAK","CHAKI WARDAK",404084,3,20,580,600
"WARDAK","CHAKI WARDAK",404084,4,23,577,600
"WARDAK","CHAKI WARDAK",404088,1,300,300,600
"WARDAK","CHAKI WARDAK",404088,2,247,319,566
"WARDAK","CHAKI WARDAK",404088,3,180,420,600
"WARDAK","CHAKI WARDAK",404085,1,165,435,600
"WARDAK","CHAKI WARDAK",404085,2,181,419,600
"WARDAK","CHAKI WARDAK",404094,1,69,431,500
"WARDAK","CHAKI WARDAK",404094,2,71,529,600
"WARDAK","CHAKI WARDAK",404094,3,73,527,600
"WARDAK","CHAKI WARDAK",404104,1,42,557,599
"WARDAK","CHAKI WARDAK",404091,2,200,400,600
"WARDAK","CHAKI WARDAK",404086,3,13,586,599
"WARDAK","CHAKI WARDAK",404089,1,6,594,600
"WARDAK","CHAKI WARDAK",404089,2,40,560,600
"WARDAK","CHAKI WARDAK",404097,4,0,600,600
"WARDAK","CHAKI WARDAK",404091,1,200,400,600
"WARDAK","CHAKI WARDAK",404089,3,50,550,600
"WARDAK","SAYYD ABAD",405116,2,5,591,596
"WARDAK","SAYYD ABAD",405117,2,0,600,600
"WARDAK","SAYYD ABAD",405115,1,2,598,600
"WARDAK","SAYYD ABAD",405115,2,95,500,595
"WARDAK","SAYYD ABAD",405116,1,0,590,590
"WARDAK","SAYYD ABAD",405124,2,576,21,597
"WARDAK","SAYYD ABAD",405137,1,91,509,600
"WARDAK","SAYYD ABAD",405137,2,6,594,600
"WARDAK","SAYYD ABAD",405124,1,49,543,592
"WARDAK","SAYYD ABAD",405124,4,7,591,598
"WARDAK","SAYYD ABAD",405140,1,50,550,600
"WARDAK","SAYYD ABAD",405140,2,76,520,596
"WARDAK","SAYYD ABAD",405140,3,55,539,594
"WARDAK","SAYYD ABAD",405140,4,87,508,595
"WARDAK","SAYYD ABAD",405140,5,56,536,592
"WARDAK","SAYYD ABAD",405135,1,150,450,600
"WARDAK","SAYYD ABAD",405123,1,25,544,569
"WARDAK","SAYYD ABAD",405123,2,32,514,546
"WARDAK","SAYYD ABAD",405122,1,13,585,598
"WARDAK","SAYYD ABAD",405122,2,25,570,595
"WARDAK","SAYYD ABAD",405108,4,0,596,596
"WARDAK","SAYYD ABAD",405124,3,0,600,600
"WARDAK","SAYYD ABAD",405122,4,0,600,600
"WARDAK","SAYYD ABAD",405132,1,10,588,598
"WARDAK","SAYYD ABAD",405132,2,6,589,595
"WARDAK","SAYYD ABAD",405127,1,29,569,598
"WARDAK","SAYYD ABAD",405127,2,47,553,600
"WARDAK","SAYYD ABAD",405119,1,59,537,596
"WARDAK","SAYYD ABAD",405119,2,52,538,590
"WARDAK","SAYYD ABAD",405130,1,3,597,600
"WARDAK","SAYYD ABAD",405130,2,13,587,600
"WARDAK","SAYYD ABAD",405129,1,24,575,599
"WARDAK","SAYYD ABAD",405129,2,26,574,600
"WARDAK","SAYYD ABAD",405139,1,75,517,592
"WARDAK","SAYYD ABAD",405139,2,50,550,600
"WARDAK","SAYYD ABAD",405139,3,100,500,600
"WARDAK","SAYYD ABAD",405125,1,12,586,598
"WARDAK","SAYYD ABAD",405125,2,15,576,591
"WARDAK","SAYYD ABAD",405125,3,28,560,588
"WARDAK","SAYYD ABAD",405128,1,57,542,599
"WARDAK","SAYYD ABAD",405128,2,38,560,598
"WARDAK","SAYYD ABAD",405117,1,0,594,594
"WARDAK","SAYYD ABAD",405110,4,0,595,595
"WARDAK","SAYYD ABAD",405110,5,4,591,595
"WARDAK","SAYYD ABAD",405108,1,5,594,599
"WARDAK","SAYYD ABAD",405108,2,0,600,600
"WARDAK","SAYYD ABAD",405108,3,0,600,600
"WARDAK","SAYYD ABAD",405111,3,15,581,596
"WARDAK","SAYYD ABAD",405108,5,0,596,596
"WARDAK","SAYYD ABAD",405108,6,1,599,600
"WARDAK","SAYYD ABAD",405131,1,20,580,600
"WARDAK","SAYYD ABAD",405131,2,2,590,592
"WARDAK","SAYYD ABAD",405131,3,195,400,595
"WARDAK","SAYYD ABAD",405131,4,100,500,600
"WARDAK","SAYYD ABAD",405113,1,10,565,575
"WARDAK","SAYYD ABAD",405113,2,6,582,588
"WARDAK","SAYYD ABAD",405113,3,39,559,598
"WARDAK","SAYYD ABAD",405113,4,139,457,596
"WARDAK","SAYYD ABAD",405111,1,0,600,600
"WARDAK","SAYYD ABAD",405111,2,17,579,596
"WARDAK","SAYYD ABAD",405138,1,37,560,597
"WARDAK","SAYYD ABAD",405122,3,0,600,600
"WARDAK","SAYYD ABAD",405118,1,73,527,600
"WARDAK","SAYYD ABAD",405118,2,1,599,600
"WARDAK","SAYYD ABAD",405114,1,30,564,594
"WARDAK","SAYYD ABAD",405114,2,14,500,514
"WARDAK","SAYYD ABAD",405114,3,67,526,593
"WARDAK","SAYYD ABAD",405114,4,10,567,577
"WARDAK","SAYYD ABAD",405114,5,47,548,595
"WARDAK","SAYYD ABAD",405114,6,89,453,542
"WARDAK","SAYYD ABAD",405114,7,0,595,595
"WARDAK","SAYYD ABAD",405114,8,4,596,600
"WARDAK","SAYYD ABAD",405114,9,1,599,600
"WARDAK","SAYYD ABAD",405136,2,32,568,600
"WARDAK","SAYYD ABAD",405138,2,110,474,584
"WARDAK","SAYYD ABAD",405138,3,87,513,600
"WARDAK","SAYYD ABAD",405141,1,10,581,591
"WARDAK","SAYYD ABAD",405141,2,7,582,589
"WARDAK","SAYYD ABAD",405141,3,8,575,583
"WARDAK","SAYYD ABAD",405110,1,17,534,551
"WARDAK","SAYYD ABAD",405110,2,5,592,597
"WARDAK","SAYYD ABAD",405110,3,21,568,589
"WARDAK","SAYYD ABAD",405109,3,50,550,600
"WARDAK","SAYYD ABAD",405112,1,12,576,588
"WARDAK","SAYYD ABAD",405135,2,110,490,600
"WARDAK","SAYYD ABAD",405136,1,25,573,598
"WARDAK","SAYYD ABAD",405133,1,16,584,600
"WARDAK","SAYYD ABAD",405121,1,14,586,600
"WARDAK","SAYYD ABAD",405111,4,3,597,600
"WARDAK","SAYYD ABAD",405142,1,16,570,586
"WARDAK","SAYYD ABAD",405142,2,0,588,588
"WARDAK","SAYYD ABAD",405142,3,0,591,591
"WARDAK","SAYYD ABAD",405142,4,3,597,600
"WARDAK","SAYYD ABAD",405109,1,57,528,585
"WARDAK","SAYYD ABAD",405109,2,1,354,355
"WARDAK","SAYYD ABAD",405120,1,2,593,595
"WARDAK","SAYYD ABAD",405133,2,16,570,586
"WARDAK","SAYYD ABAD",405112,2,13,581,594
"WARDAK","SAYYD ABAD",405112,3,13,577,590
"WARDAK","SAYYD ABAD",405121,2,8,592,600
"WARDAK","SAYYD ABAD",405120,2,20,578,598
"WARDAK","SAYYD ABAD",405126,1,9,587,596
"WARDAK","SAYYD ABAD",405126,2,7,579,586
"WARDAK","SAYYD ABAD",405134,1,13,587,600
"WARDAK","SAYYD ABAD",405134,2,26,574,600
"WARDAK","DAYMIRDAD",406066,2,0,597,597
"WARDAK","DAYMIRDAD",406070,5,0,600,600
"WARDAK","DAYMIRDAD",406066,1,0,596,596
"WARDAK","DAYMIRDAD",406065,2,0,597,597
"WARDAK","DAYMIRDAD",406065,3,0,600,600
"WARDAK","DAYMIRDAD",406070,1,0,598,598
"WARDAK","DAYMIRDAD",406070,2,0,598,598
"WARDAK","DAYMIRDAD",406070,3,0,598,598
"WARDAK","DAYMIRDAD",406067,1,0,599,599
"WARDAK","DAYMIRDAD",406066,3,0,594,594
"WARDAK","DAYMIRDAD",406071,1,0,598,598
"WARDAK","DAYMIRDAD",406071,2,0,597,597
"WARDAK","DAYMIRDAD",406071,3,0,597,597
"WARDAK","DAYMIRDAD",406064,5,0,598,598
"WARDAK","DAYMIRDAD",406068,1,55,543,598
"WARDAK","DAYMIRDAD",406068,2,51,548,599
"WARDAK","DAYMIRDAD",406065,1,0,600,600
"WARDAK","DAYMIRDAD",406069,3,68,526,594
"WARDAK","DAYMIRDAD",406068,3,95,498,593
"WARDAK","DAYMIRDAD",406069,1,39,559,598
"WARDAK","DAYMIRDAD",406069,2,44,551,595
"WARDAK","DAYMIRDAD",406064,3,0,599,599
"WARDAK","DAYMIRDAD",406067,2,0,595,595
"WARDAK","DAYMIRDAD",406064,1,0,597,597
"WARDAK","DAYMIRDAD",406064,2,0,599,599
"WARDAK","DAYMIRDAD",406069,5,19,571,590
"WARDAK","DAYMIRDAD",406064,4,0,597,597
"WARDAK","DAYMIRDAD",406070,4,0,600,600
"WARDAK","DAYMIRDAD",406069,4,38,561,599
"WARDAK","HISSA-E-AWALI",407027,3,510,79,589
"WARDAK","HISSA-E-AWALI",407028,1,358,130,488
"WARDAK","HISSA-E-AWALI",407028,2,151,64,215
"WARDAK","HISSA-E-AWALI",407032,1,239,96,335
"WARDAK","HISSA-E-AWALI",407032,2,249,131,380
"WARDAK","HISSA-E-AWALI",407032,3,250,153,403
"WARDAK","HISSA-E-AWALI",407027,2,182,33,215
"WARDAK","HISSA-E-AWALI",407026,1,358,232,590
"WARDAK","HISSA-E-AWALI",407026,2,376,224,600
"WARDAK","HISSA-E-AWALI",407025,1,27,490,517
"WARDAK","HISSA-E-AWALI",407028,3,537,55,592
"WARDAK","HISSA-E-AWALI",407025,3,18,502,520
"WARDAK","HISSA-E-AWALI",407030,1,223,91,314
"WARDAK","HISSA-E-AWALI",407030,2,203,91,294
"WARDAK","HISSA-E-AWALI",407025,2,28,510,538
"WARDAK","HISSA-E-AWALI",407032,4,409,150,559
"WARDAK","HISSA-E-AWALI",407032,5,522,41,563
"WARDAK","HISSA-E-AWALI",407029,1,113,93,206
"WARDAK","HISSA-E-AWALI",407033,1,167,25,192
"WARDAK","HISSA-E-AWALI",407029,3,170,227,397
"WARDAK","HISSA-E-AWALI",407027,1,203,47,250
"WARDAK","HISSA-E-AWALI",407031,1,230,57,287
"WARDAK","HISSA-E-AWALI",407031,2,176,28,204
"WARDAK","HISSA-E-AWALI",407029,2,102,222,324
"WARDAK","HISSA-E-AWALI",407033,2,179,7,186
"WARDAK","JAGHATU",408075,2,274,317,591
"WARDAK","JAGHATU",408075,1,41,555,596
"WARDAK","JAGHATU",408072,2,107,487,594
"WARDAK","JAGHATU",408072,3,80,517,597
"WARDAK","JAGHATU",408077,1,150,450,600
"WARDAK","JAGHATU",408077,2,150,445,595
"WARDAK","JAGHATU",408073,1,142,450,592
"WARDAK","JAGHATU",408073,2,273,322,595
"WARDAK","JAGHATU",408073,3,125,471,596
"WARDAK","JAGHATU",408073,4,120,474,594
"WARDAK","JAGHATU",408074,1,70,528,598
"WARDAK","JAGHATU",408074,2,200,400,600
"WARDAK","JAGHATU",408074,3,80,520,600
"WARDAK","JAGHATU",408074,4,20,578,598
"WARDAK","JAGHATU",408074,5,150,450,600
"WARDAK","JAGHATU",408072,1,200,397,597
"WARDAK","JAGHATU",408076,1,200,385,585
"WARDAK","JAGHATU",408076,2,150,450,600
"WARDAK","JAGHATU",408076,3,250,342,592
"WARDAK","JAGHATU",408081,1,33,548,581
"WARDAK","JAGHATU",408081,2,46,539,585
"WARDAK","JAGHATU",408078,1,150,437,587
"WARDAK","JAGHATU",408078,2,150,450,600
"WARDAK","JAGHATU",408079,1,10,590,600
"WARDAK","JAGHATU",408079,2,5,595,600
"WARDAK","JAGHATU",408080,1,3,590,593
"WARDAK","JAGHATU",408075,3,100,497,597
"WARDAK","JAGHATU",408082,1,300,300,600
"WARDAK","JAGHATU",408082,2,70,506,576
"WARDAK","JAGHATU",408080,2,10,580,590
"WARDAK","MARKAZ-E-BEH",409053,3,444,88,532
"WARDAK","MARKAZ-E-BEH",409044,2,459,131,590
"WARDAK","MARKAZ-E-BEH",409043,2,404,192,596
"WARDAK","MARKAZ-E-BEH",409054,1,488,106,594
"WARDAK","MARKAZ-E-BEH",409044,1,421,158,579
"WARDAK","MARKAZ-E-BEH",409054,2,447,121,568
"WARDAK","MARKAZ-E-BEH",409044,3,493,79,572
"WARDAK","MARKAZ-E-BEH",409039,1,473,51,524
"WARDAK","MARKAZ-E-BEH",409039,2,368,32,400
"WARDAK","MARKAZ-E-BEH",409041,1,186,87,273
"WARDAK","MARKAZ-E-BEH",409054,3,509,75,584
"WARDAK","MARKAZ-E-BEH",409062,1,419,166,585
"WARDAK","MARKAZ-E-BEH",409062,2,444,154,598
"WARDAK","MARKAZ-E-BEH",409034,1,171,62,233
"WARDAK","MARKAZ-E-BEH",409034,2,172,59,231
"WARDAK","MARKAZ-E-BEH",409034,3,268,53,321
"WARDAK","MARKAZ-E-BEH",409034,4,564,28,592
"WARDAK","MARKAZ-E-BEH",409035,1,326,101,427
"WARDAK","MARKAZ-E-BEH",409035,2,491,108,599
"WARDAK","MARKAZ-E-BEH",409050,1,194,133,327
"WARDAK","MARKAZ-E-BEH",409050,2,291,125,416
"WARDAK","MARKAZ-E-BEH",409050,3,252,87,339
"WARDAK","MARKAZ-E-BEH",409043,1,405,193,598
"WARDAK","MARKAZ-E-BEH",409041,2,188,25,213
"WARDAK","MARKAZ-E-BEH",409046,1,285,314,599
"WARDAK","MARKAZ-E-BEH",409046,2,266,333,599
"WARDAK","MARKAZ-E-BEH",409063,1,372,185,557
"WARDAK","MARKAZ-E-BEH",409063,2,324,224,548
"WARDAK","MARKAZ-E-BEH",409063,3,407,193,600
"WARDAK","MARKAZ-E-BEH",409058,1,293,290,583
"WARDAK","MARKAZ-E-BEH",409058,2,208,83,291
"WARDAK","MARKAZ-E-BEH",409060,1,358,38,396
"WARDAK","MARKAZ-E-BEH",409040,1,471,126,597
"WARDAK","MARKAZ-E-BEH",409040,2,503,78,581
"WARDAK","MARKAZ-E-BEH",409042,1,133,27,160
"WARDAK","MARKAZ-E-BEH",409042,2,87,5,92
"WARDAK","MARKAZ-E-BEH",409047,2,379,156,535
"WARDAK","MARKAZ-E-BEH",409059,1,366,147,513
"WARDAK","MARKAZ-E-BEH",409059,2,320,83,403
"WARDAK","MARKAZ-E-BEH",409037,1,293,108,401
"WARDAK","MARKAZ-E-BEH",409037,2,259,49,308
"WARDAK","MARKAZ-E-BEH",409038,1,367,229,596
"WARDAK","MARKAZ-E-BEH",409038,2,491,100,591
"WARDAK","MARKAZ-E-BEH",409045,1,245,39,284
"WARDAK","MARKAZ-E-BEH",409045,2,293,43,336
"WARDAK","MARKAZ-E-BEH",409045,3,309,30,339
"WARDAK","MARKAZ-E-BEH",409049,1,245,102,347
"WARDAK","MARKAZ-E-BEH",409049,2,195,75,270
"WARDAK","MARKAZ-E-BEH",409047,1,382,112,494
"WARDAK","MARKAZ-E-BEH",409061,2,400,8,408
"WARDAK","MARKAZ-E-BEH",409051,1,521,74,595
"WARDAK","MARKAZ-E-BEH",409051,2,451,146,597
"WARDAK","MARKAZ-E-BEH",409048,1,366,168,534
"WARDAK","MARKAZ-E-BEH",409048,2,432,156,588
"WARDAK","MARKAZ-E-BEH",409052,1,384,196,580
"WARDAK","MARKAZ-E-BEH",409052,2,463,131,594
"WARDAK","MARKAZ-E-BEH",409053,1,292,48,340
"WARDAK","MARKAZ-E-BEH",409053,2,199,27,226
"WARDAK","MARKAZ-E-BEH",409056,2,236,130,366
"WARDAK","MARKAZ-E-BEH",409057,1,168,431,599
"WARDAK","MARKAZ-E-BEH",409060,2,392,17,409
"WARDAK","MARKAZ-E-BEH",409061,1,520,26,546
"WARDAK","MARKAZ-E-BEH",409057,2,67,530,597
"WARDAK","MARKAZ-E-BEH",409055,1,482,62,544
"WARDAK","MARKAZ-E-BEH",409036,1,489,103,592
"WARDAK","MARKAZ-E-BEH",409036,2,438,147,585
"WARDAK","MARKAZ-E-BEH",409057,3,203,397,600
"WARDAK","MARKAZ-E-BEH",409055,2,491,38,529
"WARDAK","MARKAZ-E-BEH",409056,1,195,26,221
"LOGAR","PULI ALAM",501014,1,2,292,294
"LOGAR","PULI ALAM",501014,5,0,600,600
"LOGAR","PULI ALAM",501014,2,4,188,192
"LOGAR","PULI ALAM",501017,1,6,48,54
"LOGAR","PULI ALAM",501013,1,0,47,47
"LOGAR","PULI ALAM",501014,3,1,388,389
"LOGAR","PULI ALAM",501014,4,5,587,592
"LOGAR","PULI ALAM",501019,5,2,594,596
"LOGAR","PULI ALAM",501011,2,52,210,262
"LOGAR","PULI ALAM",501013,2,4,38,42
"LOGAR","PULI ALAM",501013,3,0,305,305
"LOGAR","PULI ALAM",501011,5,2,390,392
"LOGAR","PULI ALAM",501010,1,18,14,32
"LOGAR","PULI ALAM",501011,3,87,327,414
"LOGAR","PULI ALAM",501011,4,7,456,463
"LOGAR","PULI ALAM",501015,1,14,107,121
"LOGAR","PULI ALAM",501015,2,9,90,99
"LOGAR","PULI ALAM",501012,1,6,147,153
"LOGAR","PULI ALAM",501012,4,1,54,55
"LOGAR","PULI ALAM",501020,1,8,32,40
"LOGAR","PULI ALAM",501020,2,6,33,39
"LOGAR","PULI ALAM",501020,3,0,5,5
"LOGAR","PULI ALAM",501016,1,46,483,529
"LOGAR","PULI ALAM",501016,2,1,564,565
"LOGAR","PULI ALAM",501016,3,27,513,540
"LOGAR","PULI ALAM",501016,4,15,485,500
"LOGAR","PULI ALAM",501016,5,6,521,527
"LOGAR","PULI ALAM",501018,1,96,366,462
"LOGAR","PULI ALAM",501018,2,61,343,404
"LOGAR","PULI ALAM",501018,3,21,308,329
"LOGAR","PULI ALAM",501019,1,0,594,594
"LOGAR","PULI ALAM",501019,2,0,600,600
"LOGAR","PULI ALAM",501019,3,0,600,600
"LOGAR","PULI ALAM",501019,4,6,585,591
"LOGAR","PULI ALAM",501004,3,0,593,593
"LOGAR","PULI ALAM",501004,4,5,592,597
"LOGAR","PULI ALAM",501004,5,2,582,584
"LOGAR","PULI ALAM",501004,6,0,594,594
"LOGAR","PULI ALAM",501004,7,0,585,585
"LOGAR","PULI ALAM",501004,8,3,584,587
"LOGAR","PULI ALAM",501004,9,0,382,382
"LOGAR","PULI ALAM",501003,1,27,122,149
"LOGAR","PULI ALAM",501003,2,18,160,178
"LOGAR","PULI ALAM",501003,3,11,90,101
"LOGAR","PULI ALAM",501017,2,6,54,60
"LOGAR","PULI ALAM",501008,2,8,164,172
"LOGAR","PULI ALAM",501008,3,23,140,163
"LOGAR","PULI ALAM",501008,4,4,140,144
"LOGAR","PULI ALAM",501011,1,43,391,434
"LOGAR","PULI ALAM",501001,2,52,240,292
"LOGAR","PULI ALAM",501001,3,51,224,275
"LOGAR","PULI ALAM",501001,4,37,196,233
"LOGAR","PULI ALAM",501001,5,15,84,99
"LOGAR","PULI ALAM",501001,6,16,93,109
"LOGAR","PULI ALAM",501001,7,4,131,135
"LOGAR","PULI ALAM",501001,8,11,43,54
"LOGAR","PULI ALAM",501001,9,28,67,95
"LOGAR","PULI ALAM",501015,3,5,70,75
"LOGAR","PULI ALAM",501015,4,3,8,11
"LOGAR","PULI ALAM",501007,1,9,587,596
"LOGAR","PULI ALAM",501007,2,4,587,591
"LOGAR","PULI ALAM",501007,3,4,589,593
"LOGAR","PULI ALAM",501007,4,13,585,598
"LOGAR","PULI ALAM",501007,5,0,600,600
"LOGAR","PULI ALAM",501007,6,29,566,595
"LOGAR","PULI ALAM",501007,7,14,566,580
"LOGAR","PULI ALAM",501007,8,14,583,597
"LOGAR","PULI ALAM",501007,9,7,593,600
"LOGAR","PULI ALAM",501007,10,38,557,595
"LOGAR","PULI ALAM",501007,11,7,581,588
"LOGAR","PULI ALAM",501007,12,33,552,585
"LOGAR","PULI ALAM",501007,13,4,580,584
"LOGAR","PULI ALAM",501004,1,6,587,593
"LOGAR","PULI ALAM",501004,2,2,592,594
"LOGAR","PULI ALAM",501002,9,88,70,158
"LOGAR","PULI ALAM",501002,10,116,41,157
"LOGAR","PULI ALAM",501009,1,3,511,514
"LOGAR","PULI ALAM",501009,2,0,494,494
"LOGAR","PULI ALAM",501009,3,2,590,592
"LOGAR","PULI ALAM",501009,4,2,576,578
"LOGAR","PULI ALAM",501009,5,9,300,309
"LOGAR","PULI ALAM",501009,6,22,422,444
"LOGAR","PULI ALAM",501009,7,8,587,595
"LOGAR","PULI ALAM",501009,8,90,500,590
"LOGAR","PULI ALAM",501008,1,4,143,147
"LOGAR","PULI ALAM",501003,4,14,65,79
"LOGAR","PULI ALAM",501003,5,15,102,117
"LOGAR","PULI ALAM",501003,6,32,120,152
"LOGAR","PULI ALAM",501001,1,91,437,528
"LOGAR","PULI ALAM",501005,5,24,66,90
"LOGAR","PULI ALAM",501005,6,6,71,77
"LOGAR","PULI ALAM",501005,7,9,61,70
"LOGAR","PULI ALAM",501006,1,14,68,82
"LOGAR","PULI ALAM",501006,5,0,5,5
"LOGAR","PULI ALAM",501002,1,124,106,230
"LOGAR","PULI ALAM",501002,2,199,177,376
"LOGAR","PULI ALAM",501002,3,103,152,255
"LOGAR","PULI ALAM",501001,10,19,66,85
"LOGAR","PULI ALAM",501005,1,13,87,100
"LOGAR","PULI ALAM",501005,2,5,190,195
"LOGAR","PULI ALAM",501005,3,13,119,132
"LOGAR","PULI ALAM",501005,4,7,359,366
"LOGAR","PULI ALAM",501002,4,73,97,170
"LOGAR","PULI ALAM",501002,5,40,44,84
"LOGAR","PULI ALAM",501002,6,16,35,51
"LOGAR","PULI ALAM",501002,7,143,122,265
"LOGAR","PULI ALAM",501002,8,100,37,137
"LOGAR","BARAKI BARAK",502033,1,6,38,44
"LOGAR","BARAKI BARAK",502036,3,15,443,458
"LOGAR","BARAKI BARAK",502039,1,9,31,40
"LOGAR","BARAKI BARAK",502039,2,0,13,13
"LOGAR","BARAKI BARAK",502033,2,0,9,9
"LOGAR","BARAKI BARAK",502039,4,0,15,15
"LOGAR","BARAKI BARAK",502035,1,9,27,36
"LOGAR","BARAKI BARAK",502035,2,0,4,4
"LOGAR","BARAKI BARAK",502039,3,0,50,50
"LOGAR","BARAKI BARAK",502025,1,48,141,189
"LOGAR","BARAKI BARAK",502025,2,14,33,47
"LOGAR","BARAKI BARAK",502025,3,4,34,38
"LOGAR","BARAKI BARAK",502025,4,33,24,57
"LOGAR","BARAKI BARAK",502025,5,4,12,16
"LOGAR","BARAKI BARAK",502025,6,0,4,4
"LOGAR","BARAKI BARAK",502025,7,0,4,4
"LOGAR","BARAKI BARAK",502026,1,107,426,533
"LOGAR","BARAKI BARAK",502026,2,157,436,593
"LOGAR","BARAKI BARAK",502024,1,2,18,20
"LOGAR","BARAKI BARAK",502023,1,7,27,34
"LOGAR","BARAKI BARAK",502023,2,13,12,25
"LOGAR","BARAKI BARAK",502023,3,5,21,26
"LOGAR","BARAKI BARAK",502023,4,0,8,8
"LOGAR","BARAKI BARAK",502022,1,12,323,335
"LOGAR","BARAKI BARAK",502022,2,1,62,63
"LOGAR","BARAKI BARAK",502022,3,29,282,311
"LOGAR","BARAKI BARAK",502022,4,18,283,301
"LOGAR","BARAKI BARAK",502022,5,86,418,504
"LOGAR","BARAKI BARAK",502022,6,4,173,177
"LOGAR","BARAKI BARAK",502022,7,20,210,230
"LOGAR","BARAKI BARAK",502022,8,52,520,572
"LOGAR","BARAKI BARAK",502027,1,0,9,9
"LOGAR","BARAKI BARAK",502027,2,0,5,5
"LOGAR","BARAKI BARAK",502027,3,1,1,2
"LOGAR","BARAKI BARAK",502027,4,0,1,1
"LOGAR","BARAKI BARAK",502038,1,0,56,56
"LOGAR","BARAKI BARAK",502038,2,1,33,34
"LOGAR","BARAKI BARAK",502034,1,30,465,495
"LOGAR","BARAKI BARAK",502034,2,97,452,549
"LOGAR","BARAKI BARAK",502036,1,3,516,519
"LOGAR","BARAKI BARAK",502036,2,22,555,577
"LOGAR","BARAKI BARAK",502037,1,7,93,100
"LOGAR","BARAKI BARAK",502028,1,12,562,574
"LOGAR","BARAKI BARAK",502034,3,191,304,495
"LOGAR","CHARKH",503045,1,50,544,594
"LOGAR","CHARKH",503045,2,137,384,521
"LOGAR","CHARKH",503045,3,129,384,513
"LOGAR","CHARKH",503044,5,8,34,42
"LOGAR","CHARKH",503043,2,14,75,89
"LOGAR","CHARKH",503044,1,3,570,573
"LOGAR","CHARKH",503043,1,13,586,599
"LOGAR","CHARKH",503044,4,34,32,66
"LOGAR","CHARKH",503044,2,19,510,529
"LOGAR","CHARKH",503044,3,7,582,589
"LOGAR","KHUSHI",504048,3,9,191,200
"LOGAR","KHUSHI",504047,1,9,80,89
"LOGAR","KHUSHI",504047,2,1,96,97
"LOGAR","KHUSHI",504048,2,12,587,599
"LOGAR","KHUSHI",504049,2,47,58,105
"LOGAR","KHUSHI",504049,3,1,140,141
"LOGAR","KHUSHI",504049,4,8,32,40
"LOGAR","KHUSHI",504047,3,3,253,256
"LOGAR","KHUSHI",504046,1,75,8,83
"LOGAR","KHUSHI",504046,2,63,14,77
"LOGAR","KHUSHI",504046,3,143,25,168
"LOGAR","KHUSHI",504048,1,60,535,595
"LOGAR","KHUSHI",504046,5,173,28,201
"LOGAR","KHUSHI",504046,7,38,3,41
"LOGAR","KHUSHI",504046,8,43,12,55
"LOGAR","KHUSHI",504046,4,93,16,109
"LOGAR","KHUSHI",504049,1,12,102,114
"LOGAR","KHUSHI",504046,10,54,27,81
"LOGAR","KHUSHI",504046,9,65,9,74
"LOGAR","MOHAMMAD A",505055,3,5,362,367
"LOGAR","MOHAMMAD A",505054,1,0,310,310
"LOGAR","MOHAMMAD A",505055,2,4,403,407
"LOGAR","MOHAMMAD A",505064,2,3,23,26
"LOGAR","MOHAMMAD A",505064,3,0,87,87
"LOGAR","MOHAMMAD A",505055,1,5,518,523
"LOGAR","MOHAMMAD A",505064,1,1,61,62
"LOGAR","MOHAMMAD A",505063,3,9,590,599
"LOGAR","MOHAMMAD A",505063,4,20,578,598
"LOGAR","MOHAMMAD A",505054,3,2,389,391
"LOGAR","MOHAMMAD A",505065,1,2,73,75
"LOGAR","MOHAMMAD A",505065,2,8,197,205
"LOGAR","MOHAMMAD A",505065,3,2,146,148
"LOGAR","MOHAMMAD A",505065,4,1,97,98
"LOGAR","MOHAMMAD A",505065,5,1,271,272
"LOGAR","MOHAMMAD A",505060,1,6,588,594
"LOGAR","MOHAMMAD A",505060,2,17,576,593
"LOGAR","MOHAMMAD A",505060,3,8,585,593
"LOGAR","MOHAMMAD A",505060,4,4,583,587
"LOGAR","MOHAMMAD A",505060,5,2,226,228
"LOGAR","MOHAMMAD A",505083,1,24,100,124
"LOGAR","MOHAMMAD A",505083,2,46,212,258
"LOGAR","MOHAMMAD A",505063,5,3,596,599
"LOGAR","MOHAMMAD A",505067,1,3,588,591
"LOGAR","MOHAMMAD A",505067,2,24,474,498
"LOGAR","MOHAMMAD A",505067,3,7,585,592
"LOGAR","MOHAMMAD A",505067,4,4,183,187
"LOGAR","MOHAMMAD A",505067,5,0,163,163
"LOGAR","MOHAMMAD A",505067,6,0,139,139
"LOGAR","MOHAMMAD A",505066,1,48,534,582
"LOGAR","MOHAMMAD A",505066,2,6,583,589
"LOGAR","MOHAMMAD A",505066,3,19,567,586
"LOGAR","MOHAMMAD A",505066,4,28,561,589
"LOGAR","MOHAMMAD A",505066,5,4,588,592
"LOGAR","MOHAMMAD A",505066,6,9,582,591
"LOGAR","MOHAMMAD A",505083,3,10,52,62
"LOGAR","MOHAMMAD A",505050,5,31,567,598
"LOGAR","MOHAMMAD A",505050,6,27,317,344
"LOGAR","MOHAMMAD A",505051,1,32,169,201
"LOGAR","MOHAMMAD A",505051,2,32,177,209
"LOGAR","MOHAMMAD A",505051,4,64,119,183
"LOGAR","MOHAMMAD A",505051,5,28,167,195
"LOGAR","MOHAMMAD A",505053,1,8,60,68
"LOGAR","MOHAMMAD A",505052,1,2,587,589
"LOGAR","MOHAMMAD A",505052,2,1,202,203
"LOGAR","MOHAMMAD A",505063,1,6,588,594
"LOGAR","MOHAMMAD A",505063,2,5,587,592
"LOGAR","MOHAMMAD A",505059,1,5,321,326
"LOGAR","MOHAMMAD A",505059,2,11,331,342
"LOGAR","MOHAMMAD A",505059,3,2,246,248
"LOGAR","MOHAMMAD A",505062,1,8,529,537
"LOGAR","MOHAMMAD A",505062,2,2,515,517
"LOGAR","MOHAMMAD A",505062,3,3,545,548
"LOGAR","MOHAMMAD A",505062,4,0,388,388
"LOGAR","MOHAMMAD A",505057,1,29,175,204
"LOGAR","MOHAMMAD A",505057,2,4,69,73
"LOGAR","MOHAMMAD A",505057,3,14,83,97
"LOGAR","MOHAMMAD A",505057,4,3,442,445
"LOGAR","MOHAMMAD A",505057,5,27,459,486
"LOGAR","MOHAMMAD A",505061,1,9,574,583
"LOGAR","MOHAMMAD A",505061,2,6,589,595
"LOGAR","MOHAMMAD A",505061,3,11,563,574
"LOGAR","MOHAMMAD A",505050,4,7,406,413
"LOGAR","MOHAMMAD A",505050,1,19,491,510
"LOGAR","MOHAMMAD A",505050,2,30,442,472
"LOGAR","MOHAMMAD A",505050,3,6,491,497
"LOGAR","MOHAMMAD A",505052,3,2,330,332
"LOGAR","MOHAMMAD A",505058,1,4,7,11
"LOGAR","KHAR WAR",506073,1,4,18,22
"LOGAR","KHAR WAR",506072,3,5,9,14
"LOGAR","KHAR WAR",506073,2,1,36,37
"LOGAR","KHAR WAR",506072,2,5,8,13
"LOGAR","KHAR WAR",506072,4,5,6,11
"LOGAR","KHAR WAR",506072,5,6,5,11
"LOGAR","KHAR WAR",506072,6,5,5,10
"LOGAR","KHAR WAR",506072,1,16,20,36
"LOGAR","AZRA",507075,3,19,550,569
"LOGAR","AZRA",507075,4,22,576,598
"LOGAR","AZRA",507075,5,63,522,585
"LOGAR","AZRA",507075,6,84,504,588
"LOGAR","AZRA",507075,7,62,523,585
"LOGAR","AZRA",507075,8,62,525,587
"LOGAR","AZRA",507075,9,43,553,596
"LOGAR","AZRA",507075,1,26,487,513
"LOGAR","AZRA",507075,2,24,479,503
"LOGAR","AZRA",507081,1,91,509,600
"LOGAR","AZRA",507081,2,137,461,598
"LOGAR","AZRA",507081,3,88,510,598
"LOGAR","AZRA",507081,4,0,599,599
"LOGAR","AZRA",507081,5,4,596,600
"LOGAR","AZRA",507076,1,52,533,585
"LOGAR","AZRA",507076,2,362,158,520
"LOGAR","AZRA",507076,3,100,219,319
"LOGAR","AZRA",507076,4,23,47,70
"LOGAR","AZRA",507076,5,54,48,102
"LOGAR","AZRA",507077,1,37,560,597
"LOGAR","AZRA",507077,2,82,497,579
"LOGAR","AZRA",507077,3,73,511,584
"LOGAR","AZRA",507077,4,94,495,589
"LOGAR","AZRA",507077,5,57,537,594
"LOGAR","AZRA",507077,6,69,527,596
"LOGAR","AZRA",507077,7,532,63,595
"LOGAR","AZRA",507078,1,20,575,595
"LOGAR","AZRA",507078,2,15,581,596
"LOGAR","AZRA",507078,3,7,580,587
"LOGAR","AZRA",507078,4,7,590,597
"LOGAR","AZRA",507078,5,594,5,599
"LOGAR","AZRA",507078,6,43,553,596
"LOGAR","AZRA",507078,7,80,512,592
"LOGAR","AZRA",507078,8,9,383,392
"LOGAR","AZRA",507075,10,52,548,600
"NANGARHAR","JALALABAD",601002,1,7,70,77
"NANGARHAR","JALALABAD",601008,3,24,560,584
"NANGARHAR","JALALABAD",601008,5,39,536,575
"NANGARHAR","JALALABAD",601040,3,16,570,586
"NANGARHAR","JALALABAD",601008,4,19,571,590
"NANGARHAR","JALALABAD",601044,2,12,292,304
"NANGARHAR","JALALABAD",601008,6,9,122,131
"NANGARHAR","JALALABAD",601040,1,10,577,587
"NANGARHAR","JALALABAD",601025,1,22,222,244
"NANGARHAR","JALALABAD",601022,6,10,81,91
"NANGARHAR","JALALABAD",601022,7,9,79,88
"NANGARHAR","JALALABAD",601040,5,24,378,402
"NANGARHAR","JALALABAD",601040,2,14,575,589
"NANGARHAR","JALALABAD",601035,3,36,547,583
"NANGARHAR","JALALABAD",601040,4,10,343,353
"NANGARHAR","JALALABAD",601041,2,13,556,569
"NANGARHAR","JALALABAD",601041,3,14,347,361
"NANGARHAR","JALALABAD",601008,2,23,555,578
"NANGARHAR","JALALABAD",601041,1,10,313,323
"NANGARHAR","JALALABAD",601041,5,2,378,380
"NANGARHAR","JALALABAD",601044,1,10,409,419
"NANGARHAR","JALALABAD",601041,4,29,266,295
"NANGARHAR","JALALABAD",601043,4,5,486,491
"NANGARHAR","JALALABAD",601037,5,12,61,73
"NANGARHAR","JALALABAD",601037,6,2,70,72
"NANGARHAR","JALALABAD",601040,6,16,409,425
"NANGARHAR","JALALABAD",601042,5,0,82,82
"NANGARHAR","JALALABAD",601020,1,22,344,366
"NANGARHAR","JALALABAD",601020,2,19,190,209
"NANGARHAR","JALALABAD",601037,7,0,54,54
"NANGARHAR","JALALABAD",601037,8,0,61,61
"NANGARHAR","JALALABAD",601042,1,9,209,218
"NANGARHAR","JALALABAD",601022,5,50,57,107
"NANGARHAR","JALALABAD",601020,3,16,182,198
"NANGARHAR","JALALABAD",601044,3,11,194,205
"NANGARHAR","JALALABAD",601008,1,38,535,573
"NANGARHAR","JALALABAD",601035,2,42,416,458
"NANGARHAR","JALALABAD",601038,4,12,123,135
"NANGARHAR","JALALABAD",601038,5,16,202,218
"NANGARHAR","JALALABAD",601035,1,27,453,480
"NANGARHAR","JALALABAD",601044,4,2,112,114
"NANGARHAR","JALALABAD",601031,5,23,300,323
"NANGARHAR","JALALABAD",601035,4,31,477,508
"NANGARHAR","JALALABAD",601035,5,21,331,352
"NANGARHAR","JALALABAD",601017,4,18,251,269
"NANGARHAR","JALALABAD",601017,5,17,226,243
"NANGARHAR","JALALABAD",601017,6,10,312,322
"NANGARHAR","JALALABAD",601042,4,6,171,177
"NANGARHAR","JALALABAD",601043,2,7,588,595
"NANGARHAR","JALALABAD",601043,3,22,474,496
"NANGARHAR","JALALABAD",601004,2,17,513,530
"NANGARHAR","JALALABAD",601043,1,8,499,507
"NANGARHAR","JALALABAD",601004,4,21,377,398
"NANGARHAR","JALALABAD",601035,6,14,304,318
"NANGARHAR","JALALABAD",601017,1,18,572,590
"NANGARHAR","JALALABAD",601004,3,4,541,545
"NANGARHAR","JALALABAD",601042,3,1,82,83
"NANGARHAR","JALALABAD",601044,6,13,164,177
"NANGARHAR","JALALABAD",601044,7,22,240,262
"NANGARHAR","JALALABAD",601028,2,21,394,415
"NANGARHAR","JALALABAD",601028,3,27,403,430
"NANGARHAR","JALALABAD",601025,2,8,187,195
"NANGARHAR","JALALABAD",601025,3,27,220,247
"NANGARHAR","JALALABAD",601025,4,12,212,224
"NANGARHAR","JALALABAD",601025,5,19,216,235
"NANGARHAR","JALALABAD",601025,6,19,252,271
"NANGARHAR","JALALABAD",601036,2,19,569,588
"NANGARHAR","JALALABAD",601036,3,11,325,336
"NANGARHAR","JALALABAD",601042,2,7,89,96
"NANGARHAR","JALALABAD",601044,5,5,103,108
"NANGARHAR","JALALABAD",601022,3,13,130,143
"NANGARHAR","JALALABAD",601022,4,19,88,107
"NANGARHAR","JALALABAD",601038,3,22,326,348
"NANGARHAR","JALALABAD",601508,2,10,41,51
"NANGARHAR","JALALABAD",601508,3,3,62,65
"NANGARHAR","JALALABAD",601508,4,230,275,505
"NANGARHAR","JALALABAD",601006,1,45,461,506
"NANGARHAR","JALALABAD",601006,2,52,479,531
"NANGARHAR","JALALABAD",601006,3,27,304,331
"NANGARHAR","JALALABAD",601006,4,8,143,151
"NANGARHAR","JALALABAD",601006,5,2,123,125
"NANGARHAR","JALALABAD",601006,6,10,97,107
"NANGARHAR","JALALABAD",601017,2,13,573,586
"NANGARHAR","JALALABAD",601017,3,20,439,459
"NANGARHAR","JALALABAD",601002,4,2,144,146
"NANGARHAR","JALALABAD",601002,5,11,285,296
"NANGARHAR","JALALABAD",601002,6,3,93,96
"NANGARHAR","JALALABAD",601002,7,7,280,287
"NANGARHAR","JALALABAD",601002,8,12,246,258
"NANGARHAR","JALALABAD",601004,1,17,529,546
"NANGARHAR","JALALABAD",601018,2,7,98,105
"NANGARHAR","JALALABAD",601018,3,10,97,107
"NANGARHAR","JALALABAD",601018,4,7,133,140
"NANGARHAR","JALALABAD",601004,5,16,252,268
"NANGARHAR","JALALABAD",601004,6,5,257,262
"NANGARHAR","JALALABAD",601036,4,12,331,343
"NANGARHAR","JALALABAD",601004,8,11,287,298
"NANGARHAR","JALALABAD",601036,5,5,580,585
"NANGARHAR","JALALABAD",601037,4,15,102,117
"NANGARHAR","JALALABAD",601030,5,8,94,102
"NANGARHAR","JALALABAD",601021,1,17,199,216
"NANGARHAR","JALALABAD",601021,2,17,267,284
"NANGARHAR","JALALABAD",601021,3,21,450,471
"NANGARHAR","JALALABAD",601021,4,21,469,490
"NANGARHAR","JALALABAD",601021,5,16,408,424
"NANGARHAR","JALALABAD",601021,6,19,354,373
"NANGARHAR","JALALABAD",601021,7,19,250,269
"NANGARHAR","JALALABAD",601039,1,14,384,398
"NANGARHAR","JALALABAD",601020,7,4,76,80
"NANGARHAR","JALALABAD",601022,1,12,83,95
"NANGARHAR","JALALABAD",601022,2,6,134,140
"NANGARHAR","JALALABAD",601038,2,32,180,212
"NANGARHAR","JALALABAD",601508,1,19,65,84
"NANGARHAR","JALALABAD",601034,4,190,10,200
"NANGARHAR","JALALABAD",601034,5,6,212,218
"NANGARHAR","JALALABAD",601003,7,8,182,190
"NANGARHAR","JALALABAD",601031,3,17,262,279
"NANGARHAR","JALALABAD",601031,4,12,227,239
"NANGARHAR","JALALABAD",601024,3,8,76,84
"NANGARHAR","JALALABAD",601024,4,29,117,146
"NANGARHAR","JALALABAD",601024,5,23,231,254
"NANGARHAR","JALALABAD",601024,6,5,83,88
"NANGARHAR","JALALABAD",601002,2,6,129,135
"NANGARHAR","JALALABAD",601002,3,6,143,149
"NANGARHAR","JALALABAD",601026,2,3,89,92
"NANGARHAR","JALALABAD",601026,3,0,56,56
"NANGARHAR","JALALABAD",601026,4,1,17,18
"NANGARHAR","JALALABAD",601026,5,1,23,24
"NANGARHAR","JALALABAD",601026,6,2,15,17
"NANGARHAR","JALALABAD",601018,1,9,102,111
"NANGARHAR","JALALABAD",601023,3,10,244,254
"NANGARHAR","JALALABAD",601023,4,8,194,202
"NANGARHAR","JALALABAD",601023,5,20,434,454
"NANGARHAR","JALALABAD",601023,6,19,576,595
"NANGARHAR","JALALABAD",601043,5,9,586,595
"NANGARHAR","JALALABAD",601004,7,4,144,148
"NANGARHAR","JALALABAD",601037,1,26,117,143
"NANGARHAR","JALALABAD",601037,2,15,115,130
"NANGARHAR","JALALABAD",601036,6,19,529,548
"NANGARHAR","JALALABAD",601028,1,25,396,421
"NANGARHAR","JALALABAD",601019,6,11,114,125
"NANGARHAR","JALALABAD",601009,1,4,266,270
"NANGARHAR","JALALABAD",601028,4,7,169,176
"NANGARHAR","JALALABAD",601028,5,13,208,221
"NANGARHAR","JALALABAD",601028,6,51,358,409
"NANGARHAR","JALALABAD",601028,7,13,254,267
"NANGARHAR","JALALABAD",601015,1,8,230,238
"NANGARHAR","JALALABAD",601025,7,39,164,203
"NANGARHAR","JALALABAD",601039,2,16,401,417
"NANGARHAR","JALALABAD",601039,4,12,474,486
"NANGARHAR","JALALABAD",601039,5,21,413,434
"NANGARHAR","JALALABAD",601038,1,49,384,433
"NANGARHAR","JALALABAD",601034,3,5,151,156
"NANGARHAR","JALALABAD",601003,5,32,398,430
"NANGARHAR","JALALABAD",601003,6,8,537,545
"NANGARHAR","JALALABAD",601031,2,6,336,342
"NANGARHAR","JALALABAD",601012,3,54,436,490
"NANGARHAR","JALALABAD",601012,4,52,485,537
"NANGARHAR","JALALABAD",601012,5,74,367,441
"NANGARHAR","JALALABAD",601012,6,441,134,575
"NANGARHAR","JALALABAD",601012,7,265,319,584
"NANGARHAR","JALALABAD",601012,8,20,303,323
"NANGARHAR","JALALABAD",601024,7,6,114,120
"NANGARHAR","JALALABAD",601024,8,6,57,63
"NANGARHAR","JALALABAD",601024,9,4,81,85
"NANGARHAR","JALALABAD",601026,1,9,57,66
"NANGARHAR","JALALABAD",601029,2,39,157,196
"NANGARHAR","JALALABAD",601029,3,15,174,189
"NANGARHAR","JALALABAD",601029,4,16,128,144
"NANGARHAR","JALALABAD",601029,5,15,82,97
"NANGARHAR","JALALABAD",601029,6,25,163,188
"NANGARHAR","JALALABAD",601029,7,16,182,198
"NANGARHAR","JALALABAD",601032,1,9,289,298
"NANGARHAR","JALALABAD",601032,2,12,307,319
"NANGARHAR","JALALABAD",601023,7,25,446,471
"NANGARHAR","JALALABAD",601036,1,2,114,116
"NANGARHAR","JALALABAD",601018,7,6,145,151
"NANGARHAR","JALALABAD",601032,5,9,233,242
"NANGARHAR","JALALABAD",601037,3,38,272,310
"NANGARHAR","JALALABAD",601019,5,18,205,223
"NANGARHAR","JALALABAD",601030,3,20,201,221
"NANGARHAR","JALALABAD",601030,4,17,169,186
"NANGARHAR","JALALABAD",601009,2,5,172,177
"NANGARHAR","JALALABAD",601009,3,3,333,336
"NANGARHAR","JALALABAD",601009,4,7,507,514
"NANGARHAR","JALALABAD",601009,5,1,587,588
"NANGARHAR","JALALABAD",601009,6,29,528,557
"NANGARHAR","JALALABAD",601009,7,67,498,565
"NANGARHAR","JALALABAD",601027,1,39,278,317
"NANGARHAR","JALALABAD",601039,3,8,477,485
"NANGARHAR","JALALABAD",601020,6,2,67,69
"NANGARHAR","JALALABAD",601034,2,7,160,167
"NANGARHAR","JALALABAD",601003,4,30,331,361
"NANGARHAR","JALALABAD",601027,6,26,206,232
"NANGARHAR","JALALABAD",601031,1,14,497,511
"NANGARHAR","JALALABAD",601012,2,51,289,340
"NANGARHAR","JALALABAD",601016,4,14,312,326
"NANGARHAR","JALALABAD",601016,5,27,197,224
"NANGARHAR","JALALABAD",601024,1,7,93,100
"NANGARHAR","JALALABAD",601024,2,6,86,92
"NANGARHAR","JALALABAD",601010,2,27,50,77
"NANGARHAR","JALALABAD",601033,1,14,492,506
"NANGARHAR","JALALABAD",601013,1,83,501,584
"NANGARHAR","JALALABAD",601005,1,46,535,581
"NANGARHAR","JALALABAD",601005,2,33,383,416
"NANGARHAR","JALALABAD",601005,3,38,470,508
"NANGARHAR","JALALABAD",601005,4,10,186,196
"NANGARHAR","JALALABAD",601005,5,27,173,200
"NANGARHAR","JALALABAD",601005,6,23,171,194
"NANGARHAR","JALALABAD",601023,1,27,452,479
"NANGARHAR","JALALABAD",601023,2,13,515,528
"NANGARHAR","JALALABAD",601014,6,7,130,137
"NANGARHAR","JALALABAD",601010,1,3,80,83
"NANGARHAR","JALALABAD",601011,3,11,179,190
"NANGARHAR","JALALABAD",601018,5,8,423,431
"NANGARHAR","JALALABAD",601018,6,3,140,143
"NANGARHAR","JALALABAD",601019,1,44,389,433
"NANGARHAR","JALALABAD",601019,2,24,413,437
"NANGARHAR","JALALABAD",601030,1,9,170,179
"NANGARHAR","JALALABAD",601030,2,4,173,177
"NANGARHAR","JALALABAD",601007,2,3,349,352
"NANGARHAR","JALALABAD",601007,3,7,376,383
"NANGARHAR","JALALABAD",601007,4,2,358,360
"NANGARHAR","JALALABAD",601007,5,7,236,243
"NANGARHAR","JALALABAD",601011,1,8,216,224
"NANGARHAR","JALALABAD",601011,2,4,128,132
"NANGARHAR","JALALABAD",601014,5,4,300,304
"NANGARHAR","JALALABAD",601011,4,9,195,204
"NANGARHAR","JALALABAD",601011,5,13,185,198
"NANGARHAR","JALALABAD",601020,4,8,92,100
"NANGARHAR","JALALABAD",601020,5,6,92,98
"NANGARHAR","JALALABAD",601034,1,14,209,223
"NANGARHAR","JALALABAD",601003,3,61,533,594
"NANGARHAR","JALALABAD",601015,6,7,223,230
"NANGARHAR","JALALABAD",601012,1,38,281,319
"NANGARHAR","JALALABAD",601016,3,15,430,445
"NANGARHAR","JALALABAD",601014,2,20,264,284
"NANGARHAR","JALALABAD",601014,3,13,302,315
"NANGARHAR","JALALABAD",601014,4,7,302,309
"NANGARHAR","JALALABAD",601033,3,7,334,341
"NANGARHAR","JALALABAD",601033,4,11,288,299
"NANGARHAR","JALALABAD",601010,3,3,22,25
"NANGARHAR","JALALABAD",601033,2,7,490,497
"NANGARHAR","JALALABAD",601013,5,74,234,308
"NANGARHAR","JALALABAD",601014,1,15,391,406
"NANGARHAR","JALALABAD",601033,5,11,434,445
"NANGARHAR","JALALABAD",601029,1,35,242,277
"NANGARHAR","JALALABAD",601010,4,4,39,43
"NANGARHAR","JALALABAD",601025,8,27,87,114
"NANGARHAR","JALALABAD",601007,1,2,351,353
"NANGARHAR","JALALABAD",601016,1,39,529,568
"NANGARHAR","JALALABAD",601019,4,9,168,177
"NANGARHAR","JALALABAD",601010,7,4,66,70
"NANGARHAR","JALALABAD",601032,3,7,229,236
"NANGARHAR","JALALABAD",601032,4,3,335,338
"NANGARHAR","JALALABAD",601003,2,57,535,592
"NANGARHAR","JALALABAD",601027,4,20,75,95
"NANGARHAR","JALALABAD",601010,8,2,86,88
"NANGARHAR","JALALABAD",601015,5,7,305,312
"NANGARHAR","JALALABAD",601015,4,3,437,440
"NANGARHAR","JALALABAD",601013,2,22,414,436
"NANGARHAR","JALALABAD",601027,5,7,112,119
"NANGARHAR","JALALABAD",601003,1,47,532,579
"NANGARHAR","JALALABAD",601011,6,3,153,156
"NANGARHAR","JALALABAD",601011,8,0,88,88
"NANGARHAR","JALALABAD",601013,3,60,450,510
"NANGARHAR","JALALABAD",601016,2,14,383,397
"NANGARHAR","JALALABAD",601015,3,11,335,346
"NANGARHAR","JALALABAD",601011,7,9,90,99
"NANGARHAR","JALALABAD",601010,5,7,70,77
"NANGARHAR","JALALABAD",601013,4,200,195,395
"NANGARHAR","JALALABAD",601019,3,12,258,270
"NANGARHAR","JALALABAD",601015,2,3,375,378
"NANGARHAR","JALALABAD",601010,6,0,69,69
"NANGARHAR","JALALABAD",601027,3,11,59,70
"NANGARHAR","JALALABAD",601027,2,8,135,143
"NANGARHAR","BEHSUD",602057,5,5,61,66
"NANGARHAR","BEHSUD",602057,3,25,232,257
"NANGARHAR","BEHSUD",602509,3,28,135,163
"NANGARHAR","BEHSUD",602057,4,31,177,208
"NANGARHAR","BEHSUD",602045,3,25,271,296
"NANGARHAR","BEHSUD",602073,5,28,61,89
"NANGARHAR","BEHSUD",602509,2,40,225,265
"NANGARHAR","BEHSUD",602509,1,40,207,247
"NANGARHAR","BEHSUD",602057,2,36,370,406
"NANGARHAR","BEHSUD",602060,4,110,370,480
"NANGARHAR","BEHSUD",602049,1,31,115,146
"NANGARHAR","BEHSUD",602057,1,55,285,340
"NANGARHAR","BEHSUD",602073,4,52,533,585
"NANGARHAR","BEHSUD",602045,4,16,363,379
"NANGARHAR","BEHSUD",602056,1,49,389,438
"NANGARHAR","BEHSUD",602056,2,50,445,495
"NANGARHAR","BEHSUD",602057,6,20,95,115
"NANGARHAR","BEHSUD",602060,3,41,266,307
"NANGARHAR","BEHSUD",602045,1,15,322,337
"NANGARHAR","BEHSUD",602068,3,90,323,413
"NANGARHAR","BEHSUD",602073,3,93,401,494
"NANGARHAR","BEHSUD",602053,7,88,428,516
"NANGARHAR","BEHSUD",602053,3,24,185,209
"NANGARHAR","BEHSUD",602045,2,25,294,319
"NANGARHAR","BEHSUD",602062,5,19,315,334
"NANGARHAR","BEHSUD",602060,2,73,259,332
"NANGARHAR","BEHSUD",602061,2,9,384,393
"NANGARHAR","BEHSUD",602053,4,32,164,196
"NANGARHAR","BEHSUD",602073,2,92,367,459
"NANGARHAR","BEHSUD",602066,1,24,195,219
"NANGARHAR","BEHSUD",602053,2,50,394,444
"NANGARHAR","BEHSUD",602061,3,18,199,217
"NANGARHAR","BEHSUD",602053,6,46,450,496
"NANGARHAR","BEHSUD",602506,1,9,461,470
"NANGARHAR","BEHSUD",602066,2,8,163,171
"NANGARHAR","BEHSUD",602070,3,14,127,141
"NANGARHAR","BEHSUD",602070,4,32,200,232
"NANGARHAR","BEHSUD",602068,2,37,254,291
"NANGARHAR","BEHSUD",602053,1,52,493,545
"NANGARHAR","BEHSUD",602066,3,15,191,206
"NANGARHAR","BEHSUD",602066,4,13,147,160
"NANGARHAR","BEHSUD",602060,1,50,346,396
"NANGARHAR","BEHSUD",602062,3,13,482,495
"NANGARHAR","BEHSUD",602064,5,19,310,329
"NANGARHAR","BEHSUD",602059,4,18,201,219
"NANGARHAR","BEHSUD",602048,1,30,417,447
"NANGARHAR","BEHSUD",602045,5,17,171,188
"NANGARHAR","BEHSUD",602062,4,25,286,311
"NANGARHAR","BEHSUD",602069,1,74,491,565
"NANGARHAR","BEHSUD",602054,3,65,263,328
"NANGARHAR","BEHSUD",602070,2,22,112,134
"NANGARHAR","BEHSUD",602064,4,36,384,420
"NANGARHAR","BEHSUD",602059,3,9,40,49
"NANGARHAR","BEHSUD",602050,3,18,125,143
"NANGARHAR","BEHSUD",602050,4,16,218,234
"NANGARHAR","BEHSUD",602067,1,23,355,378
"NANGARHAR","BEHSUD",602053,5,36,308,344
"NANGARHAR","BEHSUD",602061,1,10,283,293
"NANGARHAR","BEHSUD",602067,4,34,333,367
"NANGARHAR","BEHSUD",602046,4,47,262,309
"NANGARHAR","BEHSUD",602045,6,4,406,410
"NANGARHAR","BEHSUD",602045,7,14,258,272
"NANGARHAR","BEHSUD",602506,3,52,543,595
"NANGARHAR","BEHSUD",602068,1,26,319,345
"NANGARHAR","BEHSUD",602048,6,48,241,289
"NANGARHAR","BEHSUD",602050,2,21,169,190
"NANGARHAR","BEHSUD",602058,3,19,122,141
"NANGARHAR","BEHSUD",602064,6,32,315,347
"NANGARHAR","BEHSUD",602064,7,22,400,422
"NANGARHAR","BEHSUD",602046,1,95,437,532
"NANGARHAR","BEHSUD",602046,2,40,313,353
"NANGARHAR","BEHSUD",602046,3,46,257,303
"NANGARHAR","BEHSUD",602069,2,46,461,507
"NANGARHAR","BEHSUD",602049,2,29,134,163
"NANGARHAR","BEHSUD",602049,3,37,154,191
"NANGARHAR","BEHSUD",602054,1,78,448,526
"NANGARHAR","BEHSUD",602054,2,81,453,534
"NANGARHAR","BEHSUD",602073,1,136,458,594
"NANGARHAR","BEHSUD",602064,3,59,477,536
"NANGARHAR","BEHSUD",602064,2,45,533,578
"NANGARHAR","BEHSUD",602059,1,9,31,40
"NANGARHAR","BEHSUD",602062,2,36,464,500
"NANGARHAR","BEHSUD",602072,6,9,516,525
"NANGARHAR","BEHSUD",602072,7,10,485,495
"NANGARHAR","BEHSUD",602067,3,33,413,446
"NANGARHAR","BEHSUD",602064,1,64,510,574
"NANGARHAR","BEHSUD",602069,3,19,358,377
"NANGARHAR","BEHSUD",602048,2,11,256,267
"NANGARHAR","BEHSUD",602506,2,17,451,468
"NANGARHAR","BEHSUD",602051,3,21,128,149
"NANGARHAR","BEHSUD",602048,5,53,250,303
"NANGARHAR","BEHSUD",602059,2,32,136,168
"NANGARHAR","BEHSUD",602058,2,0,33,33
"NANGARHAR","BEHSUD",602048,3,24,312,336
"NANGARHAR","BEHSUD",602062,1,29,566,595
"NANGARHAR","BEHSUD",602072,5,8,196,204
"NANGARHAR","BEHSUD",602067,2,20,434,454
"NANGARHAR","BEHSUD",602061,7,17,278,295
"NANGARHAR","BEHSUD",602048,4,26,426,452
"NANGARHAR","BEHSUD",602061,6,27,324,351
"NANGARHAR","BEHSUD",602056,3,31,242,273
"NANGARHAR","BEHSUD",602072,2,27,305,332
"NANGARHAR","BEHSUD",602051,2,46,209,255
"NANGARHAR","BEHSUD",602072,3,27,505,532
"NANGARHAR","BEHSUD",602050,1,21,191,212
"NANGARHAR","BEHSUD",602070,1,40,354,394
"NANGARHAR","BEHSUD",602061,4,19,380,399
"NANGARHAR","BEHSUD",602049,4,27,216,243
"NANGARHAR","BEHSUD",602072,4,8,344,352
"NANGARHAR","BEHSUD",602066,6,10,205,215
"NANGARHAR","BEHSUD",602058,1,14,158,172
"NANGARHAR","BEHSUD",602056,6,30,409,439
"NANGARHAR","BEHSUD",602056,5,20,419,439
"NANGARHAR","BEHSUD",602069,5,55,539,594
"NANGARHAR","BEHSUD",602072,1,12,238,250
"NANGARHAR","BEHSUD",602056,4,31,193,224
"NANGARHAR","BEHSUD",602051,1,36,263,299
"NANGARHAR","BEHSUD",602069,6,35,559,594
"NANGARHAR","BEHSUD",602069,4,36,379,415
"NANGARHAR","BEHSUD",602066,5,14,114,128
"NANGARHAR","BEHSUD",602061,5,3,167,170
"NANGARHAR","SURKH RUD",603098,1,36,481,517
"NANGARHAR","SURKH RUD",603096,2,30,475,505
"NANGARHAR","SURKH RUD",603096,3,28,401,429
"NANGARHAR","SURKH RUD",603085,3,24,283,307
"NANGARHAR","SURKH RUD",603080,1,7,220,227
"NANGARHAR","SURKH RUD",603077,1,51,420,471
"NANGARHAR","SURKH RUD",603096,1,41,430,471
"NANGARHAR","SURKH RUD",603078,4,70,479,549
"NANGARHAR","SURKH RUD",603079,3,20,245,265
"NANGARHAR","SURKH RUD",603085,1,174,228,402
"NANGARHAR","SURKH RUD",603085,2,60,165,225
"NANGARHAR","SURKH RUD",603076,3,21,210,231
"NANGARHAR","SURKH RUD",603082,3,41,548,589
"NANGARHAR","SURKH RUD",603080,2,14,300,314
"NANGARHAR","SURKH RUD",603080,3,4,171,175
"NANGARHAR","SURKH RUD",603087,4,37,446,483
"NANGARHAR","SURKH RUD",603079,2,20,565,585
"NANGARHAR","SURKH RUD",603082,4,31,552,583
"NANGARHAR","SURKH RUD",603082,5,18,179,197
"NANGARHAR","SURKH RUD",603079,1,20,559,579
"NANGARHAR","SURKH RUD",603078,3,54,540,594
"NANGARHAR","SURKH RUD",603097,1,23,571,594
"NANGARHAR","SURKH RUD",603101,1,9,546,555
"NANGARHAR","SURKH RUD",603082,2,44,544,588
"NANGARHAR","SURKH RUD",603083,5,59,451,510
"NANGARHAR","SURKH RUD",603083,2,48,341,389
"NANGARHAR","SURKH RUD",603083,3,47,330,377
"NANGARHAR","SURKH RUD",603083,4,43,373,416
"NANGARHAR","SURKH RUD",603084,2,30,180,210
"NANGARHAR","SURKH RUD",603076,2,9,120,129
"NANGARHAR","SURKH RUD",603088,3,15,585,600
"NANGARHAR","SURKH RUD",603097,2,17,449,466
"NANGARHAR","SURKH RUD",603078,2,40,321,361
"NANGARHAR","SURKH RUD",603091,5,12,218,230
"NANGARHAR","SURKH RUD",603090,1,0,223,223
"NANGARHAR","SURKH RUD",603094,5,3,202,205
"NANGARHAR","SURKH RUD",603075,1,97,220,317
"NANGARHAR","SURKH RUD",603076,1,3,55,58
"NANGARHAR","SURKH RUD",603088,2,20,287,307
"NANGARHAR","SURKH RUD",603090,2,0,240,240
"NANGARHAR","SURKH RUD",603093,1,22,555,577
"NANGARHAR","SURKH RUD",603081,2,16,217,233
"NANGARHAR","SURKH RUD",603094,1,8,461,469
"NANGARHAR","SURKH RUD",603091,4,9,240,249
"NANGARHAR","SURKH RUD",603081,1,9,281,290
"NANGARHAR","SURKH RUD",603086,2,14,189,203
"NANGARHAR","SURKH RUD",603087,3,27,305,332
"NANGARHAR","SURKH RUD",603075,2,15,371,386
"NANGARHAR","SURKH RUD",603086,1,83,156,239
"NANGARHAR","SURKH RUD",603094,2,21,555,576
"NANGARHAR","SURKH RUD",603088,1,6,285,291
"NANGARHAR","SURKH RUD",603098,2,50,192,242
"NANGARHAR","SURKH RUD",603084,1,50,279,329
"NANGARHAR","SURKH RUD",603091,3,23,574,597
"NANGARHAR","SURKH RUD",603094,3,3,573,576
"NANGARHAR","SURKH RUD",603078,1,46,539,585
"NANGARHAR","SURKH RUD",603087,2,79,448,527
"NANGARHAR","SURKH RUD",603101,2,2,53,55
"NANGARHAR","SURKH RUD",603093,7,2,114,116
"NANGARHAR","SURKH RUD",603510,1,13,281,294
"NANGARHAR","SURKH RUD",603093,2,26,434,460
"NANGARHAR","SURKH RUD",603510,3,11,144,155
"NANGARHAR","SURKH RUD",603101,3,0,424,424
"NANGARHAR","SURKH RUD",603093,6,0,76,76
"NANGARHAR","SURKH RUD",603082,1,32,561,593
"NANGARHAR","SURKH RUD",603510,2,12,257,269
"NANGARHAR","SURKH RUD",603083,1,64,336,400
"NANGARHAR","SURKH RUD",603077,3,91,274,365
"NANGARHAR","SURKH RUD",603091,1,32,555,587
"NANGARHAR","SURKH RUD",603089,1,10,205,215
"NANGARHAR","SURKH RUD",603077,2,11,75,86
"NANGARHAR","SURKH RUD",603089,3,36,160,196
"NANGARHAR","SURKH RUD",603074,2,14,582,596
"NANGARHAR","SURKH RUD",603093,3,15,324,339
"NANGARHAR","SURKH RUD",603094,4,2,255,257
"NANGARHAR","SURKH RUD",603074,1,63,457,520
"NANGARHAR","SURKH RUD",603089,2,2,199,201
"NANGARHAR","SURKH RUD",603093,5,6,230,236
"NANGARHAR","SURKH RUD",603091,2,49,535,584
"NANGARHAR","SURKH RUD",603087,1,65,520,585
"NANGARHAR","SURKH RUD",603093,4,11,152,163
"NANGARHAR","SURKH RUD",603074,3,1,21,22
"NANGARHAR","CHAPARHAR",604118,2,112,470,582
"NANGARHAR","CHAPARHAR",604117,1,8,581,589
"NANGARHAR","CHAPARHAR",604118,1,16,578,594
"NANGARHAR","CHAPARHAR",604116,2,250,324,574
"NANGARHAR","CHAPARHAR",604116,1,88,500,588
"NANGARHAR","CHAPARHAR",604103,2,0,22,22
"NANGARHAR","CHAPARHAR",604116,3,250,350,600
"NANGARHAR","CHAPARHAR",604121,1,369,164,533
"NANGARHAR","CHAPARHAR",604122,1,100,500,600
"NANGARHAR","CHAPARHAR",604104,1,91,497,588
"NANGARHAR","CHAPARHAR",604120,1,294,306,600
"NANGARHAR","CHAPARHAR",604126,3,400,200,600
"NANGARHAR","CHAPARHAR",604111,2,200,382,582
"NANGARHAR","CHAPARHAR",604117,2,275,225,500
"NANGARHAR","CHAPARHAR",604122,2,39,527,566
"NANGARHAR","CHAPARHAR",604111,1,106,494,600
"NANGARHAR","CHAPARHAR",604126,1,350,250,600
"NANGARHAR","CHAPARHAR",604123,2,53,545,598
"NANGARHAR","CHAPARHAR",604107,1,51,515,566
"NANGARHAR","CHAPARHAR",604103,1,95,416,511
"NANGARHAR","CHAPARHAR",604120,2,248,352,600
"NANGARHAR","CHAPARHAR",604126,2,300,300,600
"NANGARHAR","CHAPARHAR",604104,2,159,394,553
"NANGARHAR","CHAPARHAR",604112,3,310,290,600
"NANGARHAR","CHAPARHAR",604107,2,87,494,581
"NANGARHAR","CHAPARHAR",604106,2,100,500,600
"NANGARHAR","CHAPARHAR",604123,1,174,420,594
"NANGARHAR","CHAPARHAR",604105,2,382,218,600
"NANGARHAR","CHAPARHAR",604112,1,150,450,600
"NANGARHAR","CHAPARHAR",604112,2,350,250,600
"NANGARHAR","CHAPARHAR",604105,1,299,300,599
"NANGARHAR","CHAPARHAR",604106,1,82,486,568
"NANGARHAR","CHAPARHAR",604108,2,365,235,600
"NANGARHAR","CHAPARHAR",604108,1,335,265,600
"NANGARHAR","KAMA",605154,1,9,182,191
"NANGARHAR","KAMA",605184,3,26,84,110
"NANGARHAR","KAMA",605154,2,4,134,138
"NANGARHAR","KAMA",605164,2,39,150,189
"NANGARHAR","KAMA",605176,3,4,210,214
"NANGARHAR","KAMA",605179,1,17,194,211
"NANGARHAR","KAMA",605161,1,37,380,417
"NANGARHAR","KAMA",605160,3,7,180,187
"NANGARHAR","KAMA",605167,2,10,61,71
"NANGARHAR","KAMA",605184,2,19,127,146
"NANGARHAR","KAMA",605154,3,7,275,282
"NANGARHAR","KAMA",605512,1,22,284,306
"NANGARHAR","KAMA",605511,1,20,95,115
"NANGARHAR","KAMA",605179,2,28,92,120
"NANGARHAR","KAMA",605511,3,5,107,112
"NANGARHAR","KAMA",605183,2,17,443,460
"NANGARHAR","KAMA",605512,2,30,443,473
"NANGARHAR","KAMA",605511,2,49,101,150
"NANGARHAR","KAMA",605157,3,10,82,92
"NANGARHAR","KAMA",605176,1,7,114,121
"NANGARHAR","KAMA",605164,1,113,96,209
"NANGARHAR","KAMA",605167,1,9,116,125
"NANGARHAR","KAMA",605172,2,11,208,219
"NANGARHAR","KAMA",605163,1,148,169,317
"NANGARHAR","KAMA",605163,2,151,185,336
"NANGARHAR","KAMA",605166,2,15,97,112
"NANGARHAR","KAMA",605166,3,17,143,160
"NANGARHAR","KAMA",605149,1,64,429,493
"NANGARHAR","KAMA",605157,4,14,62,76
"NANGARHAR","KAMA",605157,1,23,173,196
"NANGARHAR","KAMA",605151,2,100,391,491
"NANGARHAR","KAMA",605514,1,38,187,225
"NANGARHAR","KAMA",605514,2,49,190,239
"NANGARHAR","KAMA",605176,2,10,118,128
"NANGARHAR","KAMA",605158,1,27,250,277
"NANGARHAR","KAMA",605158,2,154,434,588
"NANGARHAR","KAMA",605158,3,131,468,599
"NANGARHAR","KAMA",605160,1,30,195,225
"NANGARHAR","KAMA",605184,1,92,418,510
"NANGARHAR","KAMA",605173,3,120,370,490
"NANGARHAR","KAMA",605157,2,45,168,213
"NANGARHAR","KAMA",605149,2,39,425,464
"NANGARHAR","KAMA",605155,1,35,99,134
"NANGARHAR","KAMA",605162,2,17,138,155
"NANGARHAR","KAMA",605172,1,13,223,236
"NANGARHAR","KAMA",605178,2,9,232,241
"NANGARHAR","KAMA",605178,1,35,230,265
"NANGARHAR","KAMA",605514,3,92,250,342
"NANGARHAR","KAMA",605177,2,56,381,437
"NANGARHAR","KAMA",605181,1,56,349,405
"NANGARHAR","KAMA",605181,2,22,327,349
"NANGARHAR","KAMA",605151,1,72,450,522
"NANGARHAR","KAMA",605160,2,14,116,130
"NANGARHAR","KAMA",605155,2,60,133,193
"NANGARHAR","KAMA",605155,3,41,106,147
"NANGARHAR","KAMA",605183,1,45,372,417
"NANGARHAR","KAMA",605513,3,24,185,209
"NANGARHAR","KAMA",605166,1,21,124,145
"NANGARHAR","KAMA",605185,3,6,309,315
"NANGARHAR","KAMA",605180,2,13,59,72
"NANGARHAR","KAMA",605152,2,108,305,413
"NANGARHAR","KAMA",605168,1,13,217,230
"NANGARHAR","KAMA",605168,2,8,61,69
"NANGARHAR","KAMA",605173,1,66,271,337
"NANGARHAR","KAMA",605173,2,149,250,399
"NANGARHAR","KAMA",605156,1,123,474,597
"NANGARHAR","KAMA",605156,2,146,447,593
"NANGARHAR","KAMA",605182,1,70,329,399
"NANGARHAR","KAMA",605170,1,12,98,110
"NANGARHAR","KAMA",605165,2,213,188,401
"NANGARHAR","KAMA",605149,3,49,378,427
"NANGARHAR","KAMA",605185,2,1,217,218
"NANGARHAR","KAMA",605182,2,29,450,479
"NANGARHAR","KAMA",605174,1,14,125,139
"NANGARHAR","KAMA",605174,2,25,175,200
"NANGARHAR","KAMA",605161,2,27,280,307
"NANGARHAR","KAMA",605185,1,8,206,214
"NANGARHAR","KAMA",605175,3,7,76,83
"NANGARHAR","KAMA",605150,2,31,353,384
"NANGARHAR","KAMA",605177,1,35,342,377
"NANGARHAR","KAMA",605162,3,57,245,302
"NANGARHAR","KAMA",605150,1,12,321,333
"NANGARHAR","KAMA",605170,3,13,96,109
"NANGARHAR","KAMA",605159,2,185,389,574
"NANGARHAR","KAMA",605180,1,9,66,75
"NANGARHAR","KAMA",605175,4,8,78,86
"NANGARHAR","KAMA",605175,2,14,28,42
"NANGARHAR","KAMA",605169,1,61,238,299
"NANGARHAR","KAMA",605153,1,29,268,297
"NANGARHAR","KAMA",605170,2,16,105,121
"NANGARHAR","KAMA",605513,2,39,253,292
"NANGARHAR","KAMA",605512,3,9,400,409
"NANGARHAR","KAMA",605152,1,55,388,443
"NANGARHAR","KAMA",605159,1,108,369,477
"NANGARHAR","KAMA",605175,1,2,40,42
"NANGARHAR","KAMA",605165,1,69,133,202
"NANGARHAR","KAMA",605169,2,36,66,102
"NANGARHAR","KAMA",605162,1,17,182,199
"NANGARHAR","KAMA",605171,1,13,180,193
"NANGARHAR","KAMA",605171,2,11,188,199
"NANGARHAR","KAMA",605161,3,69,495,564
"NANGARHAR","KAMA",605153,2,37,230,267
"NANGARHAR","KAMA",605513,1,29,229,258
"NANGARHAR","KUZ KUNAR",606210,1,61,153,214
"NANGARHAR","KUZ KUNAR",606187,1,120,21,141
"NANGARHAR","KUZ KUNAR",606213,1,179,417,596
"NANGARHAR","KUZ KUNAR",606197,1,472,122,594
"NANGARHAR","KUZ KUNAR",606197,2,400,200,600
"NANGARHAR","KUZ KUNAR",606210,2,8,288,296
"NANGARHAR","KUZ KUNAR",606196,4,461,139,600
"NANGARHAR","KUZ KUNAR",606214,1,107,369,476
"NANGARHAR","KUZ KUNAR",606213,2,129,467,596
"NANGARHAR","KUZ KUNAR",606187,2,33,124,157
"NANGARHAR","KUZ KUNAR",606201,2,64,161,225
"NANGARHAR","KUZ KUNAR",606515,3,459,135,594
"NANGARHAR","KUZ KUNAR",606188,1,238,261,499
"NANGARHAR","KUZ KUNAR",606212,2,30,123,153
"NANGARHAR","KUZ KUNAR",606209,2,100,196,296
"NANGARHAR","KUZ KUNAR",606208,2,432,48,480
"NANGARHAR","KUZ KUNAR",606191,2,48,263,311
"NANGARHAR","KUZ KUNAR",606201,1,121,239,360
"NANGARHAR","KUZ KUNAR",606212,1,19,132,151
"NANGARHAR","KUZ KUNAR",606186,1,487,112,599
"NANGARHAR","KUZ KUNAR",606194,1,158,437,595
"NANGARHAR","KUZ KUNAR",606188,3,45,299,344
"NANGARHAR","KUZ KUNAR",606206,2,379,150,529
"NANGARHAR","KUZ KUNAR",606515,2,552,38,590
"NANGARHAR","KUZ KUNAR",606190,3,63,269,332
"NANGARHAR","KUZ KUNAR",606189,1,419,178,597
"NANGARHAR","KUZ KUNAR",606194,2,115,454,569
"NANGARHAR","KUZ KUNAR",606196,3,387,197,584
"NANGARHAR","KUZ KUNAR",606191,1,49,325,374
"NANGARHAR","KUZ KUNAR",606211,2,36,189,225
"NANGARHAR","KUZ KUNAR",606188,2,217,376,593
"NANGARHAR","KUZ KUNAR",606192,2,16,178,194
"NANGARHAR","KUZ KUNAR",606197,3,444,153,597
"NANGARHAR","KUZ KUNAR",606193,1,57,111,168
"NANGARHAR","KUZ KUNAR",606192,1,45,129,174
"NANGARHAR","KUZ KUNAR",606203,3,36,103,139
"NANGARHAR","KUZ KUNAR",606515,1,526,62,588
"NANGARHAR","KUZ KUNAR",606204,1,50,542,592
"NANGARHAR","KUZ KUNAR",606204,2,83,507,590
"NANGARHAR","KUZ KUNAR",606189,2,297,292,589
"NANGARHAR","KUZ KUNAR",606208,1,305,271,576
"NANGARHAR","KUZ KUNAR",606211,1,38,311,349
"NANGARHAR","KUZ KUNAR",606202,2,59,61,120
"NANGARHAR","KUZ KUNAR",606205,2,19,57,76
"NANGARHAR","KUZ KUNAR",606214,2,18,114,132
"NANGARHAR","KUZ KUNAR",606206,1,387,201,588
"NANGARHAR","KUZ KUNAR",606192,3,20,94,114
"NANGARHAR","KUZ KUNAR",606203,1,33,90,123
"NANGARHAR","KUZ KUNAR",606203,2,48,62,110
"NANGARHAR","KUZ KUNAR",606193,2,52,84,136
"NANGARHAR","KUZ KUNAR",606209,1,184,258,442
"NANGARHAR","KUZ KUNAR",606190,2,67,241,308
"NANGARHAR","KUZ KUNAR",606204,3,27,524,551
"NANGARHAR","KUZ KUNAR",606207,2,335,155,490
"NANGARHAR","KUZ KUNAR",606196,2,468,130,598
"NANGARHAR","KUZ KUNAR",606202,1,28,33,61
"NANGARHAR","KUZ KUNAR",606186,3,433,122,555
"NANGARHAR","KUZ KUNAR",606190,1,95,227,322
"NANGARHAR","KUZ KUNAR",606195,1,142,333,475
"NANGARHAR","KUZ KUNAR",606201,3,216,170,386
"NANGARHAR","KUZ KUNAR",606207,1,395,189,584
"NANGARHAR","KUZ KUNAR",606193,3,73,138,211
"NANGARHAR","KUZ KUNAR",606196,1,480,114,594
"NANGARHAR","KUZ KUNAR",606186,2,410,169,579
"NANGARHAR","KUZ KUNAR",606205,1,22,50,72
"NANGARHAR","KUZ KUNAR",606195,2,337,230,567
"NANGARHAR","RODAT",607148,4,9,584,593
"NANGARHAR","RODAT",607144,2,72,138,210
"NANGARHAR","RODAT",607134,1,12,572,584
"NANGARHAR","RODAT",607140,2,0,21,21
"NANGARHAR","RODAT",607138,2,92,501,593
"NANGARHAR","RODAT",607138,1,129,428,557
"NANGARHAR","RODAT",607140,1,0,10,10
"NANGARHAR","RODAT",607148,3,26,209,235
"NANGARHAR","RODAT",607148,5,26,570,596
"NANGARHAR","RODAT",607143,2,3,248,251
"NANGARHAR","RODAT",607144,1,2,144,146
"NANGARHAR","RODAT",607145,2,39,311,350
"NANGARHAR","RODAT",607143,1,17,151,168
"NANGARHAR","RODAT",607128,2,8,557,565
"NANGARHAR","RODAT",607129,2,97,3,100
"NANGARHAR","RODAT",607145,1,74,163,237
"NANGARHAR","RODAT",607128,1,13,581,594
"NANGARHAR","RODAT",607129,1,105,0,105
"NANGARHAR","RODAT",607131,1,42,556,598
"NANGARHAR","RODAT",607128,3,7,451,458
"NANGARHAR","RODAT",607139,2,32,85,117
"NANGARHAR","RODAT",607129,4,0,100,100
"NANGARHAR","RODAT",607139,1,15,67,82
"NANGARHAR","RODAT",607142,2,2,185,187
"NANGARHAR","RODAT",607129,3,4,85,89
"NANGARHAR","RODAT",607135,3,212,59,271
"NANGARHAR","RODAT",607141,3,9,167,176
"NANGARHAR","RODAT",607142,1,40,290,330
"NANGARHAR","RODAT",607141,1,37,467,504
"NANGARHAR","RODAT",607141,2,21,555,576
"NANGARHAR","RODAT",607148,1,53,415,468
"NANGARHAR","RODAT",607133,1,127,161,288
"NANGARHAR","RODAT",607130,2,18,577,595
"NANGARHAR","RODAT",607148,2,32,276,308
"NANGARHAR","RODAT",607133,3,11,113,124
"NANGARHAR","RODAT",607135,2,16,580,596
"NANGARHAR","RODAT",607146,2,65,533,598
"NANGARHAR","RODAT",607130,1,25,568,593
"NANGARHAR","RODAT",607134,3,0,597,597
"NANGARHAR","RODAT",607135,1,72,525,597
"NANGARHAR","RODAT",607138,3,169,424,593
"NANGARHAR","RODAT",607134,2,39,545,584
"NANGARHAR","RODAT",607131,2,8,587,595
"NANGARHAR","RODAT",607128,4,7,582,589
"NANGARHAR","RODAT",607146,1,39,557,596
"NANGARHAR","RODAT",607132,2,35,555,590
"NANGARHAR","RODAT",607128,5,38,247,285
"NANGARHAR","RODAT",607133,2,137,145,282
"NANGARHAR","RODAT",607131,4,21,576,597
"NANGARHAR","RODAT",607131,3,46,551,597
"NANGARHAR","RODAT",607132,1,6,590,596
"NANGARHAR","KHUGYANI",608291,1,9,86,95
"NANGARHAR","KHUGYANI",608278,3,165,431,596
"NANGARHAR","KHUGYANI",608277,2,21,579,600
"NANGARHAR","KHUGYANI",608278,2,237,348,585
"NANGARHAR","KHUGYANI",608291,2,4,99,103
"NANGARHAR","KHUGYANI",608282,1,34,192,226
"NANGARHAR","KHUGYANI",608277,1,104,484,588
"NANGARHAR","KHUGYANI",608276,1,158,442,600
"NANGARHAR","KHUGYANI",608285,1,2,598,600
"NANGARHAR","KHUGYANI",608288,1,200,397,597
"NANGARHAR","KHUGYANI",608288,2,219,381,600
"NANGARHAR","KHUGYANI",608288,3,485,112,597
"NANGARHAR","KHUGYANI",608516,1,17,348,365
"NANGARHAR","KHUGYANI",608276,2,2,598,600
"NANGARHAR","KHUGYANI",608291,3,0,97,97
"NANGARHAR","KHUGYANI",608291,4,11,126,137
"NANGARHAR","KHUGYANI",608278,1,161,422,583
"NANGARHAR","KHUGYANI",608285,3,5,595,600
"NANGARHAR","KHUGYANI",608284,3,29,115,144
"NANGARHAR","KHUGYANI",608276,3,50,538,588
"NANGARHAR","KHUGYANI",608516,2,7,400,407
"NANGARHAR","KHUGYANI",608283,1,88,254,342
"NANGARHAR","KHUGYANI",608283,2,8,242,250
"NANGARHAR","KHUGYANI",608284,2,70,69,139
"NANGARHAR","KHUGYANI",608284,1,51,280,331
"NANGARHAR","KHUGYANI",608287,2,14,564,578
"NANGARHAR","KHUGYANI",608287,4,33,542,575
"NANGARHAR","KHUGYANI",608282,2,68,187,255
"NANGARHAR","KHUGYANI",608516,3,10,207,217
"NANGARHAR","KHUGYANI",608280,1,24,330,354
"NANGARHAR","KHUGYANI",608283,3,1,192,193
"NANGARHAR","KHUGYANI",608285,2,6,594,600
"NANGARHAR","KHUGYANI",608280,2,121,470,591
"NANGARHAR","KHUGYANI",608286,2,4,596,600
"NANGARHAR","KHUGYANI",608282,3,57,355,412
"NANGARHAR","KHUGYANI",608287,3,7,588,595
"NANGARHAR","KHUGYANI",608287,1,27,566,593
"NANGARHAR","KHUGYANI",608286,1,2,598,600
"NANGARHAR","BATI KOT",609442,3,6,587,593
"NANGARHAR","BATI KOT",609451,2,84,473,557
"NANGARHAR","BATI KOT",609442,2,12,587,599
"NANGARHAR","BATI KOT",609461,1,24,572,596
"NANGARHAR","BATI KOT",609438,5,17,404,421
"NANGARHAR","BATI KOT",609457,1,28,233,261
"NANGARHAR","BATI KOT",609457,3,1,0,1
"NANGARHAR","BATI KOT",609451,1,176,421,597
"NANGARHAR","BATI KOT",609438,4,138,243,381
"NANGARHAR","BATI KOT",609460,2,67,28,95
"NANGARHAR","BATI KOT",609457,2,20,150,170
"NANGARHAR","BATI KOT",609452,3,60,69,129
"NANGARHAR","BATI KOT",609452,2,29,42,71
"NANGARHAR","BATI KOT",609461,2,33,566,599
"NANGARHAR","BATI KOT",609438,3,85,292,377
"NANGARHAR","BATI KOT",609442,1,32,561,593
"NANGARHAR","BATI KOT",609441,1,6,38,44
"NANGARHAR","BATI KOT",609460,1,12,44,56
"NANGARHAR","BATI KOT",609440,5,171,423,594
"NANGARHAR","BATI KOT",609438,6,98,97,195
"NANGARHAR","BATI KOT",609440,1,24,61,85
"NANGARHAR","BATI KOT",609452,1,23,127,150
"NANGARHAR","BATI KOT",609453,2,81,517,598
"NANGARHAR","BATI KOT",609455,2,80,177,257
"NANGARHAR","BATI KOT",609455,3,17,46,63
"NANGARHAR","BATI KOT",609453,3,108,486,594
"NANGARHAR","BATI KOT",609441,2,0,35,35
"NANGARHAR","BATI KOT",609455,1,79,280,359
"NANGARHAR","BATI KOT",609438,2,63,415,478
"NANGARHAR","BATI KOT",609449,3,6,194,200
"NANGARHAR","BATI KOT",609453,1,39,551,590
"NANGARHAR","BATI KOT",609440,4,179,419,598
"NANGARHAR","BATI KOT",609459,2,8,450,458
"NANGARHAR","BATI KOT",609449,2,92,407,499
"NANGARHAR","BATI KOT",609438,1,94,289,383
"NANGARHAR","BATI KOT",609440,2,9,85,94
"NANGARHAR","BATI KOT",609449,1,8,489,497
"NANGARHAR","BATI KOT",609440,3,9,63,72
"NANGARHAR","BATI KOT",609459,1,4,476,480
"NANGARHAR","DEH BALA",610327,1,2,44,46
"NANGARHAR","DEH BALA",610327,4,15,47,62
"NANGARHAR","DEH BALA",610327,3,2,33,35
"NANGARHAR","DEH BALA",610327,2,0,22,22
"NANGARHAR","PACHIR WAGA",611315,3,2,81,83
"NANGARHAR","PACHIR WAGA",611315,2,6,176,182
"NANGARHAR","PACHIR WAGA",611306,1,4,75,79
"NANGARHAR","PACHIR WAGA",611315,1,2,225,227
"NANGARHAR","PACHIR WAGA",611310,2,5,25,30
"NANGARHAR","PACHIR WAGA",611306,3,2,89,91
"NANGARHAR","PACHIR WAGA",611310,1,12,28,40
"NANGARHAR","PACHIR WAGA",611307,1,1,95,96
"NANGARHAR","PACHIR WAGA",611308,2,1,412,413
"NANGARHAR","PACHIR WAGA",611317,2,9,452,461
"NANGARHAR","PACHIR WAGA",611308,1,28,513,541
"NANGARHAR","PACHIR WAGA",611311,2,0,1,1
"NANGARHAR","PACHIR WAGA",611307,2,0,228,228
"NANGARHAR","PACHIR WAGA",611309,2,5,424,429
"NANGARHAR","PACHIR WAGA",611309,1,30,450,480
"NANGARHAR","PACHIR WAGA",611309,3,11,278,289
"NANGARHAR","PACHIR WAGA",611311,1,0,6,6
"NANGARHAR","PACHIR WAGA",611306,2,4,135,139
"NANGARHAR","PACHIR WAGA",611317,1,24,437,461
"NANGARHAR","PACHIR WAGA",611308,3,1,248,249
"NANGARHAR","DARAH-E-NOOR",612229,2,524,74,598
"NANGARHAR","DARAH-E-NOOR",612224,1,482,116,598
"NANGARHAR","DARAH-E-NOOR",612220,1,551,42,593
"NANGARHAR","DARAH-E-NOOR",612216,1,490,99,589
"NANGARHAR","DARAH-E-NOOR",612229,1,456,143,599
"NANGARHAR","DARAH-E-NOOR",612236,2,431,134,565
"NANGARHAR","DARAH-E-NOOR",612229,3,467,130,597
"NANGARHAR","DARAH-E-NOOR",612232,2,390,210,600
"NANGARHAR","DARAH-E-NOOR",612224,3,528,72,600
"NANGARHAR","DARAH-E-NOOR",612232,1,416,179,595
"NANGARHAR","DARAH-E-NOOR",612235,1,598,0,598
"NANGARHAR","DARAH-E-NOOR",612235,2,500,99,599
"NANGARHAR","DARAH-E-NOOR",612224,2,365,231,596
"NANGARHAR","DARAH-E-NOOR",612230,3,439,159,598
"NANGARHAR","DARAH-E-NOOR",612222,2,450,150,600
"NANGARHAR","DARAH-E-NOOR",612221,3,591,3,594
"NANGARHAR","DARAH-E-NOOR",612237,1,530,58,588
"NANGARHAR","DARAH-E-NOOR",612235,3,584,15,599
"NANGARHAR","DARAH-E-NOOR",612234,1,553,25,578
"NANGARHAR","DARAH-E-NOOR",612234,2,454,141,595
"NANGARHAR","DARAH-E-NOOR",612227,1,454,129,583
"NANGARHAR","DARAH-E-NOOR",612219,1,440,151,591
"NANGARHAR","DARAH-E-NOOR",612222,1,535,64,599
"NANGARHAR","DARAH-E-NOOR",612231,2,465,128,593
"NANGARHAR","DARAH-E-NOOR",612221,2,572,22,594
"NANGARHAR","DARAH-E-NOOR",612236,1,350,250,600
"NANGARHAR","DARAH-E-NOOR",612223,2,463,137,600
"NANGARHAR","DARAH-E-NOOR",612237,2,538,55,593
"NANGARHAR","DARAH-E-NOOR",612223,3,542,57,599
"NANGARHAR","DARAH-E-NOOR",612218,1,519,79,598
"NANGARHAR","DARAH-E-NOOR",612218,2,549,44,593
"NANGARHAR","DARAH-E-NOOR",612219,2,482,116,598
"NANGARHAR","DARAH-E-NOOR",612215,2,458,138,596
"NANGARHAR","DARAH-E-NOOR",612215,3,501,95,596
"NANGARHAR","DARAH-E-NOOR",612220,2,568,22,590
"NANGARHAR","DARAH-E-NOOR",612230,2,566,33,599
"NANGARHAR","DARAH-E-NOOR",612230,1,433,165,598
"NANGARHAR","DARAH-E-NOOR",612217,2,573,24,597
"NANGARHAR","DARAH-E-NOOR",612223,1,357,242,599
"NANGARHAR","DARAH-E-NOOR",612233,1,464,135,599
"NANGARHAR","DARAH-E-NOOR",612233,2,561,37,598
"NANGARHAR","DARAH-E-NOOR",612216,3,516,82,598
"NANGARHAR","DARAH-E-NOOR",612219,3,536,62,598
"NANGARHAR","DARAH-E-NOOR",612215,4,555,42,597
"NANGARHAR","DARAH-E-NOOR",612215,5,494,99,593
"NANGARHAR","DARAH-E-NOOR",612215,1,392,205,597
"NANGARHAR","DARAH-E-NOOR",612225,1,512,77,589
"NANGARHAR","DARAH-E-NOOR",612225,2,496,101,597
"NANGARHAR","DARAH-E-NOOR",612221,1,581,17,598
"NANGARHAR","DARAH-E-NOOR",612227,2,464,132,596
"NANGARHAR","DARAH-E-NOOR",612227,3,471,127,598
"NANGARHAR","DARAH-E-NOOR",612216,2,474,125,599
"NANGARHAR","DARAH-E-NOOR",612226,1,508,91,599
"NANGARHAR","DARAH-E-NOOR",612231,1,391,205,596
"NANGARHAR","DARAH-E-NOOR",612228,2,495,105,600
"NANGARHAR","DARAH-E-NOOR",612217,3,549,13,562
"NANGARHAR","DARAH-E-NOOR",612226,2,507,89,596
"NANGARHAR","DARAH-E-NOOR",612228,1,331,269,600
"NANGARHAR","DARAH-E-NOOR",612217,1,591,9,600
"NANGARHAR","KOT",613339,3,0,4,4
"NANGARHAR","KOT",613343,1,21,86,107
"NANGARHAR","KOT",613350,1,6,169,175
"NANGARHAR","KOT",613346,2,8,64,72
"NANGARHAR","KOT",613348,3,7,545,552
"NANGARHAR","KOT",613346,3,26,87,113
"NANGARHAR","KOT",613339,1,0,5,5
"NANGARHAR","KOT",613350,3,40,62,102
"NANGARHAR","KOT",613338,1,16,197,213
"NANGARHAR","KOT",613345,2,60,85,145
"NANGARHAR","KOT",613350,2,107,137,244
"NANGARHAR","KOT",613347,1,1,35,36
"NANGARHAR","KOT",613346,1,20,188,208
"NANGARHAR","KOT",613338,2,13,88,101
"NANGARHAR","KOT",613348,1,83,515,598
"NANGARHAR","KOT",613348,2,15,566,581
"NANGARHAR","KOT",613517,1,1,312,313
"NANGARHAR","KOT",613346,4,8,100,108
"NANGARHAR","KOT",613347,2,1,26,27
"NANGARHAR","KOT",613345,1,13,77,90
"NANGARHAR","KOT",613339,2,0,5,5
"NANGARHAR","KOT",613517,2,7,186,193
"NANGARHAR","KOT",613344,1,4,136,140
"NANGARHAR","KOT",613351,1,0,4,4
"NANGARHAR","KOT",613344,3,39,83,122
"NANGARHAR","KOT",613343,2,3,80,83
"NANGARHAR","KOT",613517,3,11,587,598
"NANGARHAR","KOT",613349,2,30,313,343
"NANGARHAR","KOT",613352,2,11,66,77
"NANGARHAR","KOT",613351,2,0,4,4
"NANGARHAR","KOT",613343,3,44,96,140
"NANGARHAR","KOT",613349,1,63,455,518
"NANGARHAR","KOT",613352,1,16,79,95
"NANGARHAR","KOT",613344,2,17,75,92
"NANGARHAR","KOT",613338,3,12,141,153
"NANGARHAR","GOSHTA",614485,2,182,413,595
"NANGARHAR","GOSHTA",614493,3,10,65,75
"NANGARHAR","GOSHTA",614493,2,9,50,59
"NANGARHAR","GOSHTA",614493,5,53,184,237
"NANGARHAR","GOSHTA",614493,1,34,64,98
"NANGARHAR","GOSHTA",614489,1,57,534,591
"NANGARHAR","GOSHTA",614485,1,105,492,597
"NANGARHAR","GOSHTA",614501,2,122,354,476
"NANGARHAR","GOSHTA",614495,2,397,81,478
"NANGARHAR","GOSHTA",614484,3,47,79,126
"NANGARHAR","GOSHTA",614484,4,3,4,7
"NANGARHAR","GOSHTA",614493,4,28,107,135
"NANGARHAR","GOSHTA",614490,2,68,281,349
"NANGARHAR","GOSHTA",614495,1,192,299,491
"NANGARHAR","GOSHTA",614490,1,73,248,321
"NANGARHAR","GOSHTA",614492,2,247,310,557
"NANGARHAR","GOSHTA",614486,1,80,229,309
"NANGARHAR","GOSHTA",614497,2,129,306,435
"NANGARHAR","GOSHTA",614486,2,92,219,311
"NANGARHAR","GOSHTA",614492,1,159,293,452
"NANGARHAR","GOSHTA",614501,1,78,234,312
"NANGARHAR","GOSHTA",614489,2,70,460,530
"NANGARHAR","GOSHTA",614484,2,24,20,44
"NANGARHAR","GOSHTA",614496,1,179,407,586
"NANGARHAR","GOSHTA",614518,2,20,55,75
"NANGARHAR","GOSHTA",614500,1,115,170,285
"NANGARHAR","GOSHTA",614498,1,154,443,597
"NANGARHAR","GOSHTA",614497,1,281,319,600
"NANGARHAR","GOSHTA",614491,2,150,108,258
"NANGARHAR","GOSHTA",614488,1,30,110,140
"NANGARHAR","GOSHTA",614484,1,20,27,47
"NANGARHAR","GOSHTA",614518,1,42,59,101
"NANGARHAR","GOSHTA",614491,1,65,137,202
"NANGARHAR","GOSHTA",614487,2,185,272,457
"NANGARHAR","GOSHTA",614488,2,27,44,71
"NANGARHAR","GOSHTA",614487,3,261,280,541
"NANGARHAR","GOSHTA",614499,1,168,432,600
"NANGARHAR","GOSHTA",614487,1,320,276,596
"NANGARHAR","GOSHTA",614498,2,91,496,587
"NANGARHAR","GOSHTA",614496,2,175,425,600
"NANGARHAR","GOSHTA",614499,2,234,366,600
"NANGARHAR","GOSHTA",614518,3,93,151,244
"NANGARHAR","ACHIN",615362,3,6,18,24
"NANGARHAR","ACHIN",615357,2,47,258,305
"NANGARHAR","ACHIN",615386,1,33,126,159
"NANGARHAR","ACHIN",615370,1,6,59,65
"NANGARHAR","ACHIN",615362,1,17,190,207
"NANGARHAR","ACHIN",615382,1,230,367,597
"NANGARHAR","ACHIN",615357,1,23,565,588
"NANGARHAR","ACHIN",615380,1,81,482,563
"NANGARHAR","ACHIN",615380,2,83,397,480
"NANGARHAR","ACHIN",615370,2,19,71,90
"NANGARHAR","ACHIN",615382,2,150,450,600
"NANGARHAR","ACHIN",615363,2,14,70,84
"NANGARHAR","ACHIN",615382,3,297,302,599
"NANGARHAR","ACHIN",615387,1,40,336,376
"NANGARHAR","ACHIN",615362,2,4,104,108
"NANGARHAR","ACHIN",615381,2,26,240,266
"NANGARHAR","ACHIN",615383,2,192,400,592
"NANGARHAR","ACHIN",615369,1,0,7,7
"NANGARHAR","ACHIN",615387,2,56,324,380
"NANGARHAR","ACHIN",615363,1,39,5,44
"NANGARHAR","ACHIN",615519,1,193,283,476
"NANGARHAR","ACHIN",615366,1,0,17,17
"NANGARHAR","ACHIN",615386,2,41,141,182
"NANGARHAR","ACHIN",615370,3,10,110,120
"NANGARHAR","ACHIN",615355,3,11,277,288
"NANGARHAR","ACHIN",615367,1,8,58,66
"NANGARHAR","ACHIN",615366,2,1,1,2
"NANGARHAR","ACHIN",615371,1,0,19,19
"NANGARHAR","ACHIN",615371,2,0,3,3
"NANGARHAR","ACHIN",615381,1,29,256,285
"NANGARHAR","ACHIN",615519,2,60,534,594
"NANGARHAR","ACHIN",615362,4,7,52,59
"NANGARHAR","ACHIN",615356,1,87,213,300
"NANGARHAR","ACHIN",615369,2,3,11,14
"NANGARHAR","ACHIN",615383,1,309,291,600
"NANGARHAR","ACHIN",615356,3,24,450,474
"NANGARHAR","ACHIN",615519,3,433,164,597
"NANGARHAR","ACHIN",615355,2,66,85,151
"NANGARHAR","ACHIN",615356,2,44,436,480
"NANGARHAR","ACHIN",615375,3,26,34,60
"NANGARHAR","ACHIN",615355,1,37,214,251
"NANGARHAR","ACHIN",615367,2,2,35,37
"NANGARHAR","ACHIN",615391,2,136,308,444
"NANGARHAR","ACHIN",615388,2,38,548,586
"NANGARHAR","ACHIN",615369,3,0,2,2
"NANGARHAR","ACHIN",615391,1,104,284,388
"NANGARHAR","ACHIN",615388,1,64,191,255
"NANGARHAR","ACHIN",615375,2,5,82,87
"NANGARHAR","ACHIN",615375,1,27,70,97
"NANGARHAR","SHINWAR",616422,1,2,2,4
"NANGARHAR","SHINWAR",616520,3,60,536,596
"NANGARHAR","SHINWAR",616430,3,4,150,154
"NANGARHAR","SHINWAR",616430,2,12,89,101
"NANGARHAR","SHINWAR",616430,1,14,67,81
"NANGARHAR","SHINWAR",616428,3,38,156,194
"NANGARHAR","SHINWAR",616437,1,4,12,16
"NANGARHAR","SHINWAR",616426,3,65,140,205
"NANGARHAR","SHINWAR",616437,2,1,8,9
"NANGARHAR","SHINWAR",616428,2,53,162,215
"NANGARHAR","SHINWAR",616420,1,46,163,209
"NANGARHAR","SHINWAR",616422,2,3,3,6
"NANGARHAR","SHINWAR",616424,1,23,213,236
"NANGARHAR","SHINWAR",616420,3,16,76,92
"NANGARHAR","SHINWAR",616520,1,61,537,598
"NANGARHAR","SHINWAR",616428,4,39,109,148
"NANGARHAR","SHINWAR",616428,5,22,33,55
"NANGARHAR","SHINWAR",616434,3,2,9,11
"NANGARHAR","SHINWAR",616434,4,2,15,17
"NANGARHAR","SHINWAR",616424,2,1,71,72
"NANGARHAR","SHINWAR",616426,2,1,16,17
"NANGARHAR","SHINWAR",616435,1,72,330,402
"NANGARHAR","SHINWAR",616420,2,27,73,100
"NANGARHAR","SHINWAR",616435,3,31,493,524
"NANGARHAR","SHINWAR",616520,2,47,551,598
"NANGARHAR","SHINWAR",616429,3,27,142,169
"NANGARHAR","SHINWAR",616429,2,115,129,244
"NANGARHAR","SHINWAR",616429,1,7,115,122
"NANGARHAR","SHINWAR",616423,1,9,88,97
"NANGARHAR","SHINWAR",616424,3,21,58,79
"NANGARHAR","SHINWAR",616436,3,14,117,131
"NANGARHAR","SHINWAR",616435,2,31,263,294
"NANGARHAR","SHINWAR",616436,1,2,195,197
"NANGARHAR","SHINWAR",616422,3,4,1,5
"NANGARHAR","SHINWAR",616425,3,20,140,160
"NANGARHAR","SHINWAR",616436,2,48,127,175
"NANGARHAR","SHINWAR",616421,1,23,138,161
"NANGARHAR","SHINWAR",616426,1,9,17,26
"NANGARHAR","SHINWAR",616425,2,17,142,159
"NANGARHAR","SHINWAR",616425,1,86,153,239
"NANGARHAR","SHINWAR",616428,1,151,165,316
"NANGARHAR","SHINWAR",616421,2,5,68,73
"NANGARHAR","SHINWAR",616423,3,8,61,69
"NANGARHAR","SHINWAR",616434,2,2,16,18
"NANGARHAR","SHINWAR",616423,2,4,73,77
"NANGARHAR","SHINWAR",616434,1,2,27,29
"NANGARHAR","SHINWAR",616437,4,1,24,25
"NANGARHAR","SHINWAR",616421,3,3,101,104
"NANGARHAR","SHINWAR",616437,3,0,11,11
"NANGARHAR","MUHMAND DARA",617470,1,365,232,597
"NANGARHAR","MUHMAND DARA",617464,2,13,42,55
"NANGARHAR","MUHMAND DARA",617464,1,36,346,382
"NANGARHAR","MUHMAND DARA",617477,1,43,420,463
"NANGARHAR","MUHMAND DARA",617470,2,361,215,576
"NANGARHAR","MUHMAND DARA",617465,2,36,22,58
"NANGARHAR","MUHMAND DARA",617467,4,62,191,253
"NANGARHAR","MUHMAND DARA",617465,1,57,54,111
"NANGARHAR","MUHMAND DARA",617483,3,11,54,65
"NANGARHAR","MUHMAND DARA",617470,3,395,202,597
"NANGARHAR","MUHMAND DARA",617467,3,23,410,433
"NANGARHAR","MUHMAND DARA",617476,1,18,119,137
"NANGARHAR","MUHMAND DARA",617476,2,25,138,163
"NANGARHAR","MUHMAND DARA",617477,2,4,298,302
"NANGARHAR","MUHMAND DARA",617465,3,35,32,67
"NANGARHAR","MUHMAND DARA",617462,4,9,583,592
"NANGARHAR","MUHMAND DARA",617483,2,14,80,94
"NANGARHAR","MUHMAND DARA",617482,1,7,582,589
"NANGARHAR","MUHMAND DARA",617483,4,2,2,4
"NANGARHAR","MUHMAND DARA",617483,5,2,1,3
"NANGARHAR","MUHMAND DARA",617472,2,276,317,593
"NANGARHAR","MUHMAND DARA",617472,3,284,273,557
"NANGARHAR","MUHMAND DARA",617483,1,21,84,105
"NANGARHAR","MUHMAND DARA",617467,2,35,335,370
"NANGARHAR","MUHMAND DARA",617463,2,63,35,98
"NANGARHAR","MUHMAND DARA",617474,6,50,14,64
"NANGARHAR","MUHMAND DARA",617463,3,35,149,184
"NANGARHAR","MUHMAND DARA",617482,2,36,556,592
"NANGARHAR","MUHMAND DARA",617478,1,81,259,340
"NANGARHAR","MUHMAND DARA",617472,1,313,275,588
"NANGARHAR","MUHMAND DARA",617478,2,39,128,167
"NANGARHAR","MUHMAND DARA",617462,2,82,518,600
"NANGARHAR","MUHMAND DARA",617462,3,51,543,594
"NANGARHAR","MUHMAND DARA",617469,4,67,431,498
"NANGARHAR","MUHMAND DARA",617468,5,131,84,215
"NANGARHAR","MUHMAND DARA",617468,3,33,165,198
"NANGARHAR","MUHMAND DARA",617463,4,28,27,55
"NANGARHAR","MUHMAND DARA",617475,1,58,335,393
"NANGARHAR","MUHMAND DARA",617475,2,31,287,318
"NANGARHAR","MUHMAND DARA",617469,3,23,247,270
"NANGARHAR","MUHMAND DARA",617462,1,27,569,596
"NANGARHAR","MUHMAND DARA",617463,1,35,114,149
"NANGARHAR","MUHMAND DARA",617474,5,44,47,91
"NANGARHAR","MUHMAND DARA",617472,4,335,208,543
"NANGARHAR","MUHMAND DARA",617469,2,19,369,388
"NANGARHAR","MUHMAND DARA",617464,3,12,51,63
"NANGARHAR","MUHMAND DARA",617474,4,44,50,94
"NANGARHAR","MUHMAND DARA",617468,4,47,96,143
"NANGARHAR","MUHMAND DARA",617467,1,70,153,223
"NANGARHAR","MUHMAND DARA",617468,1,28,247,275
"NANGARHAR","MUHMAND DARA",617474,2,71,472,543
"NANGARHAR","MUHMAND DARA",617464,4,7,91,98
"NANGARHAR","MUHMAND DARA",617474,3,66,48,114
"NANGARHAR","MUHMAND DARA",617469,1,82,208,290
"NANGARHAR","MUHMAND DARA",617474,1,30,562,592
"NANGARHAR","MUHMAND DARA",617468,2,19,249,268
"NANGARHAR","LALPOOR",618502,7,2,70,72
"NANGARHAR","LALPOOR",618502,6,5,53,58
"NANGARHAR","LALPOOR",618503,3,9,121,130
"NANGARHAR","LALPOOR",618502,1,8,80,88
"NANGARHAR","LALPOOR",618503,2,7,80,87
"NANGARHAR","LALPOOR",618504,1,19,118,137
"NANGARHAR","LALPOOR",618502,5,18,109,127
"NANGARHAR","LALPOOR",618502,2,9,146,155
"NANGARHAR","LALPOOR",618505,3,7,173,180
"NANGARHAR","LALPOOR",618502,4,26,191,217
"NANGARHAR","LALPOOR",618502,3,28,193,221
"NANGARHAR","LALPOOR",618503,4,12,178,190
"NANGARHAR","LALPOOR",618505,5,1,37,38
"NANGARHAR","LALPOOR",618503,1,9,117,126
"NANGARHAR","LALPOOR",618504,2,10,79,89
"NANGARHAR","LALPOOR",618504,4,13,69,82
"NANGARHAR","LALPOOR",618505,4,1,83,84
"NANGARHAR","LALPOOR",618505,2,6,95,101
"NANGARHAR","LALPOOR",618505,1,8,129,137
"NANGARHAR","LALPOOR",618503,5,4,65,69
"NANGARHAR","LALPOOR",618503,6,0,7,7
"NANGARHAR","LALPOOR",618504,3,37,128,165
"NANGARHAR","LALPOOR",618504,5,7,105,112
"NANGARHAR","SHER ZAD",619244,4,20,101,121
"NANGARHAR","SHER ZAD",619243,1,135,462,597
"NANGARHAR","SHER ZAD",619238,4,139,341,480
"NANGARHAR","SHER ZAD",619244,2,0,598,598
"NANGARHAR","SHER ZAD",619238,1,427,172,599
"NANGARHAR","SHER ZAD",619244,3,33,567,600
"NANGARHAR","SHER ZAD",619238,3,515,78,593
"NANGARHAR","SHER ZAD",619238,2,173,425,598
"NANGARHAR","SHER ZAD",619244,1,50,533,583
"NANGARHAR","SHER ZAD",619243,3,23,565,588
"NANGARHAR","SHER ZAD",619243,2,12,582,594
"NANGARHAR","NAZYAN",620408,2,40,299,339
"NANGARHAR","NAZYAN",620408,3,93,372,465
"NANGARHAR","NAZYAN",620409,1,39,520,559
"NANGARHAR","NAZYAN",620408,1,49,284,333
"NANGARHAR","NAZYAN",620409,3,0,358,358
"NANGARHAR","NAZYAN",620402,3,0,5,5
"NANGARHAR","NAZYAN",620400,2,7,163,170
"NANGARHAR","NAZYAN",620404,1,4,6,10
"NANGARHAR","NAZYAN",620400,1,29,136,165
"NANGARHAR","NAZYAN",620409,2,32,555,587
"NANGARHAR","NAZYAN",620403,1,2,34,36
"NANGARHAR","NAZYAN",620411,1,0,38,38
"NANGARHAR","NAZYAN",620410,1,13,412,425
"NANGARHAR","NAZYAN",620402,2,21,529,550
"NANGARHAR","NAZYAN",620403,3,9,586,595
"NANGARHAR","NAZYAN",620410,2,10,420,430
"NANGARHAR","NAZYAN",620402,1,48,496,544
"NANGARHAR","NAZYAN",620410,3,43,454,497
"NANGARHAR","NAZYAN",620400,3,47,96,143
"NANGARHAR","NAZYAN",620400,4,70,328,398
"NANGARHAR","HESARAK",621262,2,195,319,514
"NANGARHAR","HESARAK",621261,2,193,343,536
"NANGARHAR","HESARAK",621261,3,214,347,561
"NANGARHAR","HESARAK",621262,1,116,461,577
"NANGARHAR","HESARAK",621262,3,119,481,600
"NANGARHAR","HESARAK",621261,1,211,281,492
"NANGARHAR","DUR BABA",622416,2,227,373,600
"NANGARHAR","DUR BABA",622507,3,15,579,594
"NANGARHAR","DUR BABA",622416,3,63,535,598
"NANGARHAR","DUR BABA",622507,1,75,517,592
"NANGARHAR","DUR BABA",622507,2,45,550,595
"NANGARHAR","DUR BABA",622413,5,34,566,600
"NANGARHAR","DUR BABA",622416,1,97,496,593
"NANGARHAR","DUR BABA",622418,2,57,543,600
"NANGARHAR","DUR BABA",622418,3,21,579,600
"NANGARHAR","DUR BABA",622414,2,84,484,568
"NANGARHAR","DUR BABA",622413,4,247,351,598
"NANGARHAR","DUR BABA",622413,3,22,578,600
"NANGARHAR","DUR BABA",622413,2,147,453,600
"NANGARHAR","DUR BABA",622417,2,69,530,599
"NANGARHAR","DUR BABA",622412,1,11,589,600
"NANGARHAR","DUR BABA",622417,3,54,545,599
"NANGARHAR","DUR BABA",622418,1,22,578,600
"NANGARHAR","DUR BABA",622413,1,95,505,600
"NANGARHAR","DUR BABA",622414,1,34,565,599
"NANGARHAR","DUR BABA",622419,2,240,360,600
"NANGARHAR","DUR BABA",622414,3,70,523,593
"NANGARHAR","DUR BABA",622417,1,85,515,600
"NANGARHAR","DUR BABA",622415,1,29,571,600
"NANGARHAR","DUR BABA",622521,3,14,586,600
"NANGARHAR","DUR BABA",622412,2,56,542,598
"NANGARHAR","DUR BABA",622415,3,112,488,600
"NANGARHAR","DUR BABA",622415,2,73,527,600
"NANGARHAR","DUR BABA",622412,3,101,497,598
"NANGARHAR","DUR BABA",622419,1,268,330,598
"NANGARHAR","DUR BABA",622521,2,83,516,599
"NANGARHAR","DUR BABA",622521,1,79,520,599
"NANGARHAR","DUR BABA",622412,4,4,596,600
"LAGHMAN","MEHTARLAM",701001,12,15,580,595
"LAGHMAN","MEHTARLAM",701001,8,9,586,595
"LAGHMAN","MEHTARLAM",701001,11,20,578,598
"LAGHMAN","MEHTARLAM",701004,4,19,579,598
"LAGHMAN","MEHTARLAM",701001,10,7,584,591
"LAGHMAN","MEHTARLAM",701014,1,31,464,495
"LAGHMAN","MEHTARLAM",701001,1,47,541,588
"LAGHMAN","MEHTARLAM",701031,2,11,54,65
"LAGHMAN","MEHTARLAM",701018,3,5,593,598
"LAGHMAN","MEHTARLAM",701031,1,62,266,328
"LAGHMAN","MEHTARLAM",701024,1,4,531,535
"LAGHMAN","MEHTARLAM",701023,2,0,76,76
"LAGHMAN","MEHTARLAM",701022,1,26,330,356
"LAGHMAN","MEHTARLAM",701022,2,1,378,379
"LAGHMAN","MEHTARLAM",701023,1,37,260,297
"LAGHMAN","MEHTARLAM",701001,13,14,580,594
"LAGHMAN","MEHTARLAM",701032,1,133,457,590
"LAGHMAN","MEHTARLAM",701024,3,5,405,410
"LAGHMAN","MEHTARLAM",701032,2,42,341,383
"LAGHMAN","MEHTARLAM",701001,5,24,571,595
"LAGHMAN","MEHTARLAM",701004,5,39,477,516
"LAGHMAN","MEHTARLAM",701014,2,9,588,597
"LAGHMAN","MEHTARLAM",701026,4,8,591,599
"LAGHMAN","MEHTARLAM",701009,4,7,589,596
"LAGHMAN","MEHTARLAM",701017,1,7,580,587
"LAGHMAN","MEHTARLAM",701002,6,26,555,581
"LAGHMAN","MEHTARLAM",701017,2,5,589,594
"LAGHMAN","MEHTARLAM",701017,3,4,592,596
"LAGHMAN","MEHTARLAM",701016,1,37,426,463
"LAGHMAN","MEHTARLAM",701001,14,18,582,600
"LAGHMAN","MEHTARLAM",701001,15,1,3,4
"LAGHMAN","MEHTARLAM",701019,4,92,422,514
"LAGHMAN","MEHTARLAM",701001,16,31,564,595
"LAGHMAN","MEHTARLAM",701001,6,0,514,514
"LAGHMAN","MEHTARLAM",701001,7,27,547,574
"LAGHMAN","MEHTARLAM",701015,4,76,282,358
"LAGHMAN","MEHTARLAM",701018,1,53,460,513
"LAGHMAN","MEHTARLAM",701018,2,14,431,445
"LAGHMAN","MEHTARLAM",701004,3,24,572,596
"LAGHMAN","MEHTARLAM",701020,1,10,159,169
"LAGHMAN","MEHTARLAM",701004,6,2,550,552
"LAGHMAN","MEHTARLAM",701001,9,21,570,591
"LAGHMAN","MEHTARLAM",701016,2,4,402,406
"LAGHMAN","MEHTARLAM",701001,2,32,551,583
"LAGHMAN","MEHTARLAM",701001,3,12,580,592
"LAGHMAN","MEHTARLAM",701001,4,56,541,597
"LAGHMAN","MEHTARLAM",701030,1,29,563,592
"LAGHMAN","MEHTARLAM",701024,2,5,321,326
"LAGHMAN","MEHTARLAM",701008,3,25,182,207
"LAGHMAN","MEHTARLAM",701008,4,15,410,425
"LAGHMAN","MEHTARLAM",701030,2,39,552,591
"LAGHMAN","MEHTARLAM",701030,3,13,583,596
"LAGHMAN","MEHTARLAM",701006,3,50,261,311
"LAGHMAN","MEHTARLAM",701020,2,18,115,133
"LAGHMAN","MEHTARLAM",701020,3,16,179,195
"LAGHMAN","MEHTARLAM",701014,4,11,585,596
"LAGHMAN","MEHTARLAM",701014,5,107,423,530
"LAGHMAN","MEHTARLAM",701014,6,16,177,193
"LAGHMAN","MEHTARLAM",701019,1,32,351,383
"LAGHMAN","MEHTARLAM",701015,2,112,482,594
"LAGHMAN","MEHTARLAM",701015,3,32,259,291
"LAGHMAN","MEHTARLAM",701026,3,61,521,582
"LAGHMAN","MEHTARLAM",701009,3,15,568,583
"LAGHMAN","MEHTARLAM",701006,1,77,433,510
"LAGHMAN","MEHTARLAM",701006,2,47,499,546
"LAGHMAN","MEHTARLAM",701004,2,11,585,596
"LAGHMAN","MEHTARLAM",701006,4,45,268,313
"LAGHMAN","MEHTARLAM",701005,1,30,570,600
"LAGHMAN","MEHTARLAM",701005,2,30,568,598
"LAGHMAN","MEHTARLAM",701005,3,31,560,591
"LAGHMAN","MEHTARLAM",701016,3,14,504,518
"LAGHMAN","MEHTARLAM",701016,4,117,467,584
"LAGHMAN","MEHTARLAM",701019,2,84,351,435
"LAGHMAN","MEHTARLAM",701019,3,38,196,234
"LAGHMAN","MEHTARLAM",701005,7,16,464,480
"LAGHMAN","MEHTARLAM",701005,8,9,234,243
"LAGHMAN","MEHTARLAM",701005,9,4,141,145
"LAGHMAN","MEHTARLAM",701004,1,20,580,600
"LAGHMAN","MEHTARLAM",701010,2,16,575,591
"LAGHMAN","MEHTARLAM",701010,3,9,575,584
"LAGHMAN","MEHTARLAM",701010,4,7,587,594
"LAGHMAN","MEHTARLAM",701010,5,1,596,597
"LAGHMAN","MEHTARLAM",701004,7,8,591,599
"LAGHMAN","MEHTARLAM",701014,3,36,557,593
"LAGHMAN","MEHTARLAM",701007,2,31,225,256
"LAGHMAN","MEHTARLAM",701016,5,14,102,116
"LAGHMAN","MEHTARLAM",701026,2,58,428,486
"LAGHMAN","MEHTARLAM",701008,2,37,158,195
"LAGHMAN","MEHTARLAM",701009,2,8,490,498
"LAGHMAN","MEHTARLAM",701003,9,18,238,256
"LAGHMAN","MEHTARLAM",701010,1,29,564,593
"LAGHMAN","MEHTARLAM",701002,2,25,335,360
"LAGHMAN","MEHTARLAM",701002,3,73,372,445
"LAGHMAN","MEHTARLAM",701002,4,543,14,557
"LAGHMAN","MEHTARLAM",701002,5,33,508,541
"LAGHMAN","MEHTARLAM",701020,4,23,64,87
"LAGHMAN","MEHTARLAM",701020,5,4,33,37
"LAGHMAN","MEHTARLAM",701025,1,71,381,452
"LAGHMAN","MEHTARLAM",701007,3,45,237,282
"LAGHMAN","MEHTARLAM",701015,1,52,345,397
"LAGHMAN","MEHTARLAM",701026,1,34,519,553
"LAGHMAN","MEHTARLAM",701009,1,1,582,583
"LAGHMAN","MEHTARLAM",701003,8,10,304,314
"LAGHMAN","MEHTARLAM",701002,1,5,592,597
"LAGHMAN","MEHTARLAM",701003,2,39,551,590
"LAGHMAN","MEHTARLAM",701013,1,35,534,569
"LAGHMAN","MEHTARLAM",701007,1,12,128,140
"LAGHMAN","MEHTARLAM",701003,1,12,579,591
"LAGHMAN","MEHTARLAM",701008,1,28,161,189
"LAGHMAN","MEHTARLAM",701005,6,9,324,333
"LAGHMAN","MEHTARLAM",701025,3,25,304,329
"LAGHMAN","MEHTARLAM",701005,4,31,554,585
"LAGHMAN","MEHTARLAM",701003,7,12,366,378
"LAGHMAN","MEHTARLAM",701005,5,43,554,597
"LAGHMAN","MEHTARLAM",701007,4,20,187,207
"LAGHMAN","MEHTARLAM",701013,5,8,569,577
"LAGHMAN","MEHTARLAM",701013,3,25,530,555
"LAGHMAN","MEHTARLAM",701003,4,10,481,491
"LAGHMAN","MEHTARLAM",701003,5,17,580,597
"LAGHMAN","MEHTARLAM",701013,2,36,291,327
"LAGHMAN","MEHTARLAM",701013,4,34,485,519
"LAGHMAN","MEHTARLAM",701003,6,15,240,255
"LAGHMAN","MEHTARLAM",701003,3,14,570,584
"LAGHMAN","MEHTARLAM",701025,4,3,111,114
"LAGHMAN","MEHTARLAM",701025,2,16,311,327
"LAGHMAN","QARGHAYEE",702035,5,4,149,153
"LAGHMAN","QARGHAYEE",702033,1,75,329,404
"LAGHMAN","QARGHAYEE",702042,5,20,200,220
"LAGHMAN","QARGHAYEE",702042,4,12,587,599
"LAGHMAN","QARGHAYEE",702035,4,3,158,161
"LAGHMAN","QARGHAYEE",702041,1,200,323,523
"LAGHMAN","QARGHAYEE",702042,3,24,407,431
"LAGHMAN","QARGHAYEE",702041,2,66,269,335
"LAGHMAN","QARGHAYEE",702044,5,26,380,406
"LAGHMAN","QARGHAYEE",702052,1,18,170,188
"LAGHMAN","QARGHAYEE",702052,2,28,117,145
"LAGHMAN","QARGHAYEE",702035,2,22,323,345
"LAGHMAN","QARGHAYEE",702035,3,50,258,308
"LAGHMAN","QARGHAYEE",702040,4,3,257,260
"LAGHMAN","QARGHAYEE",702042,2,17,576,593
"LAGHMAN","QARGHAYEE",702040,6,559,29,588
"LAGHMAN","QARGHAYEE",702033,2,39,171,210
"LAGHMAN","QARGHAYEE",702033,3,65,298,363
"LAGHMAN","QARGHAYEE",702040,5,22,574,596
"LAGHMAN","QARGHAYEE",702040,2,6,406,412
"LAGHMAN","QARGHAYEE",702045,2,41,240,281
"LAGHMAN","QARGHAYEE",702040,3,6,472,478
"LAGHMAN","QARGHAYEE",702043,1,18,118,136
"LAGHMAN","QARGHAYEE",702044,1,38,456,494
"LAGHMAN","QARGHAYEE",702044,2,30,367,397
"LAGHMAN","QARGHAYEE",702044,3,29,566,595
"LAGHMAN","QARGHAYEE",702036,4,20,356,376
"LAGHMAN","QARGHAYEE",702127,2,6,58,64
"LAGHMAN","QARGHAYEE",702033,5,132,321,453
"LAGHMAN","QARGHAYEE",702041,3,7,581,588
"LAGHMAN","QARGHAYEE",702044,4,16,290,306
"LAGHMAN","QARGHAYEE",702042,1,21,571,592
"LAGHMAN","QARGHAYEE",702035,1,31,188,219
"LAGHMAN","QARGHAYEE",702050,2,24,377,401
"LAGHMAN","QARGHAYEE",702050,3,2,590,592
"LAGHMAN","QARGHAYEE",702046,1,49,191,240
"LAGHMAN","QARGHAYEE",702046,2,25,164,189
"LAGHMAN","QARGHAYEE",702046,3,23,217,240
"LAGHMAN","QARGHAYEE",702051,1,3,545,548
"LAGHMAN","QARGHAYEE",702052,3,92,211,303
"LAGHMAN","QARGHAYEE",702048,1,44,554,598
"LAGHMAN","QARGHAYEE",702048,2,21,559,580
"LAGHMAN","QARGHAYEE",702043,2,26,144,170
"LAGHMAN","QARGHAYEE",702043,3,35,295,330
"LAGHMAN","QARGHAYEE",702040,1,30,165,195
"LAGHMAN","QARGHAYEE",702045,1,67,266,333
"LAGHMAN","QARGHAYEE",702034,4,62,325,387
"LAGHMAN","QARGHAYEE",702130,6,185,344,529
"LAGHMAN","QARGHAYEE",702130,7,181,337,518
"LAGHMAN","QARGHAYEE",702045,3,63,513,576
"LAGHMAN","QARGHAYEE",702045,4,44,260,304
"LAGHMAN","QARGHAYEE",702045,5,0,157,157
"LAGHMAN","QARGHAYEE",702040,7,16,578,594
"LAGHMAN","QARGHAYEE",702127,1,1,42,43
"LAGHMAN","QARGHAYEE",702051,3,15,585,600
"LAGHMAN","QARGHAYEE",702033,4,72,129,201
"LAGHMAN","QARGHAYEE",702034,1,28,103,131
"LAGHMAN","QARGHAYEE",702043,4,17,216,233
"LAGHMAN","QARGHAYEE",702043,5,185,13,198
"LAGHMAN","QARGHAYEE",702036,1,106,212,318
"LAGHMAN","QARGHAYEE",702036,2,53,261,314
"LAGHMAN","QARGHAYEE",702036,3,66,291,357
"LAGHMAN","QARGHAYEE",702049,6,1,308,309
"LAGHMAN","QARGHAYEE",702049,7,8,428,436
"LAGHMAN","QARGHAYEE",702047,1,35,373,408
"LAGHMAN","QARGHAYEE",702047,2,34,219,253
"LAGHMAN","QARGHAYEE",702047,3,16,182,198
"LAGHMAN","QARGHAYEE",702039,1,18,64,82
"LAGHMAN","QARGHAYEE",702039,2,10,45,55
"LAGHMAN","QARGHAYEE",702039,3,20,79,99
"LAGHMAN","QARGHAYEE",702034,2,27,129,156
"LAGHMAN","QARGHAYEE",702034,3,54,185,239
"LAGHMAN","QARGHAYEE",702050,1,33,401,434
"LAGHMAN","QARGHAYEE",702130,5,25,150,175
"LAGHMAN","QARGHAYEE",702130,4,25,109,134
"LAGHMAN","QARGHAYEE",702049,5,2,593,595
"LAGHMAN","QARGHAYEE",702053,1,30,61,91
"LAGHMAN","QARGHAYEE",702053,2,25,49,74
"LAGHMAN","QARGHAYEE",702053,3,20,104,124
"LAGHMAN","QARGHAYEE",702051,2,4,524,528
"LAGHMAN","QARGHAYEE",702048,4,0,153,153
"LAGHMAN","QARGHAYEE",702130,2,55,317,372
"LAGHMAN","QARGHAYEE",702038,2,12,379,391
"LAGHMAN","QARGHAYEE",702048,3,8,588,596
"LAGHMAN","QARGHAYEE",702049,4,1,596,597
"LAGHMAN","QARGHAYEE",702049,3,2,595,597
"LAGHMAN","QARGHAYEE",702038,1,5,290,295
"LAGHMAN","QARGHAYEE",702038,3,3,190,193
"LAGHMAN","QARGHAYEE",702045,6,4,125,129
"LAGHMAN","QARGHAYEE",702130,1,59,226,285
"LAGHMAN","QARGHAYEE",702049,2,12,582,594
"LAGHMAN","QARGHAYEE",702037,2,36,563,599
"LAGHMAN","QARGHAYEE",702127,3,10,75,85
"LAGHMAN","QARGHAYEE",702049,1,1,590,591
"LAGHMAN","QARGHAYEE",702039,4,53,154,207
"LAGHMAN","QARGHAYEE",702037,1,54,427,481
"LAGHMAN","QARGHAYEE",702130,3,59,149,208
"LAGHMAN","QARGHAYEE",702037,3,53,423,476
"LAGHMAN","ALISHING",703091,2,33,53,86
"LAGHMAN","ALISHING",703091,3,57,32,89
"LAGHMAN","ALISHING",703091,4,24,187,211
"LAGHMAN","ALISHING",703087,3,50,151,201
"LAGHMAN","ALISHING",703097,1,32,514,546
"LAGHMAN","ALISHING",703090,4,0,37,37
"LAGHMAN","ALISHING",703090,3,92,177,269
"LAGHMAN","ALISHING",703086,2,15,53,68
"LAGHMAN","ALISHING",703101,2,39,215,254
"LAGHMAN","ALISHING",703091,1,14,72,86
"LAGHMAN","ALISHING",703090,2,165,327,492
"LAGHMAN","ALISHING",703088,5,8,29,37
"LAGHMAN","ALISHING",703087,2,12,97,109
"LAGHMAN","ALISHING",703086,1,25,153,178
"LAGHMAN","ALISHING",703089,2,6,68,74
"LAGHMAN","ALISHING",703097,2,16,578,594
"LAGHMAN","ALISHING",703097,3,19,559,578
"LAGHMAN","ALISHING",703089,3,147,401,548
"LAGHMAN","ALISHING",703090,1,57,394,451
"LAGHMAN","ALISHING",703089,1,20,79,99
"LAGHMAN","ALISHING",703088,3,15,216,231
"LAGHMAN","ALISHING",703087,1,30,143,173
"LAGHMAN","ALISHING",703097,4,5,586,591
"LAGHMAN","ALISHING",703086,3,232,52,284
"LAGHMAN","ALISHING",703101,1,13,222,235
"LAGHMAN","ALISHING",703088,4,18,174,192
"LAGHMAN","ALISHING",703088,1,36,106,142
"LAGHMAN","ALISHING",703088,2,1,24,25
"LAGHMAN","ALINGAR",704063,2,13,66,79
"LAGHMAN","ALINGAR",704057,2,14,65,79
"LAGHMAN","ALINGAR",704063,1,50,118,168
"LAGHMAN","ALINGAR",704085,1,26,299,325
"LAGHMAN","ALINGAR",704132,1,9,582,591
"LAGHMAN","ALINGAR",704132,2,8,590,598
"LAGHMAN","ALINGAR",704062,1,63,516,579
"LAGHMAN","ALINGAR",704057,1,14,490,504
"LAGHMAN","ALINGAR",704076,3,7,32,39
"LAGHMAN","ALINGAR",704076,4,9,20,29
"LAGHMAN","ALINGAR",704076,2,19,193,212
"LAGHMAN","ALINGAR",704055,1,9,589,598
"LAGHMAN","ALINGAR",704131,1,36,190,226
"LAGHMAN","ALINGAR",704131,2,35,103,138
"LAGHMAN","ALINGAR",704131,3,135,107,242
"LAGHMAN","ALINGAR",704085,2,5,494,499
"LAGHMAN","ALINGAR",704066,3,184,356,540
"LAGHMAN","ALINGAR",704064,3,5,153,158
"LAGHMAN","ALINGAR",704076,1,36,62,98
"LAGHMAN","ALINGAR",704066,2,98,176,274
"LAGHMAN","ALINGAR",704132,3,8,575,583
"LAGHMAN","ALINGAR",704055,2,7,593,600
"LAGHMAN","ALINGAR",704055,3,8,107,115
"LAGHMAN","ALINGAR",704062,2,25,572,597
"LAGHMAN","ALINGAR",704080,2,10,202,212
"LAGHMAN","ALINGAR",704080,1,3,120,123
"LAGHMAN","ALINGAR",704064,2,7,83,90
"LAGHMAN","ALINGAR",704067,1,7,556,563
"LAGHMAN","ALINGAR",704067,2,33,559,592
"LAGHMAN","ALINGAR",704066,1,193,291,484
"LAGHMAN","ALINGAR",704062,3,35,565,600
"LAGHMAN","ALINGAR",704064,1,16,286,302
"LAGHMAN","ALINGAR",704062,4,7,266,273
"LAGHMAN","ALINGAR",704062,5,7,263,270
"LAGHMAN","ALINGAR",704056,2,12,66,78
"LAGHMAN","ALINGAR",704056,1,29,229,258
"LAGHMAN","ALINGAR",704067,3,7,576,583
"LAGHMAN","DAWLAT SHAH",705117,1,85,75,160
"LAGHMAN","DAWLAT SHAH",705113,4,493,54,547
"LAGHMAN","DAWLAT SHAH",705123,1,24,10,34
"LAGHMAN","DAWLAT SHAH",705113,3,521,31,552
"LAGHMAN","DAWLAT SHAH",705114,4,184,368,552
"LAGHMAN","DAWLAT SHAH",705114,2,208,366,574
"LAGHMAN","DAWLAT SHAH",705123,3,77,66,143
"LAGHMAN","DAWLAT SHAH",705116,1,7,16,23
"LAGHMAN","DAWLAT SHAH",705122,2,35,19,54
"LAGHMAN","DAWLAT SHAH",705123,2,14,21,35
"LAGHMAN","DAWLAT SHAH",705115,4,103,101,204
"LAGHMAN","DAWLAT SHAH",705114,3,59,405,464
"LAGHMAN","DAWLAT SHAH",705111,3,327,78,405
"LAGHMAN","DAWLAT SHAH",705113,2,350,67,417
"LAGHMAN","DAWLAT SHAH",705120,3,163,9,172
"LAGHMAN","DAWLAT SHAH",705122,1,70,17,87
"LAGHMAN","DAWLAT SHAH",705116,3,71,37,108
"LAGHMAN","DAWLAT SHAH",705120,1,89,22,111
"LAGHMAN","DAWLAT SHAH",705114,1,242,347,589
"LAGHMAN","DAWLAT SHAH",705111,4,322,48,370
"LAGHMAN","DAWLAT SHAH",705124,2,363,73,436
"LAGHMAN","DAWLAT SHAH",705111,1,341,85,426
"LAGHMAN","DAWLAT SHAH",705113,1,499,24,523
"LAGHMAN","DAWLAT SHAH",705115,3,19,36,55
"LAGHMAN","DAWLAT SHAH",705116,2,4,12,16
"LAGHMAN","DAWLAT SHAH",705117,3,85,107,192
"LAGHMAN","DAWLAT SHAH",705126,3,51,54,105
"LAGHMAN","DAWLAT SHAH",705120,2,63,11,74
"LAGHMAN","DAWLAT SHAH",705124,3,214,25,239
"LAGHMAN","DAWLAT SHAH",705111,2,144,95,239
"LAGHMAN","DAWLAT SHAH",705116,4,79,59,138
"LAGHMAN","DAWLAT SHAH",705126,2,127,81,208
"LAGHMAN","DAWLAT SHAH",705115,1,21,13,34
"LAGHMAN","DAWLAT SHAH",705110,1,150,72,222
"LAGHMAN","DAWLAT SHAH",705110,2,33,19,52
"LAGHMAN","DAWLAT SHAH",705124,1,426,18,444
"LAGHMAN","DAWLAT SHAH",705112,2,115,69,184
"LAGHMAN","DAWLAT SHAH",705115,2,28,14,42
"LAGHMAN","DAWLAT SHAH",705126,1,65,77,142
"LAGHMAN","DAWLAT SHAH",705117,2,65,63,128
"LAGHMAN","DAWLAT SHAH",705112,1,93,61,154
"LAGHMAN","DAWLAT SHAH",705110,3,187,18,205
"LAGHMAN","DAWLAT SHAH",705110,4,61,41,102
NA,NA,706027,1,2,9,11
NA,NA,706027,2,3,11,14
NA,NA,706027,3,0,4,4
"PANJSHIR","BAZARAK",801007,3,142,13,155
"PANJSHIR","BAZARAK",801097,2,28,56,84
"PANJSHIR","BAZARAK",801008,1,18,14,32
"PANJSHIR","BAZARAK",801008,2,39,26,65
"PANJSHIR","BAZARAK",801097,1,80,40,120
"PANJSHIR","BAZARAK",801007,2,63,3,66
"PANJSHIR","BAZARAK",801097,3,123,23,146
"PANJSHIR","BAZARAK",801098,1,363,20,383
"PANJSHIR","BAZARAK",801007,1,56,8,64
"PANJSHIR","BAZARAK",801001,4,576,17,593
"PANJSHIR","BAZARAK",801001,1,479,9,488
"PANJSHIR","BAZARAK",801001,2,189,10,199
"PANJSHIR","BAZARAK",801001,3,223,4,227
"PANJSHIR","BAZARAK",801005,3,146,1,147
"PANJSHIR","BAZARAK",801001,5,54,1,55
"PANJSHIR","BAZARAK",801005,1,83,3,86
"PANJSHIR","BAZARAK",801005,2,97,3,100
"PANJSHIR","BAZARAK",801002,3,175,2,177
"PANJSHIR","BAZARAK",801002,4,391,2,393
"PANJSHIR","BAZARAK",801003,1,142,3,145
"PANJSHIR","BAZARAK",801003,2,243,1,244
"PANJSHIR","BAZARAK",801003,3,152,8,160
"PANJSHIR","BAZARAK",801003,4,132,1,133
"PANJSHIR","BAZARAK",801006,1,74,8,82
"PANJSHIR","BAZARAK",801006,2,63,17,80
"PANJSHIR","BAZARAK",801006,3,80,6,86
"PANJSHIR","BAZARAK",801006,4,136,4,140
"PANJSHIR","BAZARAK",801004,1,196,2,198
"PANJSHIR","BAZARAK",801004,2,153,3,156
"PANJSHIR","BAZARAK",801004,3,155,5,160
"PANJSHIR","BAZARAK",801004,4,269,5,274
"PANJSHIR","BAZARAK",801002,2,135,4,139
"PANJSHIR","BAZARAK",801098,2,304,28,332
"PANJSHIR","BAZARAK",801098,3,187,13,200
"PANJSHIR","BAZARAK",801002,1,185,12,197
"PANJSHIR","BAZARAK",801005,4,140,3,143
"PANJSHIR","RUKHA",802020,2,98,11,109
"PANJSHIR","RUKHA",802020,1,301,21,322
"PANJSHIR","RUKHA",802021,2,212,66,278
"PANJSHIR","RUKHA",802022,4,128,4,132
"PANJSHIR","RUKHA",802022,5,183,6,189
"PANJSHIR","RUKHA",802021,1,201,12,213
"PANJSHIR","RUKHA",802022,3,122,1,123
"PANJSHIR","RUKHA",802028,2,195,2,197
"PANJSHIR","RUKHA",802026,1,343,112,455
"PANJSHIR","RUKHA",802022,6,209,2,211
"PANJSHIR","RUKHA",802028,1,196,12,208
"PANJSHIR","RUKHA",802099,2,64,15,79
"PANJSHIR","RUKHA",802099,3,85,4,89
"PANJSHIR","RUKHA",802026,2,213,41,254
"PANJSHIR","RUKHA",802099,1,91,4,95
"PANJSHIR","RUKHA",802024,1,200,10,210
"PANJSHIR","RUKHA",802024,2,168,2,170
"PANJSHIR","RUKHA",802025,1,180,17,197
"PANJSHIR","RUKHA",802025,2,174,4,178
"PANJSHIR","RUKHA",802020,4,217,12,229
"PANJSHIR","RUKHA",802023,1,434,8,442
"PANJSHIR","RUKHA",802023,2,322,23,345
"PANJSHIR","RUKHA",802020,3,196,20,216
"PANJSHIR","RUKHA",802022,1,55,1,56
"PANJSHIR","RUKHA",802022,2,112,3,115
"PANJSHIR","RUKHA",802027,2,179,3,182
"PANJSHIR","RUKHA",802021,3,160,4,164
"PANJSHIR","RUKHA",802023,3,301,36,337
"PANJSHIR","RUKHA",802027,1,173,40,213
"PANJSHIR","DARAH",803062,3,70,2,72
"PANJSHIR","DARAH",803062,2,22,1,23
"PANJSHIR","DARAH",803047,1,170,41,211
"PANJSHIR","DARAH",803044,3,153,0,153
"PANJSHIR","DARAH",803044,4,197,1,198
"PANJSHIR","DARAH",803062,1,22,0,22
"PANJSHIR","DARAH",803055,2,99,0,99
"PANJSHIR","DARAH",803055,3,80,0,80
"PANJSHIR","DARAH",803055,4,78,0,78
"PANJSHIR","DARAH",803060,1,146,29,175
"PANJSHIR","DARAH",803060,2,118,12,130
"PANJSHIR","DARAH",803061,1,72,2,74
"PANJSHIR","DARAH",803047,2,239,9,248
"PANJSHIR","DARAH",803047,3,203,10,213
"PANJSHIR","DARAH",803044,1,102,2,104
"PANJSHIR","DARAH",803044,2,128,0,128
"PANJSHIR","DARAH",803056,1,105,66,171
"PANJSHIR","DARAH",803056,2,140,2,142
"PANJSHIR","DARAH",803055,1,120,0,120
"PANJSHIR","DARAH",803101,3,228,23,251
"PANJSHIR","DARAH",803059,1,78,44,122
"PANJSHIR","DARAH",803059,2,107,14,121
"PANJSHIR","DARAH",803100,1,266,1,267
"PANJSHIR","DARAH",803100,2,281,6,287
"PANJSHIR","DARAH",803100,3,161,3,164
"PANJSHIR","DARAH",803046,3,409,3,412
"PANJSHIR","DARAH",803043,1,197,1,198
"PANJSHIR","DARAH",803054,1,56,1,57
"PANJSHIR","DARAH",803054,2,67,5,72
"PANJSHIR","DARAH",803054,3,66,3,69
"PANJSHIR","DARAH",803045,2,85,0,85
"PANJSHIR","DARAH",803045,3,205,1,206
"PANJSHIR","DARAH",803101,1,103,5,108
"PANJSHIR","DARAH",803101,2,99,5,104
"PANJSHIR","DARAH",803043,4,49,0,49
"PANJSHIR","DARAH",803045,1,102,0,102
"PANJSHIR","DARAH",803046,1,252,2,254
"PANJSHIR","DARAH",803046,2,113,4,117
"PANJSHIR","DARAH",803061,2,43,6,49
"PANJSHIR","DARAH",803043,2,103,0,103
"PANJSHIR","DARAH",803043,3,34,1,35
"PANJSHIR","HISSA-E-AWAL",804102,2,246,2,248
"PANJSHIR","HISSA-E-AWAL",804103,2,104,3,107
"PANJSHIR","HISSA-E-AWAL",804103,3,48,9,57
"PANJSHIR","HISSA-E-AWAL",804017,1,334,5,339
"PANJSHIR","HISSA-E-AWAL",804009,4,369,9,378
"PANJSHIR","HISSA-E-AWAL",804017,2,144,12,156
"PANJSHIR","HISSA-E-AWAL",804018,3,320,3,323
"PANJSHIR","HISSA-E-AWAL",804102,1,237,18,255
"PANJSHIR","HISSA-E-AWAL",804010,3,246,5,251
"PANJSHIR","HISSA-E-AWAL",804018,1,115,2,117
"PANJSHIR","HISSA-E-AWAL",804018,2,218,1,219
"PANJSHIR","HISSA-E-AWAL",804015,1,333,1,334
"PANJSHIR","HISSA-E-AWAL",804015,2,241,6,247
"PANJSHIR","HISSA-E-AWAL",804019,1,285,1,286
"PANJSHIR","HISSA-E-AWAL",804019,2,279,2,281
"PANJSHIR","HISSA-E-AWAL",804019,3,463,0,463
"PANJSHIR","HISSA-E-AWAL",804012,1,150,5,155
"PANJSHIR","HISSA-E-AWAL",804012,2,143,8,151
"PANJSHIR","HISSA-E-AWAL",804009,5,592,2,594
"PANJSHIR","HISSA-E-AWAL",804010,1,319,12,331
"PANJSHIR","HISSA-E-AWAL",804010,2,238,16,254
"PANJSHIR","HISSA-E-AWAL",804013,6,129,28,157
"PANJSHIR","HISSA-E-AWAL",804013,7,170,5,175
"PANJSHIR","HISSA-E-AWAL",804013,8,156,1,157
"PANJSHIR","HISSA-E-AWAL",804103,1,66,8,74
"PANJSHIR","HISSA-E-AWAL",804016,2,558,26,584
"PANJSHIR","HISSA-E-AWAL",804016,3,147,0,147
"PANJSHIR","HISSA-E-AWAL",804016,4,201,0,201
"PANJSHIR","HISSA-E-AWAL",804009,1,564,10,574
"PANJSHIR","HISSA-E-AWAL",804009,2,289,8,297
"PANJSHIR","HISSA-E-AWAL",804009,3,271,28,299
"PANJSHIR","HISSA-E-AWAL",804013,1,127,1,128
"PANJSHIR","HISSA-E-AWAL",804013,2,197,26,223
"PANJSHIR","HISSA-E-AWAL",804013,3,129,9,138
"PANJSHIR","HISSA-E-AWAL",804013,4,105,0,105
"PANJSHIR","HISSA-E-AWAL",804013,5,173,2,175
"PANJSHIR","HISSA-E-AWAL",804092,1,197,19,216
"PANJSHIR","HISSA-E-AWAL",804092,2,70,3,73
"PANJSHIR","HISSA-E-AWAL",804016,1,590,6,596
"PANJSHIR","HISSA-E-AWAL",804011,2,376,4,380
"PANJSHIR","HISSA-E-AWAL",804014,3,35,0,35
"PANJSHIR","HISSA-E-AWAL",804102,3,218,1,219
"PANJSHIR","HISSA-E-AWAL",804011,1,448,12,460
"PANJSHIR","HISSA-E-AWAL",804014,2,407,3,410
"PANJSHIR","HISSA-E-AWAL",804012,3,235,1,236
"PANJSHIR","HISSA-E-AWAL",804014,1,490,3,493
"PANJSHIR","UNABA",805035,3,150,15,165
"PANJSHIR","UNABA",805034,2,130,19,149
"PANJSHIR","UNABA",805035,1,226,14,240
"PANJSHIR","UNABA",805034,1,102,8,110
"PANJSHIR","UNABA",805031,1,546,18,564
"PANJSHIR","UNABA",805034,3,164,16,180
"PANJSHIR","UNABA",805035,2,417,20,437
"PANJSHIR","UNABA",805041,2,103,15,118
"PANJSHIR","UNABA",805036,2,101,11,112
"PANJSHIR","UNABA",805037,1,483,24,507
"PANJSHIR","UNABA",805041,1,90,3,93
"PANJSHIR","UNABA",805036,1,253,26,279
"PANJSHIR","UNABA",805032,1,160,4,164
"PANJSHIR","UNABA",805032,2,98,10,108
"PANJSHIR","UNABA",805037,2,124,3,127
"PANJSHIR","UNABA",805033,2,190,11,201
"PANJSHIR","UNABA",805030,2,420,20,440
"PANJSHIR","UNABA",805030,3,565,24,589
"PANJSHIR","UNABA",805032,3,74,10,84
"PANJSHIR","UNABA",805030,1,580,8,588
"PANJSHIR","UNABA",805031,4,551,22,573
"PANJSHIR","UNABA",805031,5,159,9,168
"PANJSHIR","UNABA",805031,2,342,12,354
"PANJSHIR","UNABA",805031,3,521,77,598
"PANJSHIR","UNABA",805040,1,181,8,189
"PANJSHIR","UNABA",805040,2,48,2,50
"PANJSHIR","UNABA",805033,1,111,6,117
"PANJSHIR","UNABA",805042,1,208,27,235
"PANJSHIR","UNABA",805042,2,214,15,229
"PANJSHIR","UNABA",805038,2,207,6,213
"PANJSHIR","UNABA",805039,1,166,65,231
"PANJSHIR","UNABA",805039,2,61,15,76
"PANJSHIR","UNABA",805038,1,464,27,491
"PANJSHIR","UNABA",805029,1,205,7,212
"PANJSHIR","UNABA",805029,2,173,6,179
"PANJSHIR","UNABA",805029,3,396,13,409
"PANJSHIR","SHUTUL",806090,2,202,5,207
"PANJSHIR","SHUTUL",806088,3,240,8,248
"PANJSHIR","SHUTUL",806086,2,76,14,90
"PANJSHIR","SHUTUL",806090,1,182,8,190
"PANJSHIR","SHUTUL",806088,2,334,34,368
"PANJSHIR","SHUTUL",806084,2,45,31,76
"PANJSHIR","SHUTUL",806093,1,23,6,29
"PANJSHIR","SHUTUL",806093,2,6,5,11
"PANJSHIR","SHUTUL",806084,1,163,22,185
"PANJSHIR","SHUTUL",806087,3,98,25,123
"PANJSHIR","SHUTUL",806090,3,28,1,29
"PANJSHIR","SHUTUL",806087,1,61,14,75
"PANJSHIR","SHUTUL",806087,2,57,12,69
"PANJSHIR","SHUTUL",806104,3,79,10,89
"PANJSHIR","SHUTUL",806089,1,51,8,59
"PANJSHIR","SHUTUL",806089,2,103,10,113
"PANJSHIR","SHUTUL",806086,1,69,12,81
"PANJSHIR","SHUTUL",806105,1,17,4,21
"PANJSHIR","SHUTUL",806105,2,14,2,16
"PANJSHIR","SHUTUL",806105,3,57,22,79
"PANJSHIR","SHUTUL",806084,3,267,18,285
"PANJSHIR","SHUTUL",806104,2,31,3,34
"PANJSHIR","SHUTUL",806088,1,444,38,482
"PANJSHIR","SHUTUL",806085,2,106,0,106
"PANJSHIR","SHUTUL",806104,1,27,2,29
"PANJSHIR","SHUTUL",806091,1,284,66,350
"PANJSHIR","SHUTUL",806091,2,271,17,288
"PANJSHIR","SHUTUL",806085,1,201,17,218
"PANJSHIR","PARYAN",807080,2,422,8,430
"PANJSHIR","PARYAN",807106,1,200,5,205
"PANJSHIR","PARYAN",807106,2,258,14,272
"PANJSHIR","PARYAN",807108,1,31,12,43
"PANJSHIR","PARYAN",807108,2,66,6,72
"PANJSHIR","PARYAN",807108,3,81,13,94
"PANJSHIR","PARYAN",807106,3,391,15,406
"PANJSHIR","PARYAN",807067,2,299,18,317
"PANJSHIR","PARYAN",807107,3,60,22,82
"PANJSHIR","PARYAN",807082,1,591,6,597
"PANJSHIR","PARYAN",807067,1,453,47,500
"PANJSHIR","PARYAN",807068,1,278,13,291
"PANJSHIR","PARYAN",807068,2,215,13,228
"PANJSHIR","PARYAN",807074,1,195,24,219
"PANJSHIR","PARYAN",807082,2,120,13,133
"PANJSHIR","PARYAN",807066,1,239,7,246
"PANJSHIR","PARYAN",807066,2,244,5,249
"PANJSHIR","PARYAN",807066,3,236,7,243
"PANJSHIR","PARYAN",807074,2,211,20,231
"PANJSHIR","PARYAN",807107,1,73,21,94
"PANJSHIR","PARYAN",807107,2,47,17,64
"PANJSHIR","PARYAN",807070,1,460,16,476
"PANJSHIR","PARYAN",807070,2,122,21,143
"PANJSHIR","PARYAN",807073,1,570,22,592
"PANJSHIR","PARYAN",807073,2,437,64,501
"PANJSHIR","PARYAN",807083,1,181,36,217
"PANJSHIR","PARYAN",807083,2,198,12,210
"PANJSHIR","PARYAN",807071,1,499,1,500
"PANJSHIR","PARYAN",807071,2,434,6,440
"PANJSHIR","PARYAN",807094,1,46,6,52
"PANJSHIR","PARYAN",807094,2,29,16,45
"PANJSHIR","PARYAN",807096,1,176,4,180
"PANJSHIR","PARYAN",807096,2,281,0,281
"PANJSHIR","PARYAN",807095,1,317,38,355
"PANJSHIR","PARYAN",807095,2,276,16,292
"PANJSHIR","PARYAN",807080,1,240,15,255
"PANJSHIR","PARYAN",807075,2,206,43,249
"PANJSHIR","PARYAN",807077,1,553,21,574
"PANJSHIR","PARYAN",807077,2,594,5,599
"PANJSHIR","PARYAN",807072,1,572,20,592
"PANJSHIR","PARYAN",807072,2,333,7,340
"PANJSHIR","PARYAN",807069,1,139,12,151
"PANJSHIR","PARYAN",807069,2,152,8,160
"PANJSHIR","PARYAN",807069,3,245,52,297
"PANJSHIR","PARYAN",807081,1,72,5,77
"PANJSHIR","PARYAN",807081,2,94,48,142
"PANJSHIR","PARYAN",807079,1,322,29,351
"PANJSHIR","PARYAN",807079,2,369,45,414
"PANJSHIR","PARYAN",807075,1,365,57,422
"PANJSHIR","PARYAN",807078,1,212,7,219
"PANJSHIR","PARYAN",807078,2,365,7,372
"PANJSHIR","PARYAN",807076,1,238,12,250
"PANJSHIR","PARYAN",807076,2,184,40,224
NA,NA,808049,1,238,30,268
NA,NA,808049,2,155,44,199
NA,NA,808058,2,97,3,100
NA,NA,808057,1,353,37,390
NA,NA,808057,2,322,18,340
NA,NA,808064,1,93,38,131
NA,NA,808064,2,62,38,100
NA,NA,808053,1,181,24,205
NA,NA,808053,2,123,2,125
NA,NA,808063,1,328,12,340
NA,NA,808063,2,197,7,204
NA,NA,808051,1,438,10,448
NA,NA,808051,2,400,121,521
NA,NA,808065,1,87,20,107
NA,NA,808065,2,67,4,71
NA,NA,808065,3,86,14,100
NA,NA,808058,1,268,42,310
NA,NA,808048,1,75,7,82
NA,NA,808048,2,51,8,59
NA,NA,808050,3,283,7,290
NA,NA,808052,1,182,7,189
NA,NA,808052,2,112,0,112
NA,NA,808048,3,86,8,94
NA,NA,808050,1,402,57,459
NA,NA,808050,2,295,15,310
"BAGHLAN","PUL-E-KHUMRI",901037,3,25,308,333
"BAGHLAN","PUL-E-KHUMRI",901037,2,20,559,579
"BAGHLAN","PUL-E-KHUMRI",901041,2,40,38,78
"BAGHLAN","PUL-E-KHUMRI",901037,1,10,590,600
"BAGHLAN","PUL-E-KHUMRI",901007,7,4,13,17
"BAGHLAN","PUL-E-KHUMRI",901011,1,232,127,359
"BAGHLAN","PUL-E-KHUMRI",901011,2,276,144,420
"BAGHLAN","PUL-E-KHUMRI",901032,3,175,166,341
"BAGHLAN","PUL-E-KHUMRI",901012,3,37,41,78
"BAGHLAN","PUL-E-KHUMRI",901005,5,266,201,467
"BAGHLAN","PUL-E-KHUMRI",901012,4,48,25,73
"BAGHLAN","PUL-E-KHUMRI",901041,3,103,28,131
"BAGHLAN","PUL-E-KHUMRI",901011,3,399,175,574
"BAGHLAN","PUL-E-KHUMRI",901037,4,0,64,64
"BAGHLAN","PUL-E-KHUMRI",901001,8,135,37,172
"BAGHLAN","PUL-E-KHUMRI",901038,2,41,412,453
"BAGHLAN","PUL-E-KHUMRI",901038,1,68,370,438
"BAGHLAN","PUL-E-KHUMRI",901032,2,86,184,270
"BAGHLAN","PUL-E-KHUMRI",901014,2,42,435,477
"BAGHLAN","PUL-E-KHUMRI",901038,3,10,516,526
"BAGHLAN","PUL-E-KHUMRI",901002,1,407,179,586
"BAGHLAN","PUL-E-KHUMRI",901041,1,70,34,104
"BAGHLAN","PUL-E-KHUMRI",901228,2,203,104,307
"BAGHLAN","PUL-E-KHUMRI",901001,9,55,27,82
"BAGHLAN","PUL-E-KHUMRI",901228,4,109,72,181
"BAGHLAN","PUL-E-KHUMRI",901012,1,192,126,318
"BAGHLAN","PUL-E-KHUMRI",901012,2,121,139,260
"BAGHLAN","PUL-E-KHUMRI",901007,6,234,78,312
"BAGHLAN","PUL-E-KHUMRI",901004,3,433,149,582
"BAGHLAN","PUL-E-KHUMRI",901006,3,185,71,256
"BAGHLAN","PUL-E-KHUMRI",901006,4,230,168,398
"BAGHLAN","PUL-E-KHUMRI",901006,5,228,138,366
"BAGHLAN","PUL-E-KHUMRI",901040,1,9,586,595
"BAGHLAN","PUL-E-KHUMRI",901040,2,8,557,565
"BAGHLAN","PUL-E-KHUMRI",901040,3,12,548,560
"BAGHLAN","PUL-E-KHUMRI",901228,1,179,105,284
"BAGHLAN","PUL-E-KHUMRI",901228,3,109,68,177
"BAGHLAN","PUL-E-KHUMRI",901010,5,202,123,325
"BAGHLAN","PUL-E-KHUMRI",901001,6,147,68,215
"BAGHLAN","PUL-E-KHUMRI",901001,7,259,90,349
"BAGHLAN","PUL-E-KHUMRI",901005,4,210,185,395
"BAGHLAN","PUL-E-KHUMRI",901018,2,37,366,403
"BAGHLAN","PUL-E-KHUMRI",901005,6,286,214,500
"BAGHLAN","PUL-E-KHUMRI",901009,1,405,187,592
"BAGHLAN","PUL-E-KHUMRI",901009,2,357,182,539
"BAGHLAN","PUL-E-KHUMRI",901011,4,233,90,323
"BAGHLAN","PUL-E-KHUMRI",901011,5,367,124,491
"BAGHLAN","PUL-E-KHUMRI",901010,1,342,154,496
"BAGHLAN","PUL-E-KHUMRI",901010,2,391,177,568
"BAGHLAN","PUL-E-KHUMRI",901010,4,254,105,359
"BAGHLAN","PUL-E-KHUMRI",901008,5,300,114,414
"BAGHLAN","PUL-E-KHUMRI",901033,3,23,370,393
"BAGHLAN","PUL-E-KHUMRI",901032,1,98,186,284
"BAGHLAN","PUL-E-KHUMRI",901001,5,55,28,83
"BAGHLAN","PUL-E-KHUMRI",901029,1,112,336,448
"BAGHLAN","PUL-E-KHUMRI",901029,2,44,133,177
"BAGHLAN","PUL-E-KHUMRI",901029,3,55,59,114
"BAGHLAN","PUL-E-KHUMRI",901029,4,155,39,194
"BAGHLAN","PUL-E-KHUMRI",901009,3,355,166,521
"BAGHLAN","PUL-E-KHUMRI",901014,3,43,83,126
"BAGHLAN","PUL-E-KHUMRI",901014,4,30,469,499
"BAGHLAN","PUL-E-KHUMRI",901008,1,223,78,301
"BAGHLAN","PUL-E-KHUMRI",901008,4,233,70,303
"BAGHLAN","PUL-E-KHUMRI",901005,1,176,159,335
"BAGHLAN","PUL-E-KHUMRI",901005,2,164,113,277
"BAGHLAN","PUL-E-KHUMRI",901005,3,225,172,397
"BAGHLAN","PUL-E-KHUMRI",901007,5,148,62,210
"BAGHLAN","PUL-E-KHUMRI",901033,2,14,553,567
"BAGHLAN","PUL-E-KHUMRI",901004,2,457,125,582
"BAGHLAN","PUL-E-KHUMRI",901035,4,107,74,181
"BAGHLAN","PUL-E-KHUMRI",901036,1,104,273,377
"BAGHLAN","PUL-E-KHUMRI",901004,4,216,50,266
"BAGHLAN","PUL-E-KHUMRI",901004,5,128,37,165
"BAGHLAN","PUL-E-KHUMRI",901003,1,127,126,253
"BAGHLAN","PUL-E-KHUMRI",901003,2,205,165,370
"BAGHLAN","PUL-E-KHUMRI",901010,3,283,133,416
"BAGHLAN","PUL-E-KHUMRI",901001,2,233,129,362
"BAGHLAN","PUL-E-KHUMRI",901001,3,198,88,286
"BAGHLAN","PUL-E-KHUMRI",901001,4,132,72,204
"BAGHLAN","PUL-E-KHUMRI",901027,1,7,425,432
"BAGHLAN","PUL-E-KHUMRI",901027,2,6,582,588
"BAGHLAN","PUL-E-KHUMRI",901027,3,36,484,520
"BAGHLAN","PUL-E-KHUMRI",901027,4,6,484,490
"BAGHLAN","PUL-E-KHUMRI",901024,1,14,565,579
"BAGHLAN","PUL-E-KHUMRI",901024,2,86,473,559
"BAGHLAN","PUL-E-KHUMRI",901024,3,107,488,595
"BAGHLAN","PUL-E-KHUMRI",901009,4,223,100,323
"BAGHLAN","PUL-E-KHUMRI",901009,5,166,74,240
"BAGHLAN","PUL-E-KHUMRI",901003,3,299,238,537
"BAGHLAN","PUL-E-KHUMRI",901003,4,163,257,420
"BAGHLAN","PUL-E-KHUMRI",901003,5,183,337,520
"BAGHLAN","PUL-E-KHUMRI",901007,4,262,76,338
"BAGHLAN","PUL-E-KHUMRI",901231,2,8,586,594
"BAGHLAN","PUL-E-KHUMRI",901231,3,38,556,594
"BAGHLAN","PUL-E-KHUMRI",901015,1,19,577,596
"BAGHLAN","PUL-E-KHUMRI",901015,2,6,577,583
"BAGHLAN","PUL-E-KHUMRI",901015,3,21,567,588
"BAGHLAN","PUL-E-KHUMRI",901015,4,8,585,593
"BAGHLAN","PUL-E-KHUMRI",901002,2,400,191,591
"BAGHLAN","PUL-E-KHUMRI",901002,3,361,178,539
"BAGHLAN","PUL-E-KHUMRI",901002,4,394,140,534
"BAGHLAN","PUL-E-KHUMRI",901009,6,144,68,212
"BAGHLAN","PUL-E-KHUMRI",901001,1,369,219,588
"BAGHLAN","PUL-E-KHUMRI",901008,2,267,78,345
"BAGHLAN","PUL-E-KHUMRI",901034,6,150,63,213
"BAGHLAN","PUL-E-KHUMRI",901031,5,0,595,595
"BAGHLAN","PUL-E-KHUMRI",901033,1,12,548,560
"BAGHLAN","PUL-E-KHUMRI",901004,1,313,61,374
"BAGHLAN","PUL-E-KHUMRI",901006,1,356,168,524
"BAGHLAN","PUL-E-KHUMRI",901006,2,176,81,257
"BAGHLAN","PUL-E-KHUMRI",901039,1,145,78,223
"BAGHLAN","PUL-E-KHUMRI",901039,2,158,110,268
"BAGHLAN","PUL-E-KHUMRI",901039,3,254,125,379
"BAGHLAN","PUL-E-KHUMRI",901036,3,179,238,417
"BAGHLAN","PUL-E-KHUMRI",901019,1,40,287,327
"BAGHLAN","PUL-E-KHUMRI",901019,2,33,283,316
"BAGHLAN","PUL-E-KHUMRI",901019,3,83,507,590
"BAGHLAN","PUL-E-KHUMRI",901008,3,158,49,207
"BAGHLAN","PUL-E-KHUMRI",901030,1,77,36,113
"BAGHLAN","PUL-E-KHUMRI",901030,2,93,40,133
"BAGHLAN","PUL-E-KHUMRI",901030,3,172,44,216
"BAGHLAN","PUL-E-KHUMRI",901018,1,33,401,434
"BAGHLAN","PUL-E-KHUMRI",901231,4,4,71,75
"BAGHLAN","PUL-E-KHUMRI",901018,3,22,277,299
"BAGHLAN","PUL-E-KHUMRI",901018,4,7,86,93
"BAGHLAN","PUL-E-KHUMRI",901018,5,15,86,101
"BAGHLAN","PUL-E-KHUMRI",901012,5,137,72,209
"BAGHLAN","PUL-E-KHUMRI",901014,1,75,186,261
"BAGHLAN","PUL-E-KHUMRI",901025,2,21,379,400
"BAGHLAN","PUL-E-KHUMRI",901025,3,63,533,596
"BAGHLAN","PUL-E-KHUMRI",901019,4,137,461,598
"BAGHLAN","PUL-E-KHUMRI",901026,1,15,580,595
"BAGHLAN","PUL-E-KHUMRI",901026,2,7,592,599
"BAGHLAN","PUL-E-KHUMRI",901026,3,0,595,595
"BAGHLAN","PUL-E-KHUMRI",901026,4,28,530,558
"BAGHLAN","PUL-E-KHUMRI",901035,2,257,249,506
"BAGHLAN","PUL-E-KHUMRI",901227,1,53,9,62
"BAGHLAN","PUL-E-KHUMRI",901227,2,15,14,29
"BAGHLAN","PUL-E-KHUMRI",901227,3,57,1,58
"BAGHLAN","PUL-E-KHUMRI",901028,1,22,565,587
"BAGHLAN","PUL-E-KHUMRI",901028,2,46,330,376
"BAGHLAN","PUL-E-KHUMRI",901002,5,277,79,356
"BAGHLAN","PUL-E-KHUMRI",901002,6,139,40,179
"BAGHLAN","PUL-E-KHUMRI",901025,4,61,537,598
"BAGHLAN","PUL-E-KHUMRI",901007,3,256,48,304
"BAGHLAN","PUL-E-KHUMRI",901031,3,9,587,596
"BAGHLAN","PUL-E-KHUMRI",901031,4,10,582,592
"BAGHLAN","PUL-E-KHUMRI",901017,4,100,440,540
"BAGHLAN","PUL-E-KHUMRI",901022,5,120,466,586
"BAGHLAN","PUL-E-KHUMRI",901035,3,167,412,579
"BAGHLAN","PUL-E-KHUMRI",901229,3,378,31,409
"BAGHLAN","PUL-E-KHUMRI",901021,3,78,264,342
"BAGHLAN","PUL-E-KHUMRI",901036,2,91,213,304
"BAGHLAN","PUL-E-KHUMRI",901024,4,86,484,570
"BAGHLAN","PUL-E-KHUMRI",901034,1,450,133,583
"BAGHLAN","PUL-E-KHUMRI",901034,2,428,155,583
"BAGHLAN","PUL-E-KHUMRI",901034,3,79,26,105
"BAGHLAN","PUL-E-KHUMRI",901034,4,48,14,62
"BAGHLAN","PUL-E-KHUMRI",901034,5,122,44,166
"BAGHLAN","PUL-E-KHUMRI",901231,1,8,584,592
"BAGHLAN","PUL-E-KHUMRI",901022,4,19,574,593
"BAGHLAN","PUL-E-KHUMRI",901035,1,144,238,382
"BAGHLAN","PUL-E-KHUMRI",901021,1,48,264,312
"BAGHLAN","PUL-E-KHUMRI",901021,2,108,296,404
"BAGHLAN","PUL-E-KHUMRI",901230,3,173,90,263
"BAGHLAN","PUL-E-KHUMRI",901021,4,79,305,384
"BAGHLAN","PUL-E-KHUMRI",901015,5,1,596,597
"BAGHLAN","PUL-E-KHUMRI",901025,1,34,247,281
"BAGHLAN","PUL-E-KHUMRI",901013,1,23,563,586
"BAGHLAN","PUL-E-KHUMRI",901013,2,5,592,597
"BAGHLAN","PUL-E-KHUMRI",901022,1,40,483,523
"BAGHLAN","PUL-E-KHUMRI",901022,2,23,286,309
"BAGHLAN","PUL-E-KHUMRI",901017,2,5,579,584
"BAGHLAN","PUL-E-KHUMRI",901017,3,150,450,600
"BAGHLAN","PUL-E-KHUMRI",901020,4,29,15,44
"BAGHLAN","PUL-E-KHUMRI",901229,1,265,56,321
"BAGHLAN","PUL-E-KHUMRI",901229,2,392,81,473
"BAGHLAN","PUL-E-KHUMRI",901028,3,38,407,445
"BAGHLAN","PUL-E-KHUMRI",901028,4,68,460,528
"BAGHLAN","PUL-E-KHUMRI",901007,1,280,53,333
"BAGHLAN","PUL-E-KHUMRI",901016,1,14,566,580
"BAGHLAN","PUL-E-KHUMRI",901031,2,4,589,593
"BAGHLAN","PUL-E-KHUMRI",901022,3,21,232,253
"BAGHLAN","PUL-E-KHUMRI",901017,1,16,570,586
"BAGHLAN","PUL-E-KHUMRI",901007,2,242,57,299
"BAGHLAN","PUL-E-KHUMRI",901232,1,75,340,415
"BAGHLAN","PUL-E-KHUMRI",901023,1,16,82,98
"BAGHLAN","PUL-E-KHUMRI",901023,2,16,84,100
"BAGHLAN","PUL-E-KHUMRI",901232,3,158,28,186
"BAGHLAN","PUL-E-KHUMRI",901021,5,89,476,565
"BAGHLAN","PUL-E-KHUMRI",901016,3,57,463,520
"BAGHLAN","PUL-E-KHUMRI",901020,3,53,13,66
"BAGHLAN","PUL-E-KHUMRI",901023,3,24,94,118
"BAGHLAN","PUL-E-KHUMRI",901013,3,6,592,598
"BAGHLAN","PUL-E-KHUMRI",901020,2,100,91,191
"BAGHLAN","PUL-E-KHUMRI",901230,2,253,110,363
"BAGHLAN","PUL-E-KHUMRI",901023,4,11,131,142
"BAGHLAN","PUL-E-KHUMRI",901232,2,103,59,162
"BAGHLAN","PUL-E-KHUMRI",901031,1,10,586,596
"BAGHLAN","PUL-E-KHUMRI",901016,2,3,589,592
"BAGHLAN","PUL-E-KHUMRI",901016,4,38,535,573
"BAGHLAN","PUL-E-KHUMRI",901020,1,90,57,147
"BAGHLAN","PUL-E-KHUMRI",901230,1,150,68,218
"BAGHLAN","DAHANA-E-GHURI",902238,2,31,258,289
"BAGHLAN","DAHANA-E-GHURI",902238,3,18,281,299
"BAGHLAN","DAHANA-E-GHURI",902076,3,47,265,312
"BAGHLAN","DAHANA-E-GHURI",902239,2,75,6,81
"BAGHLAN","DAHANA-E-GHURI",902238,1,10,392,402
"BAGHLAN","DAHANA-E-GHURI",902259,1,38,19,57
"BAGHLAN","DAHANA-E-GHURI",902259,2,74,37,111
"BAGHLAN","DAHANA-E-GHURI",902078,1,193,22,215
"BAGHLAN","DAHANA-E-GHURI",902239,3,51,1,52
"BAGHLAN","DAHANA-E-GHURI",902258,3,3,337,340
"BAGHLAN","DAHANA-E-GHURI",902075,4,73,116,189
"BAGHLAN","DAHANA-E-GHURI",902239,1,65,4,69
"BAGHLAN","DAHANA-E-GHURI",902258,2,4,311,315
"BAGHLAN","DAHANA-E-GHURI",902259,3,3,54,57
"BAGHLAN","DAHANA-E-GHURI",902260,1,11,495,506
"BAGHLAN","DAHANA-E-GHURI",902076,1,47,456,503
"BAGHLAN","DAHANA-E-GHURI",902076,2,55,493,548
"BAGHLAN","DAHANA-E-GHURI",902075,2,87,125,212
"BAGHLAN","DAHANA-E-GHURI",902075,3,121,42,163
"BAGHLAN","DAHANA-E-GHURI",902090,1,298,253,551
"BAGHLAN","DAHANA-E-GHURI",902258,1,26,272,298
"BAGHLAN","DAHANA-E-GHURI",902090,3,34,454,488
"BAGHLAN","DAHANA-E-GHURI",902085,3,343,61,404
"BAGHLAN","DAHANA-E-GHURI",902083,1,380,15,395
"BAGHLAN","DAHANA-E-GHURI",902090,2,175,422,597
"BAGHLAN","DAHANA-E-GHURI",902075,1,135,91,226
"BAGHLAN","DAHANA-E-GHURI",902081,1,159,36,195
"BAGHLAN","DAHANA-E-GHURI",902081,2,103,45,148
"BAGHLAN","DAHANA-E-GHURI",902078,2,160,23,183
"BAGHLAN","DAHANA-E-GHURI",902085,1,313,82,395
"BAGHLAN","DAHANA-E-GHURI",902085,2,159,28,187
"BAGHLAN","DAHANA-E-GHURI",902091,1,22,511,533
"BAGHLAN","DAHANA-E-GHURI",902082,2,107,9,116
"BAGHLAN","DAHANA-E-GHURI",902260,2,9,495,504
"BAGHLAN","DAHANA-E-GHURI",902078,3,236,38,274
"BAGHLAN","DAHANA-E-GHURI",902092,2,37,480,517
"BAGHLAN","DAHANA-E-GHURI",902089,1,21,383,404
"BAGHLAN","DAHANA-E-GHURI",902088,3,62,57,119
"BAGHLAN","DAHANA-E-GHURI",902080,2,84,42,126
"BAGHLAN","DAHANA-E-GHURI",902083,2,95,13,108
"BAGHLAN","DAHANA-E-GHURI",902087,3,202,30,232
"BAGHLAN","DAHANA-E-GHURI",902082,1,162,24,186
"BAGHLAN","DAHANA-E-GHURI",902089,2,20,496,516
"BAGHLAN","DAHANA-E-GHURI",902092,1,97,389,486
"BAGHLAN","DAHANA-E-GHURI",902260,3,14,478,492
"BAGHLAN","DAHANA-E-GHURI",902091,2,18,543,561
"BAGHLAN","DAHANA-E-GHURI",902079,2,138,42,180
"BAGHLAN","DAHANA-E-GHURI",902080,1,160,58,218
"BAGHLAN","DAHANA-E-GHURI",902087,2,127,37,164
"BAGHLAN","DAHANA-E-GHURI",902087,1,93,15,108
"BAGHLAN","DAHANA-E-GHURI",902077,1,64,209,273
"BAGHLAN","DAHANA-E-GHURI",902084,1,186,15,201
"BAGHLAN","DAHANA-E-GHURI",902088,2,45,27,72
"BAGHLAN","DAHANA-E-GHURI",902086,1,145,0,145
"BAGHLAN","DAHANA-E-GHURI",902088,1,42,48,90
"BAGHLAN","DAHANA-E-GHURI",902086,3,105,3,108
"BAGHLAN","DAHANA-E-GHURI",902077,2,90,243,333
"BAGHLAN","DAHANA-E-GHURI",902079,1,235,36,271
"BAGHLAN","DAHANA-E-GHURI",902084,2,118,12,130
"BAGHLAN","DAHANA-E-GHURI",902089,3,8,175,183
"BAGHLAN","DAHANA-E-GHURI",902077,3,57,250,307
"BAGHLAN","DAHANA-E-GHURI",902086,2,130,4,134
"BAGHLAN","DUSHI",903097,3,449,29,478
"BAGHLAN","DUSHI",903093,4,26,270,296
"BAGHLAN","DUSHI",903097,1,385,5,390
"BAGHLAN","DUSHI",903097,2,247,8,255
"BAGHLAN","DUSHI",903093,3,42,429,471
"BAGHLAN","DUSHI",903108,2,135,3,138
"BAGHLAN","DUSHI",903108,3,39,9,48
"BAGHLAN","DUSHI",903104,1,134,66,200
"BAGHLAN","DUSHI",903110,2,79,38,117
"BAGHLAN","DUSHI",903110,3,150,65,215
"BAGHLAN","DUSHI",903104,2,49,88,137
"BAGHLAN","DUSHI",903108,4,294,55,349
"BAGHLAN","DUSHI",903106,4,7,6,13
"BAGHLAN","DUSHI",903108,1,90,25,115
"BAGHLAN","DUSHI",903101,4,99,16,115
"BAGHLAN","DUSHI",903096,1,40,300,340
"BAGHLAN","DUSHI",903096,2,50,233,283
"BAGHLAN","DUSHI",903096,3,60,516,576
"BAGHLAN","DUSHI",903099,1,545,51,596
"BAGHLAN","DUSHI",903109,3,24,93,117
"BAGHLAN","DUSHI",903104,3,120,40,160
"BAGHLAN","DUSHI",903100,1,98,49,147
"BAGHLAN","DUSHI",903093,2,37,333,370
"BAGHLAN","DUSHI",903094,3,211,286,497
"BAGHLAN","DUSHI",903103,3,78,44,122
"BAGHLAN","DUSHI",903105,2,29,186,215
"BAGHLAN","DUSHI",903110,1,40,80,120
"BAGHLAN","DUSHI",903261,3,92,62,154
"BAGHLAN","DUSHI",903109,1,219,25,244
"BAGHLAN","DUSHI",903103,4,56,57,113
"BAGHLAN","DUSHI",903111,1,11,68,79
"BAGHLAN","DUSHI",903240,1,63,17,80
"BAGHLAN","DUSHI",903240,2,100,38,138
"BAGHLAN","DUSHI",903110,4,202,270,472
"BAGHLAN","DUSHI",903093,1,63,317,380
"BAGHLAN","DUSHI",903261,1,111,19,130
"BAGHLAN","DUSHI",903102,2,19,94,113
"BAGHLAN","DUSHI",903240,3,107,27,134
"BAGHLAN","DUSHI",903240,4,137,101,238
"BAGHLAN","DUSHI",903264,3,11,552,563
"BAGHLAN","DUSHI",903104,4,129,147,276
"BAGHLAN","DUSHI",903102,3,6,439,445
"BAGHLAN","DUSHI",903109,2,16,126,142
"BAGHLAN","DUSHI",903106,3,17,8,25
"BAGHLAN","DUSHI",903101,1,180,28,208
"BAGHLAN","DUSHI",903101,2,63,7,70
"BAGHLAN","DUSHI",903105,3,6,346,352
"BAGHLAN","DUSHI",903105,4,14,120,134
"BAGHLAN","DUSHI",903102,1,50,69,119
"BAGHLAN","DUSHI",903262,1,61,18,79
"BAGHLAN","DUSHI",903106,1,29,5,34
"BAGHLAN","DUSHI",903099,2,555,21,576
"BAGHLAN","DUSHI",903099,3,120,21,141
"BAGHLAN","DUSHI",903094,1,24,78,102
"BAGHLAN","DUSHI",903094,2,136,60,196
"BAGHLAN","DUSHI",903105,1,12,303,315
"BAGHLAN","DUSHI",903109,4,16,118,134
"BAGHLAN","DUSHI",903107,2,539,41,580
"BAGHLAN","DUSHI",903111,4,5,36,41
"BAGHLAN","DUSHI",903103,2,65,166,231
"BAGHLAN","DUSHI",903101,3,79,10,89
"BAGHLAN","DUSHI",903264,2,16,218,234
"BAGHLAN","DUSHI",903261,2,60,19,79
"BAGHLAN","DUSHI",903099,4,167,32,199
"BAGHLAN","DUSHI",903264,1,45,302,347
"BAGHLAN","DUSHI",903111,3,3,39,42
"BAGHLAN","DUSHI",903100,3,179,69,248
"BAGHLAN","DUSHI",903263,3,237,291,528
"BAGHLAN","DUSHI",903106,2,45,18,63
"BAGHLAN","DUSHI",903107,3,561,37,598
"BAGHLAN","DUSHI",903103,1,40,91,131
"BAGHLAN","DUSHI",903100,4,239,246,485
"BAGHLAN","DUSHI",903095,2,94,331,425
"BAGHLAN","DUSHI",903111,2,15,33,48
"BAGHLAN","DUSHI",903098,1,50,481,531
"BAGHLAN","DUSHI",903098,2,61,510,571
"BAGHLAN","DUSHI",903095,1,60,84,144
"BAGHLAN","DUSHI",903263,1,115,171,286
"BAGHLAN","DUSHI",903107,4,150,22,172
"BAGHLAN","DUSHI",903107,1,507,28,535
"BAGHLAN","DUSHI",903095,3,75,501,576
"BAGHLAN","DUSHI",903263,2,111,74,185
"BAGHLAN","DUSHI",903098,3,24,553,577
"BAGHLAN","DUSHI",903262,3,74,19,93
"BAGHLAN","DUSHI",903102,4,22,386,408
"BAGHLAN","DUSHI",903100,2,200,180,380
"BAGHLAN","DUSHI",903262,2,94,27,121
"BAGHLAN","NAHREEN",904128,1,102,95,197
"BAGHLAN","NAHREEN",904132,2,523,15,538
"BAGHLAN","NAHREEN",904130,1,201,99,300
"BAGHLAN","NAHREEN",904144,2,538,17,555
"BAGHLAN","NAHREEN",904144,3,412,139,551
"BAGHLAN","NAHREEN",904267,2,515,69,584
"BAGHLAN","NAHREEN",904128,2,163,61,224
"BAGHLAN","NAHREEN",904132,3,389,13,402
"BAGHLAN","NAHREEN",904267,1,386,191,577
"BAGHLAN","NAHREEN",904146,1,158,437,595
"BAGHLAN","NAHREEN",904246,2,285,82,367
"BAGHLAN","NAHREEN",904143,3,483,86,569
"BAGHLAN","NAHREEN",904130,3,310,192,502
"BAGHLAN","NAHREEN",904133,1,523,64,587
"BAGHLAN","NAHREEN",904132,1,430,33,463
"BAGHLAN","NAHREEN",904130,2,93,113,206
"BAGHLAN","NAHREEN",904144,1,433,127,560
"BAGHLAN","NAHREEN",904141,2,451,149,600
"BAGHLAN","NAHREEN",904133,2,300,46,346
"BAGHLAN","NAHREEN",904133,3,475,114,589
"BAGHLAN","NAHREEN",904141,1,558,37,595
"BAGHLAN","NAHREEN",904143,2,411,123,534
"BAGHLAN","NAHREEN",904134,3,200,393,593
"BAGHLAN","NAHREEN",904134,4,303,197,500
"BAGHLAN","NAHREEN",904131,3,347,232,579
"BAGHLAN","NAHREEN",904246,1,403,38,441
"BAGHLAN","NAHREEN",904244,1,93,245,338
"BAGHLAN","NAHREEN",904244,2,166,276,442
"BAGHLAN","NAHREEN",904244,3,167,238,405
"BAGHLAN","NAHREEN",904146,2,100,497,597
"BAGHLAN","NAHREEN",904134,1,265,332,597
"BAGHLAN","NAHREEN",904246,3,259,130,389
"BAGHLAN","NAHREEN",904266,1,510,73,583
"BAGHLAN","NAHREEN",904143,1,478,96,574
"BAGHLAN","NAHREEN",904139,3,399,77,476
"BAGHLAN","NAHREEN",904265,1,400,99,499
"BAGHLAN","NAHREEN",904129,2,42,24,66
"BAGHLAN","NAHREEN",904265,3,425,79,504
"BAGHLAN","NAHREEN",904267,3,530,54,584
"BAGHLAN","NAHREEN",904138,1,386,66,452
"BAGHLAN","NAHREEN",904265,2,393,98,491
"BAGHLAN","NAHREEN",904141,3,496,101,597
"BAGHLAN","NAHREEN",904142,1,588,11,599
"BAGHLAN","NAHREEN",904146,3,59,535,594
"BAGHLAN","NAHREEN",904134,2,101,488,589
"BAGHLAN","NAHREEN",904137,2,465,131,596
"BAGHLAN","NAHREEN",904137,3,564,24,588
"BAGHLAN","NAHREEN",904131,2,540,41,581
"BAGHLAN","NAHREEN",904129,3,197,75,272
"BAGHLAN","NAHREEN",904135,1,504,64,568
"BAGHLAN","NAHREEN",904135,2,478,80,558
"BAGHLAN","NAHREEN",904135,3,514,54,568
"BAGHLAN","NAHREEN",904142,2,549,48,597
"BAGHLAN","NAHREEN",904138,2,190,123,313
"BAGHLAN","NAHREEN",904129,1,50,8,58
"BAGHLAN","NAHREEN",904140,3,450,95,545
"BAGHLAN","NAHREEN",904243,3,589,10,599
"BAGHLAN","NAHREEN",904137,1,519,48,567
"BAGHLAN","NAHREEN",904139,2,511,80,591
"BAGHLAN","NAHREEN",904245,1,176,26,202
"BAGHLAN","NAHREEN",904243,1,572,23,595
"BAGHLAN","NAHREEN",904245,3,366,67,433
"BAGHLAN","NAHREEN",904266,2,492,78,570
"BAGHLAN","NAHREEN",904266,3,574,20,594
"BAGHLAN","NAHREEN",904140,1,343,29,372
"BAGHLAN","NAHREEN",904138,3,151,70,221
"BAGHLAN","NAHREEN",904131,1,535,45,580
"BAGHLAN","NAHREEN",904245,2,191,39,230
"BAGHLAN","NAHREEN",904145,3,516,55,571
"BAGHLAN","NAHREEN",904139,1,506,80,586
"BAGHLAN","NAHREEN",904243,2,295,27,322
"BAGHLAN","NAHREEN",904128,3,65,16,81
"BAGHLAN","NAHREEN",904136,1,210,24,234
"BAGHLAN","NAHREEN",904128,4,69,10,79
"BAGHLAN","NAHREEN",904145,1,460,43,503
"BAGHLAN","NAHREEN",904145,2,542,55,597
"BAGHLAN","NAHREEN",904136,2,361,39,400
"BAGHLAN","NAHREEN",904142,3,549,39,588
"BAGHLAN","NAHREEN",904140,2,166,98,264
"BAGHLAN","NAHREEN",904136,3,513,42,555
"BAGHLAN","NAHREEN",904134,5,248,220,468
"BAGHLAN","BAGLAN-E-JADE",905268,2,9,589,598
"BAGHLAN","BAGLAN-E-JADE",905268,1,19,523,542
"BAGHLAN","BAGLAN-E-JADE",905234,2,26,81,107
"BAGHLAN","BAGLAN-E-JADE",905234,3,85,198,283
"BAGHLAN","BAGLAN-E-JADE",905073,7,14,576,590
"BAGHLAN","BAGLAN-E-JADE",905234,1,39,181,220
"BAGHLAN","BAGLAN-E-JADE",905073,6,33,552,585
"BAGHLAN","BAGLAN-E-JADE",905234,4,21,570,591
"BAGHLAN","BAGLAN-E-JADE",905062,1,307,226,533
"BAGHLAN","BAGLAN-E-JADE",905067,1,49,540,589
"BAGHLAN","BAGLAN-E-JADE",905069,2,29,571,600
"BAGHLAN","BAGLAN-E-JADE",905061,3,38,552,590
"BAGHLAN","BAGLAN-E-JADE",905236,3,16,584,600
"BAGHLAN","BAGLAN-E-JADE",905236,4,50,550,600
"BAGHLAN","BAGLAN-E-JADE",905060,1,91,27,118
"BAGHLAN","BAGLAN-E-JADE",905236,2,36,500,536
"BAGHLAN","BAGLAN-E-JADE",905052,2,231,201,432
"BAGHLAN","BAGLAN-E-JADE",905275,3,408,3,411
"BAGHLAN","BAGLAN-E-JADE",905069,1,54,500,554
"BAGHLAN","BAGLAN-E-JADE",905052,1,179,131,310
"BAGHLAN","BAGLAN-E-JADE",905073,3,9,579,588
"BAGHLAN","BAGLAN-E-JADE",905073,4,31,558,589
"BAGHLAN","BAGLAN-E-JADE",905061,2,19,570,589
"BAGHLAN","BAGLAN-E-JADE",905054,4,16,572,588
"BAGHLAN","BAGLAN-E-JADE",905073,5,17,570,587
"BAGHLAN","BAGLAN-E-JADE",905061,1,17,573,590
"BAGHLAN","BAGLAN-E-JADE",905067,3,26,562,588
"BAGHLAN","BAGLAN-E-JADE",905046,4,26,561,587
"BAGHLAN","BAGLAN-E-JADE",905060,2,93,19,112
"BAGHLAN","BAGLAN-E-JADE",905051,1,10,554,564
"BAGHLAN","BAGLAN-E-JADE",905269,3,20,529,549
"BAGHLAN","BAGLAN-E-JADE",905054,3,20,568,588
"BAGHLAN","BAGLAN-E-JADE",905050,2,5,30,35
"BAGHLAN","BAGLAN-E-JADE",905050,3,10,117,127
"BAGHLAN","BAGLAN-E-JADE",905059,1,155,122,277
"BAGHLAN","BAGLAN-E-JADE",905059,2,142,56,198
"BAGHLAN","BAGLAN-E-JADE",905059,3,88,54,142
"BAGHLAN","BAGLAN-E-JADE",905062,2,168,182,350
"BAGHLAN","BAGLAN-E-JADE",905067,2,25,565,590
"BAGHLAN","BAGLAN-E-JADE",905274,1,157,184,341
"BAGHLAN","BAGLAN-E-JADE",905067,4,22,568,590
"BAGHLAN","BAGLAN-E-JADE",905274,3,140,400,540
"BAGHLAN","BAGLAN-E-JADE",905073,2,24,569,593
"BAGHLAN","BAGLAN-E-JADE",905054,2,29,561,590
"BAGHLAN","BAGLAN-E-JADE",905050,1,7,103,110
"BAGHLAN","BAGLAN-E-JADE",905273,1,65,73,138
"BAGHLAN","BAGLAN-E-JADE",905273,2,120,80,200
"BAGHLAN","BAGLAN-E-JADE",905273,3,130,48,178
"BAGHLAN","BAGLAN-E-JADE",905275,1,149,12,161
"BAGHLAN","BAGLAN-E-JADE",905275,2,89,33,122
"BAGHLAN","BAGLAN-E-JADE",905058,1,200,174,374
"BAGHLAN","BAGLAN-E-JADE",905058,2,240,200,440
"BAGHLAN","BAGLAN-E-JADE",905060,3,17,523,540
"BAGHLAN","BAGLAN-E-JADE",905060,4,20,500,520
"BAGHLAN","BAGLAN-E-JADE",905073,1,16,575,591
"BAGHLAN","BAGLAN-E-JADE",905233,2,69,107,176
"BAGHLAN","BAGLAN-E-JADE",905233,3,50,58,108
"BAGHLAN","BAGLAN-E-JADE",905269,2,13,437,450
"BAGHLAN","BAGLAN-E-JADE",905045,3,58,34,92
"BAGHLAN","BAGLAN-E-JADE",905045,4,52,48,100
"BAGHLAN","BAGLAN-E-JADE",905046,1,12,431,443
"BAGHLAN","BAGLAN-E-JADE",905046,2,4,569,573
"BAGHLAN","BAGLAN-E-JADE",905046,3,107,483,590
"BAGHLAN","BAGLAN-E-JADE",905063,3,169,316,485
"BAGHLAN","BAGLAN-E-JADE",905056,1,272,153,425
"BAGHLAN","BAGLAN-E-JADE",905268,3,4,485,489
"BAGHLAN","BAGLAN-E-JADE",905062,3,175,64,239
"BAGHLAN","BAGLAN-E-JADE",905068,1,15,515,530
"BAGHLAN","BAGLAN-E-JADE",905068,2,42,521,563
"BAGHLAN","BAGLAN-E-JADE",905054,1,20,571,591
"BAGHLAN","BAGLAN-E-JADE",905045,2,39,35,74
"BAGHLAN","BAGLAN-E-JADE",905237,3,16,571,587
"BAGHLAN","BAGLAN-E-JADE",905051,2,11,530,541
"BAGHLAN","BAGLAN-E-JADE",905051,3,113,481,594
"BAGHLAN","BAGLAN-E-JADE",905051,4,117,482,599
"BAGHLAN","BAGLAN-E-JADE",905065,1,40,371,411
"BAGHLAN","BAGLAN-E-JADE",905065,2,112,180,292
"BAGHLAN","BAGLAN-E-JADE",905057,1,94,168,262
"BAGHLAN","BAGLAN-E-JADE",905057,2,100,173,273
"BAGHLAN","BAGLAN-E-JADE",905057,3,60,136,196
"BAGHLAN","BAGLAN-E-JADE",905062,4,79,55,134
"BAGHLAN","BAGLAN-E-JADE",905274,2,189,133,322
"BAGHLAN","BAGLAN-E-JADE",905237,1,14,575,589
"BAGHLAN","BAGLAN-E-JADE",905237,2,9,580,589
"BAGHLAN","BAGLAN-E-JADE",905272,2,94,255,349
"BAGHLAN","BAGLAN-E-JADE",905272,3,9,197,206
"BAGHLAN","BAGLAN-E-JADE",905074,4,180,420,600
"BAGHLAN","BAGLAN-E-JADE",905074,5,59,541,600
"BAGHLAN","BAGLAN-E-JADE",905044,3,142,161,303
"BAGHLAN","BAGLAN-E-JADE",905063,2,128,292,420
"BAGHLAN","BAGLAN-E-JADE",905072,2,10,579,589
"BAGHLAN","BAGLAN-E-JADE",905072,3,17,540,557
"BAGHLAN","BAGLAN-E-JADE",905058,3,55,16,71
"BAGHLAN","BAGLAN-E-JADE",905058,4,73,27,100
"BAGHLAN","BAGLAN-E-JADE",905053,1,116,141,257
"BAGHLAN","BAGLAN-E-JADE",905053,2,84,114,198
"BAGHLAN","BAGLAN-E-JADE",905236,1,59,540,599
"BAGHLAN","BAGLAN-E-JADE",905045,1,1,599,600
"BAGHLAN","BAGLAN-E-JADE",905049,3,56,33,89
"BAGHLAN","BAGLAN-E-JADE",905233,1,54,42,96
"BAGHLAN","BAGLAN-E-JADE",905066,1,260,20,280
"BAGHLAN","BAGLAN-E-JADE",905063,1,92,182,274
"BAGHLAN","BAGLAN-E-JADE",905072,1,26,560,586
"BAGHLAN","BAGLAN-E-JADE",905048,2,37,295,332
"BAGHLAN","BAGLAN-E-JADE",905048,3,100,410,510
"BAGHLAN","BAGLAN-E-JADE",905271,1,95,369,464
"BAGHLAN","BAGLAN-E-JADE",905048,1,11,147,158
"BAGHLAN","BAGLAN-E-JADE",905272,1,21,175,196
"BAGHLAN","BAGLAN-E-JADE",905074,3,104,492,596
"BAGHLAN","BAGLAN-E-JADE",905053,3,204,100,304
"BAGHLAN","BAGLAN-E-JADE",905049,2,58,105,163
"BAGHLAN","BAGLAN-E-JADE",905043,1,15,523,538
"BAGHLAN","BAGLAN-E-JADE",905047,1,192,168,360
"BAGHLAN","BAGLAN-E-JADE",905044,1,78,355,433
"BAGHLAN","BAGLAN-E-JADE",905066,2,554,0,554
"BAGHLAN","BAGLAN-E-JADE",905271,2,75,349,424
"BAGHLAN","BAGLAN-E-JADE",905055,3,164,5,169
"BAGHLAN","BAGLAN-E-JADE",905047,2,191,65,256
"BAGHLAN","BAGLAN-E-JADE",905049,1,112,196,308
"BAGHLAN","BAGLAN-E-JADE",905269,1,14,473,487
"BAGHLAN","BAGLAN-E-JADE",905042,1,247,191,438
"BAGHLAN","BAGLAN-E-JADE",905070,1,29,413,442
"BAGHLAN","BAGLAN-E-JADE",905070,2,15,400,415
"BAGHLAN","BAGLAN-E-JADE",905044,2,91,339,430
"BAGHLAN","BAGLAN-E-JADE",905055,2,88,74,162
"BAGHLAN","BAGLAN-E-JADE",905056,2,174,81,255
"BAGHLAN","BAGLAN-E-JADE",905056,3,319,141,460
"BAGHLAN","BAGLAN-E-JADE",905056,4,251,75,326
"BAGHLAN","BAGLAN-E-JADE",905074,1,100,482,582
"BAGHLAN","BAGLAN-E-JADE",905047,4,415,54,469
"BAGHLAN","BAGLAN-E-JADE",905074,2,45,548,593
"BAGHLAN","BAGLAN-E-JADE",905043,3,20,544,564
"BAGHLAN","BAGLAN-E-JADE",905270,1,547,43,590
"BAGHLAN","BAGLAN-E-JADE",905047,3,163,66,229
"BAGHLAN","BAGLAN-E-JADE",905042,2,81,499,580
"BAGHLAN","BAGLAN-E-JADE",905271,3,310,282,592
"BAGHLAN","BAGLAN-E-JADE",905043,2,14,551,565
"BAGHLAN","BAGLAN-E-JADE",905071,3,15,424,439
"BAGHLAN","BAGLAN-E-JADE",905055,1,209,27,236
"BAGHLAN","BAGLAN-E-JADE",905270,3,553,37,590
"BAGHLAN","BAGLAN-E-JADE",905064,2,59,523,582
"BAGHLAN","BAGLAN-E-JADE",905071,1,11,389,400
"BAGHLAN","BAGLAN-E-JADE",905071,2,29,496,525
"BAGHLAN","BAGLAN-E-JADE",905064,1,61,526,587
"BAGHLAN","BAGLAN-E-JADE",905042,4,135,259,394
"BAGHLAN","BAGLAN-E-JADE",905042,5,107,241,348
"BAGHLAN","BAGLAN-E-JADE",905270,2,475,74,549
"BAGHLAN","BAGLAN-E-JADE",905042,3,75,201,276
"BAGHLAN","KHINJAN",906118,2,172,24,196
"BAGHLAN","KHINJAN",906118,1,294,46,340
"BAGHLAN","KHINJAN",906113,4,320,9,329
"BAGHLAN","KHINJAN",906112,1,485,104,589
"BAGHLAN","KHINJAN",906117,2,521,20,541
"BAGHLAN","KHINJAN",906112,2,458,136,594
"BAGHLAN","KHINJAN",906113,3,237,52,289
"BAGHLAN","KHINJAN",906117,1,440,97,537
"BAGHLAN","KHINJAN",906112,3,324,52,376
"BAGHLAN","KHINJAN",906112,4,404,48,452
"BAGHLAN","KHINJAN",906241,1,45,31,76
"BAGHLAN","KHINJAN",906119,2,380,22,402
"BAGHLAN","KHINJAN",906113,2,122,19,141
"BAGHLAN","KHINJAN",906115,2,272,35,307
"BAGHLAN","KHINJAN",906116,2,37,143,180
"BAGHLAN","KHINJAN",906113,1,306,37,343
"BAGHLAN","KHINJAN",906115,1,177,27,204
"BAGHLAN","KHINJAN",906114,1,182,22,204
"BAGHLAN","KHINJAN",906119,1,425,31,456
"BAGHLAN","KHINJAN",906116,1,165,346,511
"BAGHLAN","KHINJAN",906112,5,239,99,338
"BAGHLAN","KHINJAN",906241,2,59,12,71
"BAGHLAN","KHINJAN",906115,3,349,26,375
"BAGHLAN","KHINJAN",906114,3,292,40,332
"BAGHLAN","KHINJAN",906114,2,302,98,400
"BAGHLAN","KHINJAN",906241,3,124,41,165
"BAGHLAN","ANDARAB",907122,4,208,380,588
"BAGHLAN","ANDARAB",907122,3,398,68,466
"BAGHLAN","ANDARAB",907122,2,463,38,501
"BAGHLAN","ANDARAB",907127,2,373,152,525
"BAGHLAN","ANDARAB",907126,1,419,30,449
"BAGHLAN","ANDARAB",907122,1,462,57,519
"BAGHLAN","ANDARAB",907127,1,379,107,486
"BAGHLAN","ANDARAB",907120,3,348,75,423
"BAGHLAN","ANDARAB",907120,4,168,39,207
"BAGHLAN","ANDARAB",907127,3,236,64,300
"BAGHLAN","ANDARAB",907126,3,386,45,431
"BAGHLAN","ANDARAB",907125,1,270,205,475
"BAGHLAN","ANDARAB",907121,3,370,28,398
"BAGHLAN","ANDARAB",907242,3,529,9,538
"BAGHLAN","ANDARAB",907126,2,423,32,455
"BAGHLAN","ANDARAB",907120,2,198,50,248
"BAGHLAN","ANDARAB",907121,2,249,50,299
"BAGHLAN","ANDARAB",907123,5,348,48,396
"BAGHLAN","ANDARAB",907242,2,365,85,450
"BAGHLAN","ANDARAB",907242,1,590,2,592
"BAGHLAN","ANDARAB",907123,3,536,8,544
"BAGHLAN","ANDARAB",907125,3,219,114,333
"BAGHLAN","ANDARAB",907124,1,172,27,199
"BAGHLAN","ANDARAB",907125,2,366,181,547
"BAGHLAN","ANDARAB",907123,2,536,11,547
"BAGHLAN","ANDARAB",907120,1,302,181,483
"BAGHLAN","ANDARAB",907123,1,427,5,432
"BAGHLAN","ANDARAB",907123,4,390,23,413
"BAGHLAN","ANDARAB",907121,1,285,29,314
"BAGHLAN","ANDARAB",907124,3,362,74,436
"BAGHLAN","ANDARAB",907124,2,155,6,161
"BAGHLAN","DEH SALAH",908189,3,580,8,588
"BAGHLAN","DEH SALAH",908183,2,537,61,598
"BAGHLAN","DEH SALAH",908184,3,483,93,576
"BAGHLAN","DEH SALAH",908183,1,121,472,593
"BAGHLAN","DEH SALAH",908183,3,389,210,599
"BAGHLAN","DEH SALAH",908189,1,594,6,600
"BAGHLAN","DEH SALAH",908251,2,23,11,34
"BAGHLAN","DEH SALAH",908187,2,535,60,595
"BAGHLAN","DEH SALAH",908185,1,550,50,600
"BAGHLAN","DEH SALAH",908184,2,258,39,297
"BAGHLAN","DEH SALAH",908276,1,288,38,326
"BAGHLAN","DEH SALAH",908182,1,556,41,597
"BAGHLAN","DEH SALAH",908189,2,590,10,600
"BAGHLAN","DEH SALAH",908184,1,243,24,267
"BAGHLAN","DEH SALAH",908185,3,597,3,600
"BAGHLAN","DEH SALAH",908276,2,214,38,252
"BAGHLAN","DEH SALAH",908181,2,570,24,594
"BAGHLAN","DEH SALAH",908182,2,592,6,598
"BAGHLAN","DEH SALAH",908181,1,516,77,593
"BAGHLAN","DEH SALAH",908188,2,549,50,599
"BAGHLAN","DEH SALAH",908251,1,281,163,444
"BAGHLAN","DEH SALAH",908186,2,577,21,598
"BAGHLAN","DEH SALAH",908188,1,516,50,566
"BAGHLAN","DEH SALAH",908187,1,587,13,600
"BAGHLAN","DEH SALAH",908276,3,418,134,552
"BAGHLAN","DEH SALAH",908185,2,581,18,599
"BAGHLAN","DEH SALAH",908186,1,588,8,596
"BAGHLAN","DEH SALAH",908181,3,334,6,340
"BAGHLAN","JALGA",909194,2,558,42,600
"BAGHLAN","JALGA",909193,2,418,129,547
"BAGHLAN","JALGA",909194,1,386,213,599
"BAGHLAN","JALGA",909198,4,570,23,593
"BAGHLAN","JALGA",909197,3,573,21,594
"BAGHLAN","JALGA",909194,3,511,88,599
"BAGHLAN","JALGA",909196,1,528,71,599
"BAGHLAN","JALGA",909198,3,586,5,591
"BAGHLAN","JALGA",909193,3,344,131,475
"BAGHLAN","JALGA",909200,1,501,99,600
"BAGHLAN","JALGA",909198,2,582,12,594
"BAGHLAN","JALGA",909197,1,587,13,600
"BAGHLAN","JALGA",909199,4,496,104,600
"BAGHLAN","JALGA",909278,1,509,88,597
"BAGHLAN","JALGA",909200,2,556,44,600
"BAGHLAN","JALGA",909192,3,184,48,232
"BAGHLAN","JALGA",909197,2,552,48,600
"BAGHLAN","JALGA",909199,3,491,109,600
"BAGHLAN","JALGA",909198,1,589,8,597
"BAGHLAN","JALGA",909196,2,534,66,600
"BAGHLAN","JALGA",909193,1,576,18,594
"BAGHLAN","JALGA",909200,4,546,54,600
"BAGHLAN","JALGA",909277,3,595,1,596
"BAGHLAN","JALGA",909192,1,264,208,472
"BAGHLAN","JALGA",909200,3,480,115,595
"BAGHLAN","JALGA",909195,1,169,430,599
"BAGHLAN","JALGA",909191,1,551,44,595
"BAGHLAN","JALGA",909191,3,585,11,596
"BAGHLAN","JALGA",909252,2,536,61,597
"BAGHLAN","JALGA",909192,2,341,78,419
"BAGHLAN","JALGA",909252,1,564,35,599
"BAGHLAN","JALGA",909190,1,553,34,587
"BAGHLAN","JALGA",909195,3,191,409,600
"BAGHLAN","JALGA",909196,3,541,59,600
"BAGHLAN","JALGA",909278,2,556,40,596
"BAGHLAN","JALGA",909190,3,435,160,595
"BAGHLAN","JALGA",909195,2,149,450,599
"BAGHLAN","JALGA",909199,2,555,43,598
"BAGHLAN","JALGA",909190,4,436,160,596
"BAGHLAN","JALGA",909277,1,570,23,593
"BAGHLAN","JALGA",909278,3,316,279,595
"BAGHLAN","JALGA",909199,1,543,57,600
"BAGHLAN","JALGA",909191,2,577,20,597
"BAGHLAN","JALGA",909277,2,549,41,590
"BAGHLAN","JALGA",909190,2,473,113,586
"BAGHLAN","BURKA",910159,4,140,458,598
"BAGHLAN","BURKA",910159,3,224,376,600
"BAGHLAN","BURKA",910151,2,483,101,584
"BAGHLAN","BURKA",910160,1,81,325,406
"BAGHLAN","BURKA",910160,2,226,328,554
"BAGHLAN","BURKA",910150,3,500,98,598
"BAGHLAN","BURKA",910152,3,31,561,592
"BAGHLAN","BURKA",910151,3,550,46,596
"BAGHLAN","BURKA",910159,2,50,549,599
"BAGHLAN","BURKA",910150,4,559,40,599
"BAGHLAN","BURKA",910156,2,458,141,599
"BAGHLAN","BURKA",910155,3,20,576,596
"BAGHLAN","BURKA",910151,1,446,154,600
"BAGHLAN","BURKA",910160,3,72,220,292
"BAGHLAN","BURKA",910248,2,76,515,591
"BAGHLAN","BURKA",910150,2,550,47,597
"BAGHLAN","BURKA",910159,1,152,447,599
"BAGHLAN","BURKA",910147,2,82,469,551
"BAGHLAN","BURKA",910156,1,528,67,595
"BAGHLAN","BURKA",910152,2,123,472,595
"BAGHLAN","BURKA",910147,1,156,363,519
"BAGHLAN","BURKA",910161,2,288,309,597
"BAGHLAN","BURKA",910156,3,587,13,600
"BAGHLAN","BURKA",910248,1,82,515,597
"BAGHLAN","BURKA",910149,3,13,518,531
"BAGHLAN","BURKA",910155,1,180,419,599
"BAGHLAN","BURKA",910161,3,393,206,599
"BAGHLAN","BURKA",910162,1,50,549,599
"BAGHLAN","BURKA",910161,1,325,273,598
"BAGHLAN","BURKA",910162,3,48,552,600
"BAGHLAN","BURKA",910155,2,85,507,592
"BAGHLAN","BURKA",910152,1,112,486,598
"BAGHLAN","BURKA",910150,1,524,76,600
"BAGHLAN","BURKA",910157,1,35,550,585
"BAGHLAN","BURKA",910151,4,557,38,595
"BAGHLAN","BURKA",910154,1,474,126,600
"BAGHLAN","BURKA",910154,2,517,75,592
"BAGHLAN","BURKA",910153,2,155,437,592
"BAGHLAN","BURKA",910158,2,30,563,593
"BAGHLAN","BURKA",910158,3,25,575,600
"BAGHLAN","BURKA",910157,3,42,472,514
"BAGHLAN","BURKA",910148,3,200,400,600
"BAGHLAN","BURKA",910162,2,96,502,598
"BAGHLAN","BURKA",910158,1,80,515,595
"BAGHLAN","BURKA",910153,1,143,447,590
"BAGHLAN","BURKA",910147,3,56,539,595
"BAGHLAN","BURKA",910149,2,100,498,598
"BAGHLAN","BURKA",910154,3,566,31,597
"BAGHLAN","BURKA",910148,2,20,574,594
"BAGHLAN","BURKA",910148,1,213,381,594
"BAGHLAN","BURKA",910248,3,41,541,582
"BAGHLAN","BURKA",910147,4,74,522,596
"BAGHLAN","BURKA",910153,3,123,467,590
"BAGHLAN","BURKA",910247,2,30,564,594
"BAGHLAN","BURKA",910157,2,11,584,595
"BAGHLAN","BURKA",910247,3,378,118,496
"BAGHLAN","BURKA",910247,1,40,554,594
"BAGHLAN","BURKA",910149,1,71,491,562
"BAGHLAN","TALA WA BARF",911166,1,350,244,594
"BAGHLAN","TALA WA BARF",911168,3,155,412,567
"BAGHLAN","TALA WA BARF",911163,1,545,51,596
"BAGHLAN","TALA WA BARF",911166,2,333,260,593
"BAGHLAN","TALA WA BARF",911167,1,474,114,588
"BAGHLAN","TALA WA BARF",911279,1,401,199,600
"BAGHLAN","TALA WA BARF",911167,3,150,448,598
"BAGHLAN","TALA WA BARF",911172,1,479,119,598
"BAGHLAN","TALA WA BARF",911172,2,539,60,599
"BAGHLAN","TALA WA BARF",911167,2,389,205,594
"BAGHLAN","TALA WA BARF",911168,4,27,573,600
"BAGHLAN","TALA WA BARF",911169,1,112,334,446
"BAGHLAN","TALA WA BARF",911279,2,202,362,564
"BAGHLAN","TALA WA BARF",911163,2,505,89,594
"BAGHLAN","TALA WA BARF",911249,3,541,47,588
"BAGHLAN","TALA WA BARF",911169,3,4,586,590
"BAGHLAN","TALA WA BARF",911169,2,32,430,462
"BAGHLAN","TALA WA BARF",911164,1,492,42,534
"BAGHLAN","TALA WA BARF",911163,3,490,91,581
"BAGHLAN","TALA WA BARF",911164,4,512,87,599
"BAGHLAN","TALA WA BARF",911164,2,485,54,539
"BAGHLAN","TALA WA BARF",911168,2,301,293,594
"BAGHLAN","TALA WA BARF",911164,3,488,64,552
"BAGHLAN","TALA WA BARF",911165,2,512,85,597
"BAGHLAN","TALA WA BARF",911163,4,496,92,588
"BAGHLAN","TALA WA BARF",911167,4,267,329,596
"BAGHLAN","TALA WA BARF",911170,1,565,16,581
"BAGHLAN","TALA WA BARF",911165,1,466,134,600
"BAGHLAN","TALA WA BARF",911170,3,460,138,598
"BAGHLAN","TALA WA BARF",911168,1,103,159,262
"BAGHLAN","TALA WA BARF",911171,2,451,73,524
"BAGHLAN","TALA WA BARF",911279,3,107,492,599
"BAGHLAN","TALA WA BARF",911249,2,381,203,584
"BAGHLAN","TALA WA BARF",911170,2,478,9,487
"BAGHLAN","TALA WA BARF",911171,1,475,114,589
"BAGHLAN","TALA WA BARF",911165,3,442,157,599
"BAGHLAN","TALA WA BARF",911249,1,400,185,585
"BAGHLAN","PUL-E-HISAR",912174,1,283,15,298
"BAGHLAN","PUL-E-HISAR",912174,2,45,7,52
"BAGHLAN","PUL-E-HISAR",912176,1,276,6,282
"BAGHLAN","PUL-E-HISAR",912180,2,143,4,147
"BAGHLAN","PUL-E-HISAR",912179,1,182,8,190
"BAGHLAN","PUL-E-HISAR",912173,3,114,90,204
"BAGHLAN","PUL-E-HISAR",912250,1,456,34,490
"BAGHLAN","PUL-E-HISAR",912175,2,233,66,299
"BAGHLAN","PUL-E-HISAR",912250,2,98,19,117
"BAGHLAN","PUL-E-HISAR",912176,2,93,24,117
"BAGHLAN","PUL-E-HISAR",912175,1,452,100,552
"BAGHLAN","PUL-E-HISAR",912173,1,327,55,382
"BAGHLAN","PUL-E-HISAR",912179,2,157,7,164
"BAGHLAN","PUL-E-HISAR",912173,2,234,28,262
"BAGHLAN","PUL-E-HISAR",912180,1,467,13,480
"BAGHLAN","KHOST WA FIRI",913255,2,599,0,599
"BAGHLAN","KHOST WA FIRI",913255,1,589,10,599
"BAGHLAN","KHOST WA FIRI",913211,1,560,38,598
"BAGHLAN","KHOST WA FIRI",913211,2,565,31,596
"BAGHLAN","KHOST WA FIRI",913253,1,400,200,600
"BAGHLAN","KHOST WA FIRI",913253,3,250,350,600
"BAGHLAN","KHOST WA FIRI",913201,2,586,12,598
"BAGHLAN","KHOST WA FIRI",913201,3,577,17,594
"BAGHLAN","KHOST WA FIRI",913216,1,533,67,600
"BAGHLAN","KHOST WA FIRI",913253,2,400,200,600
"BAGHLAN","KHOST WA FIRI",913256,2,596,3,599
"BAGHLAN","KHOST WA FIRI",913217,2,595,4,599
"BAGHLAN","KHOST WA FIRI",913202,3,456,140,596
"BAGHLAN","KHOST WA FIRI",913216,2,451,148,599
"BAGHLAN","KHOST WA FIRI",913214,1,522,76,598
"BAGHLAN","KHOST WA FIRI",913201,1,583,15,598
"BAGHLAN","KHOST WA FIRI",913208,3,532,65,597
"BAGHLAN","KHOST WA FIRI",913207,1,585,14,599
"BAGHLAN","KHOST WA FIRI",913256,1,562,29,591
"BAGHLAN","KHOST WA FIRI",913212,3,214,285,499
"BAGHLAN","KHOST WA FIRI",913202,2,567,31,598
"BAGHLAN","KHOST WA FIRI",913206,3,584,0,584
"BAGHLAN","KHOST WA FIRI",913207,2,595,5,600
"BAGHLAN","KHOST WA FIRI",913211,3,574,20,594
"BAGHLAN","KHOST WA FIRI",913217,1,571,24,595
"BAGHLAN","KHOST WA FIRI",913215,1,517,83,600
"BAGHLAN","KHOST WA FIRI",913214,2,350,250,600
"BAGHLAN","KHOST WA FIRI",913212,2,552,44,596
"BAGHLAN","KHOST WA FIRI",913202,1,527,69,596
"BAGHLAN","KHOST WA FIRI",913254,3,491,106,597
"BAGHLAN","KHOST WA FIRI",913208,1,546,47,593
"BAGHLAN","KHOST WA FIRI",913208,2,591,7,598
"BAGHLAN","KHOST WA FIRI",913214,3,456,135,591
"BAGHLAN","KHOST WA FIRI",913205,1,557,42,599
"BAGHLAN","KHOST WA FIRI",913254,2,508,91,599
"BAGHLAN","KHOST WA FIRI",913210,2,384,214,598
"BAGHLAN","KHOST WA FIRI",913213,2,595,3,598
"BAGHLAN","KHOST WA FIRI",913206,2,591,7,598
"BAGHLAN","KHOST WA FIRI",913204,1,507,91,598
"BAGHLAN","KHOST WA FIRI",913215,2,560,39,599
"BAGHLAN","KHOST WA FIRI",913212,1,526,74,600
"BAGHLAN","KHOST WA FIRI",913213,1,598,1,599
"BAGHLAN","KHOST WA FIRI",913204,2,466,126,592
"BAGHLAN","KHOST WA FIRI",913254,1,536,58,594
"BAGHLAN","KHOST WA FIRI",913203,1,566,29,595
"BAGHLAN","KHOST WA FIRI",913206,1,588,10,598
"BAGHLAN","KHOST WA FIRI",913205,2,590,4,594
"BAGHLAN","KHOST WA FIRI",913209,2,376,222,598
"BAGHLAN","KHOST WA FIRI",913209,1,464,135,599
"BAGHLAN","KHOST WA FIRI",913210,1,320,278,598
"BAGHLAN","KHOST WA FIRI",913203,2,518,79,597
"BAGHLAN","GOZARGAH-E-NUR",914224,2,563,32,595
"BAGHLAN","GOZARGAH-E-NUR",914224,1,594,3,597
"BAGHLAN","GOZARGAH-E-NUR",914224,3,579,20,599
"BAGHLAN","GOZARGAH-E-NUR",914224,5,461,39,500
"BAGHLAN","GOZARGAH-E-NUR",914225,1,575,25,600
"BAGHLAN","GOZARGAH-E-NUR",914280,3,537,63,600
"BAGHLAN","GOZARGAH-E-NUR",914224,4,552,38,590
"BAGHLAN","GOZARGAH-E-NUR",914226,3,490,101,591
"BAGHLAN","GOZARGAH-E-NUR",914280,2,593,5,598
"BAGHLAN","GOZARGAH-E-NUR",914226,2,551,48,599
"BAGHLAN","GOZARGAH-E-NUR",914225,2,581,18,599
"BAGHLAN","GOZARGAH-E-NUR",914225,3,598,2,600
"BAGHLAN","GOZARGAH-E-NUR",914280,1,589,10,599
"BAGHLAN","GOZARGAH-E-NUR",914226,1,503,96,599
"BAGHLAN","FIRING WA GHARU",915220,1,560,35,595
"BAGHLAN","FIRING WA GHARU",915221,2,551,13,564
"BAGHLAN","FIRING WA GHARU",915257,2,553,46,599
"BAGHLAN","FIRING WA GHARU",915257,1,532,67,599
"BAGHLAN","FIRING WA GHARU",915219,2,577,22,599
"BAGHLAN","FIRING WA GHARU",915223,2,581,13,594
"BAGHLAN","FIRING WA GHARU",915220,2,557,39,596
"BAGHLAN","FIRING WA GHARU",915222,2,567,20,587
"BAGHLAN","FIRING WA GHARU",915219,1,554,44,598
"BAGHLAN","FIRING WA GHARU",915218,2,553,39,592
"BAGHLAN","FIRING WA GHARU",915221,1,577,20,597
"BAGHLAN","FIRING WA GHARU",915281,3,582,18,600
"BAGHLAN","FIRING WA GHARU",915222,1,590,4,594
"BAGHLAN","FIRING WA GHARU",915281,2,517,79,596
"BAGHLAN","FIRING WA GHARU",915281,1,505,80,585
"BAGHLAN","FIRING WA GHARU",915218,3,560,19,579
"BAGHLAN","FIRING WA GHARU",915218,1,547,46,593
"BAGHLAN","FIRING WA GHARU",915223,1,580,19,599